Date,Floor,User-Group,User-Count,WiFi-Conn,Duration-Sec,Traffic-In-Byte,Traffic-Out-Byte,Traffic-Both-Byte
2014-03-01,1,Staff,9,98,130628,452301048,38060902,490361950
2014-03-01,1,TPG,23,228,348629,15762938611,2793971580,18556910191
2014-03-01,1,RPG,16,81,133876,2601177954,1485487885,4086665839
2014-03-01,1,UG,63,398,534985,14961005198,2493890516,17454895714
2014-03-01,1,Alumni,11,95,203668,3901963453,214596483,4116559936
2014-03-01,1,Others(HKUST),0,0,0,0,0,0
2014-03-01,1,Non-HKUST,3,10,12237,4737156980,190789338,4927946318
2014-03-01,1,Total,125,910,1364023,42416543244,7216796704,49633339948
2014-03-01,G,Staff,29,170,156369,4810755329,282003959,5092759288
2014-03-01,G,TPG,162,606,383191,22398521727,8185705219,30584226946
2014-03-01,G,RPG,83,313,305854,5578828172,977790701,6556618873
2014-03-01,G,UG,290,2002,1704891,56643490653,12168440436,68811931089
2014-03-01,G,Alumni,23,130,80442,3487260807,101522032,3588782839
2014-03-01,G,Others(HKUST),2,13,47179,267328304,149107461,416435765
2014-03-01,G,Non-HKUST,12,58,55306,1444209679,170594817,1614804496
2014-03-01,G,Total,601,3292,2733232,94630394671,22035164625,116665559296
2014-03-01,LG1,Staff,38,336,359755,2624435603,310302543,2934738146
2014-03-01,LG1,TPG,334,3339,4465199,52446994957,7856403812,60303398769
2014-03-01,LG1,RPG,138,1204,1718654,33164187618,6511369900,39675557518
2014-03-01,LG1,UG,790,8526,11976813,151789309813,28304977565,180094287378
2014-03-01,LG1,Alumni,31,278,366337,16436450964,523805565,16960256529
2014-03-01,LG1,Others(HKUST),4,106,30811,7275780,2803886,10079666
2014-03-01,LG1,Non-HKUST,16,90,149080,626418788,156882525,783301313
2014-03-01,LG1,Total,1351,13879,19066649,257095073523,43666545796,300761619319
2014-03-01,LG3,Staff,36,91,57572,680644851,41423890,722068741
2014-03-01,LG3,TPG,178,499,570166,37962167115,2352629354,40314796469
2014-03-01,LG3,RPG,117,383,441363,29906517761,2238239708,32144757469
2014-03-01,LG3,UG,485,1305,1359724,21845620211,3239734469,25085354680
2014-03-01,LG3,Alumni,22,80,103784,896464720,43420959,939885679
2014-03-01,LG3,Others(HKUST),2,2,839,21645161,2596263,24241424
2014-03-01,LG3,Non-HKUST,9,41,64532,299438974,119890160,419329134
2014-03-01,LG3,Total,849,2401,2597980,91612498793,8037934803,99650433596
2014-03-01,LG4,Staff,35,102,150418,654331007,93447241,747778248
2014-03-01,LG4,TPG,187,1457,2379509,84849374728,7086251404,91935626132
2014-03-01,LG4,RPG,76,413,579390,14978390581,2966136885,17944527466
2014-03-01,LG4,UG,366,1634,2073309,24946000989,5918185502,30864186491
2014-03-01,LG4,Alumni,22,168,352119,5269185592,211055232,5480240824
2014-03-01,LG4,Others(HKUST),4,95,249489,8261566980,1138417464,9399984444
2014-03-01,LG4,Non-HKUST,11,129,157695,2404068297,1440806555,3844874852
2014-03-01,LG4,Total,701,3998,5941929,141362918174,18854300283,160217218457
2014-03-01,All-Floors,Staff,103,797,854742,9222467838,765238535,9987706373
2014-03-01,All-Floors,TPG,473,6129,8146694,213419997138,28274961369,241694958507
2014-03-01,All-Floors,RPG,266,2394,3179137,86229102086,14179025079,100408127165
2014-03-01,All-Floors,UG,1158,13865,17649722,270185426864,52125228488,322310655352
2014-03-01,All-Floors,Alumni,58,751,1106350,29991325536,1094400271,31085725807
2014-03-01,All-Floors,Others(HKUST),9,216,328318,8557816225,1292925074,9850741299
2014-03-01,All-Floors,Non-HKUST,28,328,438850,9511292718,2078963395,11590256113
2014-03-01,All-Floors,Total,2095,24480,31703813,627117428405,99810742211,726928170616
2014-03-02,1,Staff,6,53,96986,131640116,237639487,369279603
2014-03-02,1,TPG,37,556,811222,28628309121,6231351063,34859660184
2014-03-02,1,RPG,8,43,54739,414682287,70546701,485228988
2014-03-02,1,UG,82,622,1318961,63103739907,7186558585,70290298492
2014-03-02,1,Alumni,8,101,216363,6267319939,740688454,7008008393
2014-03-02,1,Others(HKUST),0,0,0,0,0,0
2014-03-02,1,Non-HKUST,5,17,50661,1000036468,238920229,1238956697
2014-03-02,1,Total,146,1392,2548932,99545727838,14705704519,114251432357
2014-03-02,G,Staff,26,184,211636,1600370815,3169535560,4769906375
2014-03-02,G,TPG,162,1135,874001,26848837664,11367589179,38216426843
2014-03-02,G,RPG,77,319,254211,7439876053,1050487111,8490363164
2014-03-02,G,UG,330,2426,2125874,77136356132,14445997940,91582354072
2014-03-02,G,Alumni,35,112,114415,416362052,21543994,437906046
2014-03-02,G,Others(HKUST),3,17,53165,681387878,199460010,880847888
2014-03-02,G,Non-HKUST,17,198,118694,6650521812,427434162,7077955974
2014-03-02,G,Total,650,4391,3751996,120773712406,30682047956,151455760362
2014-03-02,LG1,Staff,35,272,423543,9233644138,1557309368,10790953506
2014-03-02,LG1,TPG,316,5151,6073192,262305908144,31648178887,293954087031
2014-03-02,LG1,RPG,142,1476,2087554,43287976466,33462672617,76750649083
2014-03-02,LG1,UG,833,10194,12728678,220402287959,53452655429,273854943388
2014-03-02,LG1,Alumni,32,171,123742,11389230206,1853965721,13243195927
2014-03-02,LG1,Others(HKUST),2,96,50317,577754274,68702304,646456578
2014-03-02,LG1,Non-HKUST,35,360,409998,4448601798,585528170,5034129968
2014-03-02,LG1,Total,1395,17720,21897024,551645402985,122629012496,674274415481
2014-03-02,LG3,Staff,30,74,70789,1744266476,160189332,1904455808
2014-03-02,LG3,TPG,182,756,850481,25177325940,6093145076,31270471016
2014-03-02,LG3,RPG,142,500,569101,4498588943,2695026597,7193615540
2014-03-02,LG3,UG,487,1601,1675900,17254152951,4290283695,21544436646
2014-03-02,LG3,Alumni,26,97,97203,1493324822,299626216,1792951038
2014-03-02,LG3,Others(HKUST),4,4,0,0,0,0
2014-03-02,LG3,Non-HKUST,20,121,206025,48816974036,14929217322,63746191358
2014-03-02,LG3,Total,891,3153,3469499,98984633168,28467488238,127452121406
2014-03-02,LG4,Staff,30,120,170141,769463954,54413018,823876972
2014-03-02,LG4,TPG,170,1939,2923803,80345992724,10294723701,90640716425
2014-03-02,LG4,RPG,93,564,814825,40670918240,5924985942,46595904182
2014-03-02,LG4,UG,385,2223,3171526,28577673069,8272618740,36850291809
2014-03-02,LG4,Alumni,31,358,531127,5347374392,334709535,5682083927
2014-03-02,LG4,Others(HKUST),2,24,85630,2794472921,327189725,3121662646
2014-03-02,LG4,Non-HKUST,26,221,328576,15531904170,2456216146,17988120316
2014-03-02,LG4,Total,737,5449,8025628,174037799470,27664856807,201702656277
2014-03-02,All-Floors,Staff,83,703,973095,13479385499,5179086765,18658472264
2014-03-02,All-Floors,TPG,389,9537,11532699,423306373593,65634987906,488941361499
2014-03-02,All-Floors,RPG,276,2902,3780430,96312041989,43203718968,139515760957
2014-03-02,All-Floors,UG,1179,17066,21020939,406474210018,87648114389,494122324407
2014-03-02,All-Floors,Alumni,62,839,1082850,24913611411,3250533920,28164145331
2014-03-02,All-Floors,Others(HKUST),9,141,189112,4053615073,595352039,4648967112
2014-03-02,All-Floors,Non-HKUST,57,917,1113954,76448038284,18637316029,95085354313
2014-03-02,All-Floors,Total,2055,32105,39693079,1044987275867,224149110016,1269136385883
2014-03-03,1,Staff,56,592,680535,5510151124,535124842,6045275966
2014-03-03,1,TPG,52,542,982658,20854523246,2065150418,22919673664
2014-03-03,1,RPG,24,104,154642,3198063922,2009956105,5208020027
2014-03-03,1,UG,601,4143,5180168,163500158562,44700234014,208200392576
2014-03-03,1,Alumni,6,76,100872,1139523690,83836706,1223360396
2014-03-03,1,Others(HKUST),5,32,79092,32433865451,604416113,33038281564
2014-03-03,1,Non-HKUST,4,11,14277,50984534,2997668,53982202
2014-03-03,1,Total,748,5500,7192244,226687270529,50001715866,276688986395
2014-03-03,G,Staff,100,764,606270,12450339841,812341631,13262681472
2014-03-03,G,TPG,312,1646,821717,16108303523,2878719218,18987022741
2014-03-03,G,RPG,154,953,539913,50419167091,9912221950,60331389041
2014-03-03,G,UG,1711,9643,5158286,114700866667,14225999559,128926866226
2014-03-03,G,Alumni,15,52,45507,390263038,58241666,448504704
2014-03-03,G,Others(HKUST),8,24,75264,162184092,60268366,222452458
2014-03-03,G,Non-HKUST,10,50,31675,640936829,29592604,670529433
2014-03-03,G,Total,2310,13132,7278632,194872061081,27977384994,222849446075
2014-03-03,LG1,Staff,98,485,311010,8710443379,429923851,9140367230
2014-03-03,LG1,TPG,461,5381,4724637,108987543476,19237936870,128225480346
2014-03-03,LG1,RPG,163,1277,1132098,53441097843,7736971332,61178069175
2014-03-03,LG1,UG,2458,20794,19240680,201346230498,42328337648,243674568146
2014-03-03,LG1,Alumni,14,237,190475,1319164913,764862053,2084026966
2014-03-03,LG1,Others(HKUST),9,128,33465,423340897,22811002,446151899
2014-03-03,LG1,Non-HKUST,25,118,108448,722956287,157387368,880343655
2014-03-03,LG1,Total,3228,28420,25740813,374950777293,70678230124,445629007417
2014-03-03,LG3,Staff,164,354,140153,887005660,85472129,972477789
2014-03-03,LG3,TPG,300,1863,2115826,50093827532,7891721748,57985549280
2014-03-03,LG3,RPG,218,684,721862,17434050186,3942122638,21376172824
2014-03-03,LG3,UG,1831,5907,4593859,98821601214,22674255628,121495856842
2014-03-03,LG3,Alumni,10,60,37690,1626577718,127771561,1754349279
2014-03-03,LG3,Others(HKUST),11,29,25021,641330263,50135933,691466196
2014-03-03,LG3,Non-HKUST,13,56,103402,1836411739,505836452,2342248191
2014-03-03,LG3,Total,2547,8953,7737813,171340804312,35277316089,206618120401
2014-03-03,LG4,Staff,103,397,432622,1633287519,362221512,1995509031
2014-03-03,LG4,TPG,342,4142,5911208,138890098643,22336566641,161226665284
2014-03-03,LG4,RPG,180,996,1631835,35046918155,15224886628,50271804783
2014-03-03,LG4,UG,1601,8753,9050736,123768080386,27574066975,151342147361
2014-03-03,LG4,Alumni,8,127,98398,343446224,64301301,407747525
2014-03-03,LG4,Others(HKUST),10,117,122900,10042646468,339255990,10381902458
2014-03-03,LG4,Non-HKUST,16,63,38173,75168572,13658540,88827112
2014-03-03,LG4,Total,2260,14595,17285872,309799645967,65914957587,375714603554
2014-03-03,All-Floors,Staff,334,2592,2170590,29191227523,2225083965,31416311488
2014-03-03,All-Floors,TPG,629,13574,14556046,334934296420,54410094895,389344391315
2014-03-03,All-Floors,RPG,429,4014,4180350,159539297197,38826158653,198365455850
2014-03-03,All-Floors,UG,4267,49240,43223729,702136937327,151502893824,853639831151
2014-03-03,All-Floors,Alumni,28,552,472942,4818975583,1099013287,5917988870
2014-03-03,All-Floors,Others(HKUST),28,330,335742,43703367171,1076887404,44780254575
2014-03-03,All-Floors,Non-HKUST,47,298,295975,3326457961,709472632,4035930593
2014-03-03,All-Floors,Total,5762,70600,65235374,1277650559182,249849604660,1527500163842
2014-03-04,1,Staff,57,771,644930,7830953752,1012666518,8843620270
2014-03-04,1,TPG,62,688,928687,21690651684,2176801402,23867453086
2014-03-04,1,RPG,36,239,467906,6682776133,841278078,7524054211
2014-03-04,1,UG,598,4064,5189354,168366111882,27295822045,195661933927
2014-03-04,1,Alumni,5,81,82864,701112167,62621887,763734054
2014-03-04,1,Others(HKUST),4,45,35609,5431475300,155779468,5587254768
2014-03-04,1,Non-HKUST,7,22,15006,5155131,2286113,7441244
2014-03-04,1,Total,769,5910,7364356,210708236049,31547255511,242255491560
2014-03-04,G,Staff,98,667,502655,9108119975,1050956890,10159076865
2014-03-04,G,TPG,320,1928,1154888,12454460628,1663953735,14118414363
2014-03-04,G,RPG,144,1004,589519,15141588966,2455962546,17597551512
2014-03-04,G,UG,1626,8310,5034341,90217620750,19874620650,110092241400
2014-03-04,G,Alumni,13,60,44575,208915312,47331893,256247205
2014-03-04,G,Others(HKUST),10,25,94277,194367448,32598013,226965461
2014-03-04,G,Non-HKUST,9,18,2398,732057,598580,1330637
2014-03-04,G,Total,2220,12012,7422653,127325805136,25126022307,152451827443
2014-03-04,LG1,Staff,112,610,515603,6121079246,2403782645,8524861891
2014-03-04,LG1,TPG,454,5157,4680275,117573879463,17186968498,134760847961
2014-03-04,LG1,RPG,211,1843,1693763,55450970468,5783913071,61234883539
2014-03-04,LG1,UG,2337,19217,18528836,221961416722,40724574807,262685991529
2014-03-04,LG1,Alumni,15,86,41510,357340823,26035232,383376055
2014-03-04,LG1,Others(HKUST),14,157,72815,1655794708,178044573,1833839281
2014-03-04,LG1,Non-HKUST,22,174,121245,376774468,66229234,443003702
2014-03-04,LG1,Total,3165,27244,25654047,403497255898,66369548060,469866803958
2014-03-04,LG3,Staff,113,238,103880,2370462803,191673350,2562136153
2014-03-04,LG3,TPG,279,1570,1712727,23647023880,8168696296,31815720176
2014-03-04,LG3,RPG,188,746,892315,9944655837,4363150608,14307806445
2014-03-04,LG3,UG,1522,5190,4508499,72111129112,14730309204,86841438316
2014-03-04,LG3,Alumni,9,39,27623,615716415,71072594,686789009
2014-03-04,LG3,Others(HKUST),10,41,38111,52931855,9745100,62676955
2014-03-04,LG3,Non-HKUST,8,24,75739,10329654,2263153,12592807
2014-03-04,LG3,Total,2129,7848,7358894,108752249556,27536910305,136289159861
2014-03-04,LG4,Staff,79,242,246553,468667325,61941689,530609014
2014-03-04,LG4,TPG,303,3940,5337828,89398066474,15507884718,104905951192
2014-03-04,LG4,RPG,163,1175,1435378,47800672932,14284431233,62085104165
2014-03-04,LG4,UG,1435,8135,9432263,147301069893,24899060913,172200130806
2014-03-04,LG4,Alumni,12,169,217188,2483871213,243047444,2726918657
2014-03-04,LG4,Others(HKUST),9,118,132761,9425208519,383645281,9808853800
2014-03-04,LG4,Non-HKUST,8,92,105297,3196229835,758495185,3954725020
2014-03-04,LG4,Total,2009,13871,16907268,300073786191,56138506463,356212292654
2014-03-04,All-Floors,Staff,295,2528,2013621,25899283101,4721021092,30620304193
2014-03-04,All-Floors,TPG,628,13283,13814405,264764082129,44704304649,309468386778
2014-03-04,All-Floors,RPG,419,5007,5078881,135020664336,27728735536,162749399872
2014-03-04,All-Floors,UG,3991,44916,42693293,699957348359,127524387619,827481735978
2014-03-04,All-Floors,Alumni,25,435,413760,4366955930,450109050,4817064980
2014-03-04,All-Floors,Others(HKUST),26,386,373573,16759777830,759812435,17519590265
2014-03-04,All-Floors,Non-HKUST,37,330,319685,3589221145,829872265,4419093410
2014-03-04,All-Floors,Total,5421,66885,64707218,1150357332830,206718242646,1357075575476
2014-03-05,1,Staff,57,695,673674,3156403588,398032068,3554435656
2014-03-05,1,TPG,65,620,704858,21396861171,3458968924,24855830095
2014-03-05,1,RPG,22,162,172778,1379211579,525169172,1904380751
2014-03-05,1,UG,658,4870,6961535,171809674177,31732905566,203542579743
2014-03-05,1,Alumni,3,19,18246,8908613,1539222,10447835
2014-03-05,1,Others(HKUST),4,83,101845,4737350430,184000227,4921350657
2014-03-05,1,Non-HKUST,3,21,26699,336843222,54769888,391613110
2014-03-05,1,Total,812,6470,8659635,202825252780,36355385067,239180637847
2014-03-05,G,Staff,97,513,453951,4562023046,1495833179,6057856225
2014-03-05,G,TPG,362,2018,1447204,60490358582,5805107831,66295466413
2014-03-05,G,RPG,150,990,784579,11904924911,1454613846,13359538757
2014-03-05,G,UG,1634,8663,5194005,96165839610,17952510102,114118349712
2014-03-05,G,Alumni,12,47,43517,333418167,55591549,389009716
2014-03-05,G,Others(HKUST),4,18,70549,159139696,38891144,198030840
2014-03-05,G,Non-HKUST,14,50,29561,250908051,54776778,305684829
2014-03-05,G,Total,2273,12299,8023366,173866612063,26857324429,200723936492
2014-03-05,LG1,Staff,104,625,428333,7139023455,4641048677,11780072132
2014-03-05,LG1,TPG,491,5450,5195799,108539266201,28665319247,137204585448
2014-03-05,LG1,RPG,173,1640,1705356,25590953790,6380823681,31971777471
2014-03-05,LG1,UG,2362,20727,20069837,244644507348,61348557740,305993065088
2014-03-05,LG1,Alumni,19,156,159314,7220497358,3347458070,10567955428
2014-03-05,LG1,Others(HKUST),10,158,75388,549932871,52371489,602304360
2014-03-05,LG1,Non-HKUST,24,79,78797,412065329,43839794,455905123
2014-03-05,LG1,Total,3183,28835,27712824,394096246352,104479418698,498575665050
2014-03-05,LG3,Staff,134,327,135344,1404163316,348377859,1752541175
2014-03-05,LG3,TPG,265,1737,1836795,24674649045,10274832392,34949481437
2014-03-05,LG3,RPG,179,799,895172,21379698787,3397590635,24777289422
2014-03-05,LG3,UG,1471,4981,4248289,66480984209,11592941480,78073925689
2014-03-05,LG3,Alumni,10,24,25921,296570877,20957396,317528273
2014-03-05,LG3,Others(HKUST),15,45,34527,240520638,31033277,271553915
2014-03-05,LG3,Non-HKUST,22,105,173699,399247460,87932842,487180302
2014-03-05,LG3,Total,2096,8018,7349747,114875834332,25753665881,140629500213
2014-03-05,LG4,Staff,100,374,433111,2031827248,963297402,2995124650
2014-03-05,LG4,TPG,360,4786,6542606,133564064067,21762448159,155326512226
2014-03-05,LG4,RPG,164,1125,1611652,27498535009,8697014952,36195549961
2014-03-05,LG4,UG,1459,8552,10047610,140950747508,24280515146,165231262654
2014-03-05,LG4,Alumni,10,119,138319,1174129847,179477723,1353607570
2014-03-05,LG4,Others(HKUST),5,130,143081,17076024752,740808968,17816833720
2014-03-05,LG4,Non-HKUST,22,120,163315,76431029,18934233,95365262
2014-03-05,LG4,Total,2120,15206,19079694,322371759460,56642496583,379014256043
2014-03-05,All-Floors,Staff,305,2534,2124413,18293440653,7846589185,26140029838
2014-03-05,All-Floors,TPG,673,14611,15727262,348665199066,69966676553,418631875619
2014-03-05,All-Floors,RPG,423,4716,5169537,87753324076,20455212286,108208536362
2014-03-05,All-Floors,UG,4013,47793,46521276,720051752852,146907430034,866959182886
2014-03-05,All-Floors,Alumni,28,365,385317,9033524862,3605023960,12638548822
2014-03-05,All-Floors,Others(HKUST),22,434,425390,22762968387,1047105105,23810073492
2014-03-05,All-Floors,Non-HKUST,47,375,472071,1475495091,260253535,1735748626
2014-03-05,All-Floors,Total,5511,70828,70825266,1208035704987,250088290658,1458123995645
2014-03-06,1,Staff,59,624,702238,18010570994,1989975232,20000546226
2014-03-06,1,TPG,69,750,1179377,36624811935,5914970454,42539782389
2014-03-06,1,RPG,24,168,201604,2152588843,481829475,2634418318
2014-03-06,1,UG,593,3598,5388011,84929399250,20454018962,105383418212
2014-03-06,1,Alumni,8,105,146007,2086971430,123118555,2210089985
2014-03-06,1,Others(HKUST),2,27,82600,80000278,17347839,97348117
2014-03-06,1,Non-HKUST,2,21,30700,33321566,7819524,41141090
2014-03-06,1,Total,757,5293,7730537,143917664296,28989080041,172906744337
2014-03-06,G,Staff,108,661,595824,4960859253,1249253810,6210113063
2014-03-06,G,TPG,295,1471,1107009,11485101162,2602153632,14087254794
2014-03-06,G,RPG,129,532,496982,5626769291,916927088,6543696379
2014-03-06,G,UG,1588,7211,5074707,75628854463,21809659131,97438513594
2014-03-06,G,Alumni,9,34,39542,1042169078,74744251,1116913329
2014-03-06,G,Others(HKUST),11,89,105743,352256435,33467879,385724314
2014-03-06,G,Non-HKUST,13,50,17152,255371452,81931785,337303237
2014-03-06,G,Total,2153,10048,7436959,99351381134,26768137576,126119518710
2014-03-06,LG1,Staff,88,505,471540,5137859932,1147910904,6285770836
2014-03-06,LG1,TPG,429,4205,4639334,64593042970,22779069043,87372112013
2014-03-06,LG1,RPG,145,1432,1629845,46540465830,39563716627,86104182457
2014-03-06,LG1,UG,2292,18076,20029742,197798258046,33449085358,231247343404
2014-03-06,LG1,Alumni,11,52,51056,64364046,11342156,75706202
2014-03-06,LG1,Others(HKUST),13,167,44204,470218417,43691838,513910255
2014-03-06,LG1,Non-HKUST,23,80,97535,316133871,43453170,359587041
2014-03-06,LG1,Total,3001,24517,26963256,314920343112,97038269096,411958612208
2014-03-06,LG3,Staff,96,218,97935,1896717308,166234473,2062951781
2014-03-06,LG3,TPG,223,1398,1793693,34428741298,6940989835,41369731133
2014-03-06,LG3,RPG,153,621,764227,15087155461,10121920257,25209075718
2014-03-06,LG3,UG,1312,4297,4242790,68670923871,13286754058,81957677929
2014-03-06,LG3,Alumni,9,59,61539,481702071,77322363,559024434
2014-03-06,LG3,Others(HKUST),8,19,27059,1956896295,777904235,2734800530
2014-03-06,LG3,Non-HKUST,10,92,151536,8573251660,376625873,8949877533
2014-03-06,LG3,Total,1811,6704,7138779,131095387964,31747751094,162843139058
2014-03-06,LG4,Staff,67,237,243439,349141031,221326455,570467486
2014-03-06,LG4,TPG,290,3613,5511196,167016437645,20366604844,187383042489
2014-03-06,LG4,RPG,151,1036,1646218,19236401516,4477355100,23713756616
2014-03-06,LG4,UG,1227,6685,8478020,118159317618,27425557531,145584875149
2014-03-06,LG4,Alumni,13,127,193519,2440535830,706551318,3147087148
2014-03-06,LG4,Others(HKUST),3,126,212886,10943727040,509735419,11453462459
2014-03-06,LG4,Non-HKUST,12,60,87789,777458677,959155068,1736613745
2014-03-06,LG4,Total,1763,11884,16373067,318923019357,54666285735,373589305092
2014-03-06,All-Floors,Staff,266,2245,2110976,30355148518,4774700874,35129849392
2014-03-06,All-Floors,TPG,631,11437,14230609,314148135010,58603787808,372751922818
2014-03-06,All-Floors,RPG,353,3789,4738876,88643380941,55561748547,144205129488
2014-03-06,All-Floors,UG,3906,39867,43213270,545186753248,116425075040,661611828288
2014-03-06,All-Floors,Alumni,24,377,491663,6115742455,993078643,7108821098
2014-03-06,All-Floors,Others(HKUST),25,428,472492,13803098465,1382147210,15185245675
2014-03-06,All-Floors,Non-HKUST,43,303,384712,9955537226,1468985420,11424522646
2014-03-06,All-Floors,Total,5248,58446,65642598,1008207795863,239209523542,1247417319405
2014-03-07,1,Staff,60,734,527491,2123565392,306545461,2430110853
2014-03-07,1,TPG,48,556,863536,19356724150,8289067745,27645791895
2014-03-07,1,RPG,17,54,59288,3468622181,246746646,3715368827
2014-03-07,1,UG,468,3106,4295298,96979527847,16038112975,113017640822
2014-03-07,1,Alumni,6,84,85651,1402310500,99399637,1501710137
2014-03-07,1,Others(HKUST),3,38,77170,46225235342,1522908601,47748143943
2014-03-07,1,Non-HKUST,7,14,19291,88913166,90770668,179683834
2014-03-07,1,Total,609,4586,5927725,169644898578,26593551733,196238450311
2014-03-07,G,Staff,100,619,634614,8030696737,996632724,9027329461
2014-03-07,G,TPG,283,1542,1152793,62296008424,6560965558,68856973982
2014-03-07,G,RPG,122,687,514720,9611734264,1422668657,11034402921
2014-03-07,G,UG,1369,6780,4527217,111737677585,25574644114,137312321699
2014-03-07,G,Alumni,13,44,67880,7536501581,4507730485,12044232066
2014-03-07,G,Others(HKUST),9,88,94845,199918425,28809628,228728053
2014-03-07,G,Non-HKUST,20,45,35749,255853776,58789945,314643721
2014-03-07,G,Total,1916,9805,7027818,199668390792,39150241111,238818631903
2014-03-07,LG1,Staff,94,529,442337,1788901137,276826918,2065728055
2014-03-07,LG1,TPG,410,4701,4776946,89799813988,17471031217,107270845205
2014-03-07,LG1,RPG,162,1410,1406099,25811442603,18211197099,44022639702
2014-03-07,LG1,UG,2168,16842,17983108,189894050158,28865083850,218759134008
2014-03-07,LG1,Alumni,17,144,112890,2866647415,3893349130,6759996545
2014-03-07,LG1,Others(HKUST),14,180,89796,1123822096,425134430,1548956526
2014-03-07,LG1,Non-HKUST,19,110,127282,464721787,117046383,581768170
2014-03-07,LG1,Total,2884,23916,24938458,311749399184,69259669027,381009068211
2014-03-07,LG3,Staff,114,283,147116,8006210132,691389473,8697599605
2014-03-07,LG3,TPG,212,1164,1470062,37479785469,5779460038,43259245507
2014-03-07,LG3,RPG,131,460,639165,12437493774,1680295745,14117789519
2014-03-07,LG3,UG,1161,3785,3773593,48828375794,12424788726,61253164520
2014-03-07,LG3,Alumni,11,141,109158,3823186745,408096350,4231283095
2014-03-07,LG3,Others(HKUST),11,26,28269,721349006,68318890,789667896
2014-03-07,LG3,Non-HKUST,9,33,32273,866286579,34535254,900821833
2014-03-07,LG3,Total,1649,5892,6199636,112162687499,21086884476,133249571975
2014-03-07,LG4,Staff,91,342,454894,4559207773,1150820730,5710028503
2014-03-07,LG4,TPG,262,2748,4450738,43369428556,9559452148,52928880704
2014-03-07,LG4,RPG,118,622,929165,14787313168,6042194913,20829508081
2014-03-07,LG4,UG,1073,5438,6986525,116753533678,18866465767,135619999445
2014-03-07,LG4,Alumni,13,110,124997,11809013954,875974025,12684987979
2014-03-07,LG4,Others(HKUST),9,113,204721,9971588700,574281238,10545869938
2014-03-07,LG4,Non-HKUST,22,125,140480,2338059730,65017495,2403077225
2014-03-07,LG4,Total,1588,9498,13291520,203588145559,37134206316,240722351875
2014-03-07,All-Floors,Staff,283,2507,2206452,24508581171,3422215306,27930796477
2014-03-07,All-Floors,TPG,561,10711,12714075,252301760587,47659976706,299961737293
2014-03-07,All-Floors,RPG,334,3233,3548437,66116605990,27603103060,93719709050
2014-03-07,All-Floors,UG,3537,35951,37565741,564193165062,101769095432,665962260494
2014-03-07,All-Floors,Alumni,29,523,500576,27437660195,9784549627,37222209822
2014-03-07,All-Floors,Others(HKUST),29,445,494801,58241913569,2619452787,60861366356
2014-03-07,All-Floors,Non-HKUST,50,327,355075,4013835038,366159745,4379994783
2014-03-07,All-Floors,Total,4823,53697,57385157,996813521612,193224552663,1190038074275
2014-03-08,1,Staff,14,306,96555,201418584,22579388,223997972
2014-03-08,1,TPG,38,287,495240,16836924750,6840246665,23677171415
2014-03-08,1,RPG,9,41,40215,421190719,163176631,584367350
2014-03-08,1,UG,82,615,859677,39071513121,19923804710,58995317831
2014-03-08,1,Alumni,5,66,108436,6780887874,298004943,7078892817
2014-03-08,1,Others(HKUST),2,2,0,1078451,500120,1578571
2014-03-08,1,Non-HKUST,2,14,25932,147946946,43681478,191628424
2014-03-08,1,Total,152,1331,1626055,63460960445,27291993935,90752954380
2014-03-08,G,Staff,39,199,168784,1572944792,664408294,2237353086
2014-03-08,G,TPG,203,735,584005,10259850439,1907816481,12167666920
2014-03-08,G,RPG,66,332,384330,5146752851,488019814,5634772665
2014-03-08,G,UG,334,1636,1573768,46773873945,32272601516,79046475461
2014-03-08,G,Alumni,27,128,104747,1910885350,266319837,2177205187
2014-03-08,G,Others(HKUST),4,11,50150,23266676,2610844,25877520
2014-03-08,G,Non-HKUST,11,44,26526,30774288,4304853,35079141
2014-03-08,G,Total,684,3085,2892310,65718348341,35606081639,101324429980
2014-03-08,LG1,Staff,26,202,255043,3393748851,287658364,3681407215
2014-03-08,LG1,TPG,394,5257,7000219,203535850896,38896989324,242432840220
2014-03-08,LG1,RPG,132,1055,1694491,30410121581,5139576313,35549697894
2014-03-08,LG1,UG,858,9118,13152944,230812077757,65418564113,296230641870
2014-03-08,LG1,Alumni,28,239,379692,1158432039,152594170,1311026209
2014-03-08,LG1,Others(HKUST),6,134,82320,1309919602,772508414,2082428016
2014-03-08,LG1,Non-HKUST,20,127,258722,5826857082,204014985,6030872067
2014-03-08,LG1,Total,1464,16132,22823431,476447007808,110871905683,587318913491
2014-03-08,LG3,Staff,22,39,13717,23313485,5538490,28851975
2014-03-08,LG3,TPG,168,605,656121,20172239244,8570606724,28742845968
2014-03-08,LG3,RPG,95,363,492892,16514096571,1249526160,17763622731
2014-03-08,LG3,UG,368,1288,1692344,69372915433,9625972032,78998887465
2014-03-08,LG3,Alumni,15,72,48873,1145144488,169436473,1314580961
2014-03-08,LG3,Others(HKUST),10,13,13922,1430898661,234756250,1665654911
2014-03-08,LG3,Non-HKUST,16,90,69882,136793554,23231658,160025212
2014-03-08,LG3,Total,694,2470,2987751,108795401436,19879067787,128674469223
2014-03-08,LG4,Staff,22,84,197067,2259530632,768996101,3028526733
2014-03-08,LG4,TPG,157,1225,1913620,34989873591,7768049775,42757923366
2014-03-08,LG4,RPG,85,387,599239,12753007478,6374516611,19127524089
2014-03-08,LG4,UG,319,1510,2270741,39217349217,10900136548,50117485765
2014-03-08,LG4,Alumni,26,288,458907,3845544583,1404242063,5249786646
2014-03-08,LG4,Others(HKUST),3,121,328743,12126625243,1208336085,13334961328
2014-03-08,LG4,Non-HKUST,11,58,115751,226250052,58930963,285181015
2014-03-08,LG4,Total,623,3673,5884068,105418180796,28483208146,133901388942
2014-03-08,All-Floors,Staff,82,830,731166,7450956344,1749180637,9200136981
2014-03-08,All-Floors,TPG,531,8109,10649205,285794738920,63983708969,349778447889
2014-03-08,All-Floors,RPG,243,2178,3211167,65245169200,13414815529,78659984729
2014-03-08,All-Floors,UG,1222,14167,19549474,425247729473,138141078919,563388808392
2014-03-08,All-Floors,Alumni,51,793,1100655,14840894334,2290597486,17131491820
2014-03-08,All-Floors,Others(HKUST),17,281,475135,14891788633,2218711713,17110500346
2014-03-08,All-Floors,Non-HKUST,39,333,496813,6368621922,334163937,6702785859
2014-03-08,All-Floors,Total,2185,26691,36213615,819839898826,222132257190,1041972156016
2014-03-09,1,Staff,7,252,57538,249196930,19458504,268655434
2014-03-09,1,TPG,27,273,531510,15550569392,5855215125,21405784517
2014-03-09,1,RPG,15,62,79945,578870257,155981775,734852032
2014-03-09,1,UG,115,857,1619511,64035062256,10719142167,74754204423
2014-03-09,1,Alumni,9,96,81228,4755618715,183131401,4938750116
2014-03-09,1,Others(HKUST),1,1,0,600147188,595868388,1196015576
2014-03-09,1,Non-HKUST,9,50,57703,1986491651,172689218,2159180869
2014-03-09,1,Total,183,1591,2427435,87755956389,17701486578,105457442967
2014-03-09,G,Staff,24,171,171338,2517049705,1219399618,3736449323
2014-03-09,G,TPG,163,801,716124,12208152841,2111754455,14319907296
2014-03-09,G,RPG,79,463,444020,12874472578,1924003712,14798476290
2014-03-09,G,UG,422,2388,2629217,40445292960,5301118297,45746411257
2014-03-09,G,Alumni,28,117,91255,1495265247,112057521,1607322768
2014-03-09,G,Others(HKUST),5,32,67934,7303100485,7131946988,14435047473
2014-03-09,G,Non-HKUST,18,92,63577,1765363853,205842133,1971205986
2014-03-09,G,Total,739,4064,4183465,78608697669,18006122724,96614820393
2014-03-09,LG1,Staff,24,278,362885,4120074450,318479002,4438553452
2014-03-09,LG1,TPG,343,5976,8031424,134225254880,26977771354,161203026234
2014-03-09,LG1,RPG,137,1657,1737471,22802059272,9359072523,32161131795
2014-03-09,LG1,UG,941,12159,14676639,159561880915,49509993741,209071874656
2014-03-09,LG1,Alumni,32,136,106407,685140428,269468108,954608536
2014-03-09,LG1,Others(HKUST),5,149,101091,653013410,55746465,708759875
2014-03-09,LG1,Non-HKUST,27,185,288912,207056454,43893940,250950394
2014-03-09,LG1,Total,1509,20540,25304829,322254479809,86534425133,408788904942
2014-03-09,LG3,Staff,20,25,5880,48012669,2714831,50727500
2014-03-09,LG3,TPG,163,788,1119219,21417940164,13537689182,34955629346
2014-03-09,LG3,RPG,108,581,699608,21256064213,7898320359,29154384572
2014-03-09,LG3,UG,472,1983,2038599,88368545062,12424304338,100792849400
2014-03-09,LG3,Alumni,21,233,158254,7324611492,3401588529,10726200021
2014-03-09,LG3,Others(HKUST),3,9,9233,16973387,4356913,21330300
2014-03-09,LG3,Non-HKUST,12,68,128801,560380018,57195151,617575169
2014-03-09,LG3,Total,799,3687,4159594,138992527005,37326169303,176318696308
2014-03-09,LG4,Staff,22,142,205620,484111797,147468558,631580355
2014-03-09,LG4,TPG,156,1926,3073100,91684028000,10212692939,101896720939
2014-03-09,LG4,RPG,81,594,990755,24472449181,12498102509,36970551690
2014-03-09,LG4,UG,378,2939,4504156,141186059608,18838937700,160024997308
2014-03-09,LG4,Alumni,39,420,642467,10673532734,1441791116,12115323850
2014-03-09,LG4,Others(HKUST),6,48,130076,14148368189,1590653800,15739021989
2014-03-09,LG4,Non-HKUST,22,207,356970,21911204898,1456759091,23367963989
2014-03-09,LG4,Total,704,6276,9903144,304559754407,46186405713,350746160120
2014-03-09,All-Floors,Staff,65,868,803261,7418445551,1707520513,9125966064
2014-03-09,All-Floors,TPG,417,9764,13471377,275085945277,58695123055,333781068332
2014-03-09,All-Floors,RPG,240,3357,3951799,81983915501,31835480878,113819396379
2014-03-09,All-Floors,UG,1291,20326,25468122,493596840801,96793496243,590390337044
2014-03-09,All-Floors,Alumni,61,1002,1079611,24934168616,5408036675,30342205291
2014-03-09,All-Floors,Others(HKUST),11,239,308334,22721602659,9378572554,32100175213
2014-03-09,All-Floors,Non-HKUST,54,602,895963,26430496874,1936379533,28366876407
2014-03-09,All-Floors,Total,2139,36158,45978467,932171415279,205754609451,1137926024730
2014-03-10,1,Staff,55,590,694623,5247223507,454232767,5701456274
2014-03-10,1,TPG,62,778,1130106,42451042945,5431659401,47882702346
2014-03-10,1,RPG,19,101,176299,8208052095,508015017,8716067112
2014-03-10,1,UG,609,4980,5955830,173202092858,33181470285,206383563143
2014-03-10,1,Alumni,5,174,108694,2730589735,166542493,2897132228
2014-03-10,1,Others(HKUST),2,34,58225,14513736650,716345020,15230081670
2014-03-10,1,Non-HKUST,5,18,20486,52355337,17349121,69704458
2014-03-10,1,Total,757,6675,8144263,246405093127,40475614104,286880707231
2014-03-10,G,Staff,95,597,526941,1770527118,610255138,2380782256
2014-03-10,G,TPG,333,1453,739475,20553384788,3693303402,24246688190
2014-03-10,G,RPG,136,698,493464,15042488157,3344897890,18387386047
2014-03-10,G,UG,1768,9334,5963754,141423896164,26685819530,168109715694
2014-03-10,G,Alumni,7,28,24037,1531617,1826641,3358258
2014-03-10,G,Others(HKUST),5,24,90627,519926638,29322235,549248873
2014-03-10,G,Non-HKUST,14,38,35450,154506019,42700116,197206135
2014-03-10,G,Total,2358,12172,7873748,179466260501,34408124952,213874385453
2014-03-10,LG1,Staff,101,412,337229,385992083,290923625,676915708
2014-03-10,LG1,TPG,437,5384,5477794,87594019140,29910723204,117504742344
2014-03-10,LG1,RPG,194,1779,1714111,46454247820,6255471609,52709719429
2014-03-10,LG1,UG,2546,22313,22043724,205110012710,68753910257,273863922967
2014-03-10,LG1,Alumni,19,117,75898,427184860,50207981,477392841
2014-03-10,LG1,Others(HKUST),7,76,27651,18316,11842,30158
2014-03-10,LG1,Non-HKUST,28,146,117869,2948783521,422809133,3371592654
2014-03-10,LG1,Total,3332,30227,29794276,342920258450,105684057651,448604316101
2014-03-10,LG3,Staff,112,275,115756,769473917,74480330,843954247
2014-03-10,LG3,TPG,247,1575,1844048,36515525907,18088741997,54604267904
2014-03-10,LG3,RPG,182,735,966010,19409528386,13193063949,32602592335
2014-03-10,LG3,UG,1574,5430,4482628,54402370011,8985825779,63388195790
2014-03-10,LG3,Alumni,9,131,75430,2698421575,236538420,2934959995
2014-03-10,LG3,Others(HKUST),4,5,123,4706837,203499,4910336
2014-03-10,LG3,Non-HKUST,14,80,131581,1030430901,174597422,1205028323
2014-03-10,LG3,Total,2142,8231,7615576,114830457534,40753451396,155583908930
2014-03-10,LG4,Staff,71,331,377536,988875672,175147868,1164023540
2014-03-10,LG4,TPG,295,3694,5574666,81702323335,16171360810,97873684145
2014-03-10,LG4,RPG,140,1105,1398379,23114240683,12016761389,35131002072
2014-03-10,LG4,UG,1564,9489,10934869,201346179014,36697745086,238043924100
2014-03-10,LG4,Alumni,11,73,118121,450776399,55782320,506558719
2014-03-10,LG4,Others(HKUST),7,85,168712,9499596220,1076458262,10576054482
2014-03-10,LG4,Non-HKUST,18,108,116366,279610087,152613970,432224057
2014-03-10,LG4,Total,2106,14885,18688649,317381601410,66345869705,383727471115
2014-03-10,All-Floors,Staff,280,2205,2052085,9162092297,1605039728,10767132025
2014-03-10,All-Floors,TPG,617,12884,14766089,268816296115,73295788814,342112084929
2014-03-10,All-Floors,RPG,391,4418,4748263,112228557141,35318209854,147546766995
2014-03-10,All-Floors,UG,4224,51546,49380805,775484550757,174304770937,949789321694
2014-03-10,All-Floors,Alumni,27,523,402180,6308504186,510897855,6819402041
2014-03-10,All-Floors,Others(HKUST),18,224,345338,24537984661,1822340858,26360325519
2014-03-10,All-Floors,Non-HKUST,47,390,421752,4465685865,810069762,5275755627
2014-03-10,All-Floors,Total,5604,72190,72116512,1201003671022,287667117808,1488670788830
2014-03-11,1,Staff,55,575,655479,4597927206,422574101,5020501307
2014-03-11,1,TPG,73,939,1271444,81918981483,16260276902,98179258385
2014-03-11,1,RPG,17,99,132806,3085868738,256312591,3342181329
2014-03-11,1,UG,699,6215,6494511,184545645098,37152464589,221698109687
2014-03-11,1,Alumni,6,143,174733,7546617230,554575215,8101192445
2014-03-11,1,Others(HKUST),3,14,24701,268566216,497684792,766251008
2014-03-11,1,Non-HKUST,12,57,56159,241427888,34708864,276136752
2014-03-11,1,Total,865,8042,8809833,282205033859,55178597054,337383630913
2014-03-11,G,Staff,105,620,559458,4647500778,470589024,5118089802
2014-03-11,G,TPG,288,1550,923382,14832179908,4009012045,18841191953
2014-03-11,G,RPG,139,793,619257,11050991052,4562246848,15613237900
2014-03-11,G,UG,1767,9239,5634624,172004813314,33014588215,205019401529
2014-03-11,G,Alumni,13,36,11450,1312879850,54863393,1367743243
2014-03-11,G,Others(HKUST),14,96,185286,5203484414,157284837,5360769251
2014-03-11,G,Non-HKUST,23,118,75460,2325806511,574196148,2900002659
2014-03-11,G,Total,2349,12452,8008917,211377655827,42842780510,254220436337
2014-03-11,LG1,Staff,107,498,373635,1007995428,95977471,1103972899
2014-03-11,LG1,TPG,447,5737,5218389,100844392477,18632227601,119476620078
2014-03-11,LG1,RPG,169,1317,1360881,12422395324,4266197717,16688593041
2014-03-11,LG1,UG,2604,22999,22531739,268482421070,76205900682,344688321752
2014-03-11,LG1,Alumni,17,140,88733,2817496792,306996071,3124492863
2014-03-11,LG1,Others(HKUST),14,117,78159,126440454,9806665,136247119
2014-03-11,LG1,Non-HKUST,44,168,134788,2475915523,183650038,2659565561
2014-03-11,LG1,Total,3402,30976,29786324,388177057068,99700756245,487877813313
2014-03-11,LG3,Staff,102,290,71737,146930049,31430771,178360820
2014-03-11,LG3,TPG,270,1743,1945467,37164739348,12509628492,49674367840
2014-03-11,LG3,RPG,181,825,986411,22280370652,2989171248,25269541900
2014-03-11,LG3,UG,1607,5880,5182991,97584255796,26599948405,124184204201
2014-03-11,LG3,Alumni,9,49,38038,2200856736,150310649,2351167385
2014-03-11,LG3,Others(HKUST),8,11,14270,63779279,16154633,79933912
2014-03-11,LG3,Non-HKUST,18,171,241501,1985274422,261271552,2246545974
2014-03-11,LG3,Total,2195,8969,8480415,161426206282,42557915750,203984122032
2014-03-11,LG4,Staff,82,377,411651,1727668285,206268303,1933936588
2014-03-11,LG4,TPG,342,4751,6808455,150357481705,37401287275,187758768980
2014-03-11,LG4,RPG,152,996,1460435,19522328140,5746144655,25268472795
2014-03-11,LG4,UG,1631,10154,11548605,187434779987,47487584491,234922364478
2014-03-11,LG4,Alumni,13,210,228599,1981545760,110569065,2092114825
2014-03-11,LG4,Others(HKUST),12,105,177183,7720009215,255658696,7975667911
2014-03-11,LG4,Non-HKUST,28,181,297772,1431878604,311824243,1743702847
2014-03-11,LG4,Total,2260,16774,20932700,370175691696,91519336728,461695028424
2014-03-11,All-Floors,Staff,268,2360,2071960,12128021746,1226839670,13354861416
2014-03-11,All-Floors,TPG,646,14720,16167137,385117774921,88812432315,473930207236
2014-03-11,All-Floors,RPG,400,4030,4559790,68361953906,17820073059,86182026965
2014-03-11,All-Floors,UG,4247,54487,51392470,910051915265,220460486382,1130512401647
2014-03-11,All-Floors,Alumni,27,578,541553,15859396368,1177314393,17036710761
2014-03-11,All-Floors,Others(HKUST),30,343,479599,13382279578,936589623,14318869201
2014-03-11,All-Floors,Non-HKUST,72,695,805680,8460302948,1365650845,9825953793
2014-03-11,All-Floors,Total,5690,77213,76018189,1413361644732,331799386287,1745161031019
2014-03-12,1,Staff,57,545,656032,3128547433,591669435,3720216868
2014-03-12,1,TPG,81,1014,1109811,67991527777,6611228404,74602756181
2014-03-12,1,RPG,23,150,251839,3537074289,3931021583,7468095872
2014-03-12,1,UG,710,5610,6374643,182892035218,26451127260,209343162478
2014-03-12,1,Alumni,6,122,118032,8706850821,803828592,9510679413
2014-03-12,1,Others(HKUST),5,17,38952,725377693,67231392,792609085
2014-03-12,1,Non-HKUST,15,69,45524,710066718,46603065,756669783
2014-03-12,1,Total,897,7527,8594833,267691479949,38502709731,306194189680
2014-03-12,G,Staff,107,608,469701,2664264085,518424036,3182688121
2014-03-12,G,TPG,319,1661,934185,21252882691,3835594591,25088477282
2014-03-12,G,RPG,143,893,658813,15081232520,1570589290,16651821810
2014-03-12,G,UG,1766,8710,5891115,133199108845,15695679394,148894788239
2014-03-12,G,Alumni,16,46,88674,285321107,19634348,304955455
2014-03-12,G,Others(HKUST),10,55,129060,7491146591,700739938,8191886529
2014-03-12,G,Non-HKUST,27,68,58282,209743096,21859395,231602491
2014-03-12,G,Total,2388,12041,8229830,180183698935,22362520992,202546219927
2014-03-12,LG1,Staff,101,389,286073,965562260,102239537,1067801797
2014-03-12,LG1,TPG,456,5196,5707509,79457641263,17848813076,97306454339
2014-03-12,LG1,RPG,182,1511,1559580,21361845380,3364249353,24726094733
2014-03-12,LG1,UG,2490,20302,21818386,240839274513,58035152561,298874427074
2014-03-12,LG1,Alumni,19,163,108273,3486534337,411093929,3897628266
2014-03-12,LG1,Others(HKUST),8,129,26717,35604004,2375085,37979089
2014-03-12,LG1,Non-HKUST,37,148,106304,973466317,180506534,1153972851
2014-03-12,LG1,Total,3293,27838,29612842,347119928074,79944430075,427064358149
2014-03-12,LG3,Staff,113,288,104990,220003782,32087277,252091059
2014-03-12,LG3,TPG,289,1596,1918393,43615400901,15861867635,59477268536
2014-03-12,LG3,RPG,174,823,930402,9530174687,12063740756,21593915443
2014-03-12,LG3,UG,1456,4746,4731237,84310105213,9881446529,94191551742
2014-03-12,LG3,Alumni,17,203,150050,1065735103,346511840,1412246943
2014-03-12,LG3,Others(HKUST),5,14,1797,2099668,676925,2776593
2014-03-12,LG3,Non-HKUST,19,78,86200,317522146,58566593,376088739
2014-03-12,LG3,Total,2073,7748,7923069,139061041500,38244897555,177305939055
2014-03-12,LG4,Staff,132,534,578505,2078016660,803021017,2881037677
2014-03-12,LG4,TPG,350,4665,6288851,131855975836,36670749928,168526725764
2014-03-12,LG4,RPG,172,1112,1373726,22765689483,6750291806,29515981289
2014-03-12,LG4,UG,1556,9704,11806787,169249892883,24737737325,193987630208
2014-03-12,LG4,Alumni,17,322,337907,4281868205,289333692,4571201897
2014-03-12,LG4,Others(HKUST),8,103,199815,14760865347,505511359,15266376706
2014-03-12,LG4,Non-HKUST,20,107,148400,447447237,64114551,511561788
2014-03-12,LG4,Total,2255,16547,20733991,345439755651,69820759678,415260515329
2014-03-12,All-Floors,Staff,298,2364,2095301,9056394220,2047441302,11103835522
2014-03-12,All-Floors,TPG,655,14132,15958749,344173428468,80828253634,425001682102
2014-03-12,All-Floors,RPG,405,4489,4774360,72276016359,27679892788,99955909147
2014-03-12,All-Floors,UG,4199,49072,50622168,810490416672,134801143069,945291559741
2014-03-12,All-Floors,Alumni,31,856,802936,17826309573,1870402401,19696711974
2014-03-12,All-Floors,Others(HKUST),24,318,396341,23015093303,1276534699,24291628002
2014-03-12,All-Floors,Non-HKUST,72,470,444710,2658245514,371650138,3029895652
2014-03-12,All-Floors,Total,5684,71701,75094565,1279495904109,248875318031,1528371222140
2014-03-13,1,Staff,56,533,727438,5862561691,612857276,6475418967
2014-03-13,1,TPG,64,660,1113179,27273129909,5335981021,32609110930
2014-03-13,1,RPG,25,91,147277,4257346593,287024386,4544370979
2014-03-13,1,UG,650,5000,6427932,212995666500,33447384387,246443050887
2014-03-13,1,Alumni,5,36,74507,3794360661,633829816,4428190477
2014-03-13,1,Others(HKUST),3,10,11204,1502277088,55535000,1557812088
2014-03-13,1,Non-HKUST,9,44,25550,328267141,55080019,383347160
2014-03-13,1,Total,812,6374,8527087,256013609583,40427691905,296441301488
2014-03-13,G,Staff,110,798,551195,5915123170,1030556209,6945679379
2014-03-13,G,TPG,307,1658,876358,20405625299,2640831116,23046456415
2014-03-13,G,RPG,157,876,802195,7603959095,2296458210,9900417305
2014-03-13,G,UG,1591,7682,4997439,137068112779,18320051392,155388164171
2014-03-13,G,Alumni,11,33,45131,2246142135,153394017,2399536152
2014-03-13,G,Others(HKUST),7,50,114890,208289203,71626381,279915584
2014-03-13,G,Non-HKUST,20,53,56791,506214399,27557883,533772282
2014-03-13,G,Total,2203,11150,7443999,173953466080,24540475208,198493941288
2014-03-13,LG1,Staff,96,380,267949,2570260746,160380356,2730641102
2014-03-13,LG1,TPG,462,5111,5924576,91171480295,23479719998,114651200293
2014-03-13,LG1,RPG,187,1375,1748679,16359062192,6637296957,22996359149
2014-03-13,LG1,UG,2328,18863,21625168,219809674268,35583338526,255393012794
2014-03-13,LG1,Alumni,12,87,39191,81657579,15160736,96818315
2014-03-13,LG1,Others(HKUST),8,127,35270,102657,255116,357773
2014-03-13,LG1,Non-HKUST,23,96,110901,152437483,63856490,216293973
2014-03-13,LG1,Total,3116,26039,29751734,330144675220,65940008179,396084683399
2014-03-13,LG3,Staff,113,267,116634,1829584760,148146245,1977731005
2014-03-13,LG3,TPG,265,1481,2066366,26830874356,6900302774,33731177130
2014-03-13,LG3,RPG,155,586,794504,7641475904,1784782323,9426258227
2014-03-13,LG3,UG,1344,4328,4192424,67549957113,12026940170,79576897283
2014-03-13,LG3,Alumni,8,162,85495,1065708988,175603619,1241312607
2014-03-13,LG3,Others(HKUST),8,10,0,162537,55104,217641
2014-03-13,LG3,Non-HKUST,9,125,162374,855661108,308849407,1164510515
2014-03-13,LG3,Total,1902,6959,7417797,105773424766,21344679642,127118104408
2014-03-13,LG4,Staff,80,428,481043,768888695,115939078,884827773
2014-03-13,LG4,TPG,340,4316,6028826,96232532352,19610907387,115843439739
2014-03-13,LG4,RPG,144,1075,1417929,23753188664,3779488311,27532676975
2014-03-13,LG4,UG,1397,8421,10393628,145366323843,23566151841,168932475684
2014-03-13,LG4,Alumni,13,113,160540,1513741418,97035601,1610777019
2014-03-13,LG4,Others(HKUST),6,77,160816,2633348017,126821583,2760169600
2014-03-13,LG4,Non-HKUST,15,88,79522,1399597616,120209507,1519807123
2014-03-13,LG4,Total,1995,14518,18722304,271667620605,47416553308,319084173913
2014-03-13,All-Floors,Staff,269,2406,2144259,16946419062,2067879164,19014298226
2014-03-13,All-Floors,TPG,632,13226,16009305,261913642211,57967742296,319881384507
2014-03-13,All-Floors,RPG,393,4003,4910584,59615032448,14785050187,74400082635
2014-03-13,All-Floors,UG,3975,44294,47636591,782789734503,122943866316,905733600819
2014-03-13,All-Floors,Alumni,24,431,404864,8701610781,1075023789,9776634570
2014-03-13,All-Floors,Others(HKUST),21,274,322180,4344179502,254293184,4598472686
2014-03-13,All-Floors,Non-HKUST,53,406,435138,3242177747,575553306,3817731053
2014-03-13,All-Floors,Total,5367,65040,71862921,1137552796254,199669408242,1337222204496
2014-03-14,1,Staff,49,474,528749,4105167470,391971573,4497139043
2014-03-14,1,TPG,59,610,926952,16194616178,12285624394,28480240572
2014-03-14,1,RPG,19,98,168746,3850519911,609771701,4460291612
2014-03-14,1,UG,484,3125,4402386,108965238821,24371256329,133336495150
2014-03-14,1,Alumni,6,93,120164,8358917355,2637344213,10996261568
2014-03-14,1,Others(HKUST),3,7,31603,217662405,18934359,236596764
2014-03-14,1,Non-HKUST,1,2,113,0,0,0
2014-03-14,1,Total,621,4409,6178713,141692122140,40314902569,182007024709
2014-03-14,G,Staff,100,590,464222,3229837837,539431312,3769269149
2014-03-14,G,TPG,254,1134,805683,10028605087,9714756736,19743361823
2014-03-14,G,RPG,130,658,637490,17255377862,7708127257,24963505119
2014-03-14,G,UG,1356,6373,4673880,124359020711,16470564529,140829585240
2014-03-14,G,Alumni,12,35,37738,11137894908,1005145477,12143040385
2014-03-14,G,Others(HKUST),10,34,60570,40671859,8089700,48761559
2014-03-14,G,Non-HKUST,11,32,4410,55801643,12839137,68640780
2014-03-14,G,Total,1873,8856,6683993,166107209907,35458954148,201566164055
2014-03-14,LG1,Staff,75,464,427082,3169857811,232001082,3401858893
2014-03-14,LG1,TPG,398,4373,5650161,103212511036,19694349244,122906860280
2014-03-14,LG1,RPG,154,1164,1504946,58605732878,5213584239,63819317117
2014-03-14,LG1,UG,1970,16324,18959890,209838758306,48563648257,258402406563
2014-03-14,LG1,Alumni,19,134,154469,7876204948,1409083477,9285288425
2014-03-14,LG1,Others(HKUST),9,118,31983,160910948,22286760,183197708
2014-03-14,LG1,Non-HKUST,32,187,252399,3547803051,361376762,3909179813
2014-03-14,LG1,Total,2657,22764,26980930,386411778978,75496329821,461908108799
2014-03-14,LG3,Staff,91,235,179501,1118402194,138197221,1256599415
2014-03-14,LG3,TPG,231,1518,1804362,20302285711,4086937416,24389223127
2014-03-14,LG3,RPG,149,459,573887,28758750038,3899237340,32657987378
2014-03-14,LG3,UG,1124,3361,3267132,54745241081,6495902503,61241143584
2014-03-14,LG3,Alumni,10,114,114902,9850629395,4912215376,14762844771
2014-03-14,LG3,Others(HKUST),7,8,5651,21823400,3148589,24971989
2014-03-14,LG3,Non-HKUST,15,101,151919,1244678881,110433439,1355112320
2014-03-14,LG3,Total,1627,5796,6097354,116041810700,19646071884,135687882584
2014-03-14,LG4,Staff,90,372,529025,2983918529,576363956,3560282485
2014-03-14,LG4,TPG,242,2494,4382147,90343698065,12613664285,102957362350
2014-03-14,LG4,RPG,119,618,991596,16488534033,4857881971,21346416004
2014-03-14,LG4,UG,1089,5367,6953653,112793303401,22212683171,135005986572
2014-03-14,LG4,Alumni,15,192,232221,2324714936,964966329,3289681265
2014-03-14,LG4,Others(HKUST),8,83,227890,5138638820,566566651,5705205471
2014-03-14,LG4,Non-HKUST,16,68,85608,198427708,15634744,214062452
2014-03-14,LG4,Total,1579,9194,13402140,230271235492,41807761107,272078996599
2014-03-14,All-Floors,Staff,248,2135,2128579,14607183841,1877965144,16485148985
2014-03-14,All-Floors,TPG,547,10129,13569305,240081716077,58395332075,298477048152
2014-03-14,All-Floors,RPG,356,2997,3876665,124958914722,22288602508,147247517230
2014-03-14,All-Floors,UG,3452,34550,38256941,610701562320,118114054789,728815617109
2014-03-14,All-Floors,Alumni,30,568,659494,39548361542,10928754872,50477116414
2014-03-14,All-Floors,Others(HKUST),23,250,357697,5579707432,619026059,6198733491
2014-03-14,All-Floors,Non-HKUST,52,390,494449,5046711283,500284082,5546995365
2014-03-14,All-Floors,Total,4708,51019,59343130,1040524157217,212724019529,1253248176746
2014-03-15,1,Staff,12,165,149379,62882943,11978018,74860961
2014-03-15,1,TPG,24,222,371263,14166776507,4689792606,18856569113
2014-03-15,1,RPG,12,47,44559,1537545501,1745347305,3282892806
2014-03-15,1,UG,108,783,1465748,60861780157,9849415285,70711195442
2014-03-15,1,Alumni,9,40,89050,1257677787,960758138,2218435925
2014-03-15,1,Others(HKUST),1,4,118,13738956,642158,14381114
2014-03-15,1,Non-HKUST,2,22,54989,3631290560,110014386,3741304946
2014-03-15,1,Total,168,1283,2175106,81531692411,17367947896,98899640307
2014-03-15,G,Staff,43,242,231118,4928208504,881764651,5809973155
2014-03-15,G,TPG,177,903,771095,29031866391,4531341313,33563207704
2014-03-15,G,RPG,76,374,325604,8356906885,1117934177,9474841062
2014-03-15,G,UG,428,2365,2395905,68476820767,15205444636,83682265403
2014-03-15,G,Alumni,30,66,27862,216880468,12018975,228899443
2014-03-15,G,Others(HKUST),5,23,46479,190578554,20523478,211102032
2014-03-15,G,Non-HKUST,17,65,51417,1929479721,274095301,2203575022
2014-03-15,G,Total,776,4038,3849480,113130741290,22043122531,135173863821
2014-03-15,LG1,Staff,33,254,401622,6759689205,1065363369,7825052574
2014-03-15,LG1,TPG,374,4767,6358770,166281382389,36749483743,203030866132
2014-03-15,LG1,RPG,133,1267,1869095,24589977677,6546652719,31136630396
2014-03-15,LG1,UG,987,11714,15915649,205228576444,44700711799,249929288243
2014-03-15,LG1,Alumni,39,299,329259,2122220737,169403812,2291624549
2014-03-15,LG1,Others(HKUST),9,126,46526,18721330,3271141,21992471
2014-03-15,LG1,Non-HKUST,25,222,272789,5412828896,403966752,5816795648
2014-03-15,LG1,Total,1600,18649,25193710,410413396678,89638853335,500052250013
2014-03-15,LG3,Staff,29,109,112006,1524978153,152207843,1677185996
2014-03-15,LG3,TPG,159,660,794696,23767950981,7080920966,30848871947
2014-03-15,LG3,RPG,88,405,476218,26236907798,3843867894,30080775692
2014-03-15,LG3,UG,435,1403,1661932,37422110607,3235177056,40657287663
2014-03-15,LG3,Alumni,26,183,172519,1254964553,364169398,1619133951
2014-03-15,LG3,Others(HKUST),4,9,11662,441830303,77619586,519449889
2014-03-15,LG3,Non-HKUST,14,87,146228,594367521,117138649,711506170
2014-03-15,LG3,Total,755,2856,3375261,91243109916,14871101392,106114211308
2014-03-15,LG4,Staff,24,231,203139,5524064237,265168522,5789232759
2014-03-15,LG4,TPG,210,1682,2364296,65061526206,28384759269,93446285475
2014-03-15,LG4,RPG,85,579,764374,16914201277,1473753000,18387954277
2014-03-15,LG4,UG,433,3101,4504084,85101845942,18781412755,103883258697
2014-03-15,LG4,Alumni,50,505,745298,13654906272,1988291808,15643198080
2014-03-15,LG4,Others(HKUST),5,90,313367,12378910940,601888388,12980799328
2014-03-15,LG4,Non-HKUST,22,170,244542,3212669266,181040686,3393709952
2014-03-15,LG4,Total,829,6358,9139100,201848124140,51676314428,253524438568
2014-03-15,All-Floors,Staff,88,1001,1097264,18799823042,2376482403,21176305445
2014-03-15,All-Floors,TPG,509,8234,10660120,298309502474,81436297897,379745800371
2014-03-15,All-Floors,RPG,240,2672,3479850,77635539138,14727555095,92363094233
2014-03-15,All-Floors,UG,1401,19366,25943318,457091133917,91772161531,548863295448
2014-03-15,All-Floors,Alumni,77,1093,1363988,18506649817,3494642131,22001291948
2014-03-15,All-Floors,Others(HKUST),17,252,418152,13043780083,703944751,13747724834
2014-03-15,All-Floors,Non-HKUST,48,566,769965,14780635964,1086255774,15866891738
2014-03-15,All-Floors,Total,2380,33184,43732657,898167064435,195597339582,1093764404017
2014-03-16,1,Staff,11,182,147204,398782630,46437557,445220187
2014-03-16,1,TPG,33,348,525115,118281220082,7457093268,125738313350
2014-03-16,1,RPG,22,109,199188,1721748053,924123239,2645871292
2014-03-16,1,UG,161,1377,2299820,61810346214,14841365380,76651711594
2014-03-16,1,Alumni,10,96,153678,2684720587,752323412,3437043999
2014-03-16,1,Others(HKUST),0,0,0,0,0,0
2014-03-16,1,Non-HKUST,2,4,14151,116017863,23572111,139589974
2014-03-16,1,Total,239,2116,3339156,185012835429,24044914967,209057750396
2014-03-16,G,Staff,35,265,251914,6172567273,902193168,7074760441
2014-03-16,G,TPG,174,1069,780054,13538663020,2737371565,16276034585
2014-03-16,G,RPG,82,409,362729,12236813486,6032882800,18269696286
2014-03-16,G,UG,519,3482,3113900,82880457936,20893473243,103773931179
2014-03-16,G,Alumni,34,138,74755,1905461370,59891607,1965352977
2014-03-16,G,Others(HKUST),6,32,60426,186511627,27730827,214242454
2014-03-16,G,Non-HKUST,21,49,15857,252302788,426531414,678834202
2014-03-16,G,Total,871,5444,4659635,117172777500,31080074624,148252852124
2014-03-16,LG1,Staff,24,220,246349,8561998107,368598988,8930597095
2014-03-16,LG1,TPG,361,5765,7434097,157536012669,47365354459,204901367128
2014-03-16,LG1,RPG,122,1260,1843419,18525814879,6657322122,25183137001
2014-03-16,LG1,UG,1067,13615,18520857,172162053938,31032511641,203194565579
2014-03-16,LG1,Alumni,35,182,190189,533776172,149203345,682979517
2014-03-16,LG1,Others(HKUST),3,61,83599,176466627,5046205,181512832
2014-03-16,LG1,Non-HKUST,32,230,318829,3703659515,442582875,4146242390
2014-03-16,LG1,Total,1644,21333,28637339,361199781907,86020619635,447220401542
2014-03-16,LG3,Staff,24,48,74030,844469265,226457821,1070927086
2014-03-16,LG3,TPG,154,946,1359839,26627254948,5465783739,32093038687
2014-03-16,LG3,RPG,116,559,614258,36516156165,6499615605,43015771770
2014-03-16,LG3,UG,488,2281,2334325,40159198779,6175632850,46334831629
2014-03-16,LG3,Alumni,29,177,162074,2647681051,1596007574,4243688625
2014-03-16,LG3,Others(HKUST),6,13,11881,291473892,38357933,329831825
2014-03-16,LG3,Non-HKUST,16,155,310430,2785889820,617396522,3403286342
2014-03-16,LG3,Total,833,4179,4866837,109872123920,20619252044,130491375964
2014-03-16,LG4,Staff,25,107,103513,3082997209,219710819,3302708028
2014-03-16,LG4,TPG,182,2276,3410396,65455971528,20219751447,85675722975
2014-03-16,LG4,RPG,91,588,853998,24900630110,8425571112,33326201222
2014-03-16,LG4,UG,450,3600,5577108,156026659494,30237489369,186264148863
2014-03-16,LG4,Alumni,41,492,743776,9576602468,7065028266,16641630734
2014-03-16,LG4,Others(HKUST),7,61,238435,10987536136,348685155,11336221291
2014-03-16,LG4,Non-HKUST,24,246,527110,6611635920,841009689,7452645609
2014-03-16,LG4,Total,820,7370,11454336,276642032865,67357245857,343999278722
2014-03-16,All-Floors,Staff,69,822,823010,19060814484,1763398353,20824212837
2014-03-16,All-Floors,TPG,435,10404,13509501,381439122247,83245354478,464684476725
2014-03-16,All-Floors,RPG,254,2925,3873592,93901162693,28539514878,122440677571
2014-03-16,All-Floors,UG,1447,24355,31846010,513038716361,103180472483,616219188844
2014-03-16,All-Floors,Alumni,66,1085,1324472,17348241648,9622454204,26970695852
2014-03-16,All-Floors,Others(HKUST),14,167,394341,11641988282,419820120,12061808402
2014-03-16,All-Floors,Non-HKUST,52,684,1186377,13469505906,2351092611,15820598517
2014-03-16,All-Floors,Total,2337,40442,52957303,1049899551621,229122107127,1279021658748
2014-03-17,1,Staff,55,540,624800,3847697401,1425929723,5273627124
2014-03-17,1,TPG,81,827,1190905,23741832462,5016646403,28758478865
2014-03-17,1,RPG,24,417,272525,13122553739,1881350589,15003904328
2014-03-17,1,UG,774,6068,7756031,166658384099,66882785734,233541169833
2014-03-17,1,Alumni,5,94,108362,1280008386,144979426,1424987812
2014-03-17,1,Others(HKUST),4,40,24098,489349932,39370936,528720868
2014-03-17,1,Non-HKUST,3,14,18249,124608220,11039014,135647234
2014-03-17,1,Total,946,8000,9994970,209264434239,75402101825,284666536064
2014-03-17,G,Staff,110,697,596300,5538560092,642905628,6181465720
2014-03-17,G,TPG,333,1865,952010,15416583955,4334841246,19751425201
2014-03-17,G,RPG,166,862,639469,14646799497,1376107381,16022906878
2014-03-17,G,UG,2035,10097,6022150,130980086459,28260124005,159240210464
2014-03-17,G,Alumni,17,64,35665,206411007,43987870,250398877
2014-03-17,G,Others(HKUST),6,41,67031,272301036,46472372,318773408
2014-03-17,G,Non-HKUST,27,128,127024,3787098855,5641416451,9428515306
2014-03-17,G,Total,2694,13754,8439649,170847840901,40345854953,211193695854
2014-03-17,LG1,Staff,95,459,324516,8351570782,527905320,8879476102
2014-03-17,LG1,TPG,483,5474,5231467,68975829259,23173987771,92149817030
2014-03-17,LG1,RPG,178,1412,1324069,19525670536,5197708348,24723378884
2014-03-17,LG1,UG,2625,23805,24466375,283376079160,70945788300,354321867460
2014-03-17,LG1,Alumni,16,142,112010,4249118979,2893887466,7143006445
2014-03-17,LG1,Others(HKUST),9,98,55102,45978676,4686048,50664724
2014-03-17,LG1,Non-HKUST,39,399,238082,3367735028,163960032,3531695060
2014-03-17,LG1,Total,3445,31789,31751621,387891982420,102907923285,490799905705
2014-03-17,LG3,Staff,145,268,155402,917324012,986799043,1904123055
2014-03-17,LG3,TPG,283,1746,1897548,48967295806,38995805195,87963101001
2014-03-17,LG3,RPG,150,688,872556,13273754784,6149784619,19423539403
2014-03-17,LG3,UG,1590,6291,5856233,129931088917,15614238812,145545327729
2014-03-17,LG3,Alumni,7,14,12278,2514098,4373590,6887688
2014-03-17,LG3,Others(HKUST),11,38,16481,221116823,49366500,270483323
2014-03-17,LG3,Non-HKUST,13,68,173848,1523808630,90747371,1614556001
2014-03-17,LG3,Total,2199,9113,8984346,194836903070,61891115130,256728018200
2014-03-17,LG4,Staff,112,497,476215,3342891283,376271497,3719162780
2014-03-17,LG4,TPG,355,5560,6707263,199606265674,41530004757,241136270431
2014-03-17,LG4,RPG,136,847,1124862,9979659608,2222798759,12202458367
2014-03-17,LG4,UG,1703,13277,14757387,185878644233,34330091947,220208736180
2014-03-17,LG4,Alumni,12,212,228929,1705659062,102523149,1808182211
2014-03-17,LG4,Others(HKUST),7,125,207310,4928243050,222102187,5150345237
2014-03-17,LG4,Non-HKUST,25,177,242615,1995458393,219040831,2214499224
2014-03-17,LG4,Total,2350,20695,23744581,407436821303,79002833127,486439654430
2014-03-17,All-Floors,Staff,323,2461,2177233,21998043570,3959811211,25957854781
2014-03-17,All-Floors,TPG,656,15472,15979193,356707807156,113051285372,469759092528
2014-03-17,All-Floors,RPG,392,4226,4233481,70548438164,16827749696,87376187860
2014-03-17,All-Floors,UG,4320,59538,58858176,896824282868,216033028798,1112857311666
2014-03-17,All-Floors,Alumni,28,526,497244,7443711532,3189751501,10633463033
2014-03-17,All-Floors,Others(HKUST),25,342,370022,5956989517,361998043,6318987560
2014-03-17,All-Floors,Non-HKUST,64,786,799818,10798709126,6126203699,16924912825
2014-03-17,All-Floors,Total,5808,83351,82915167,1370277981933,359549828320,1729827810253
2014-03-18,1,Staff,62,649,773917,5551331855,629538469,6180870324
2014-03-18,1,TPG,73,922,1412820,51499194245,6447253038,57946447283
2014-03-18,1,RPG,19,158,200614,8673488441,5056656418,13730144859
2014-03-18,1,UG,742,5715,7570002,213899473214,64038595494,277938068708
2014-03-18,1,Alumni,2,27,31465,424255006,48270811,472525817
2014-03-18,1,Others(HKUST),2,16,38999,169546781,15136353,184683134
2014-03-18,1,Non-HKUST,9,29,47417,703045828,395344170,1098389998
2014-03-18,1,Total,909,7516,10075234,280920335370,76630794753,357551130123
2014-03-18,G,Staff,117,663,594778,8953199124,1026132589,9979331713
2014-03-18,G,TPG,347,2034,1089529,39093326552,4366301892,43459628444
2014-03-18,G,RPG,127,771,549651,35909854859,3527418366,39437273225
2014-03-18,G,UG,1941,9606,6272623,110763001180,27349428220,138112429400
2014-03-18,G,Alumni,4,13,5035,3673410,254726,3928136
2014-03-18,G,Others(HKUST),6,22,45666,30809603,18282516,49092119
2014-03-18,G,Non-HKUST,20,51,10420,3459467,1659549,5119016
2014-03-18,G,Total,2562,13160,8567702,194757324195,36289477858,231046802053
2014-03-18,LG1,Staff,106,488,350043,2532061134,216642115,2748703249
2014-03-18,LG1,TPG,474,5281,5459492,69832701593,15335599760,85168301353
2014-03-18,LG1,RPG,180,1229,1358475,7559455998,4514162445,12073618443
2014-03-18,LG1,UG,2657,23066,25023034,277061786638,62686468246,339748254884
2014-03-18,LG1,Alumni,10,30,22456,766279546,856117034,1622396580
2014-03-18,LG1,Others(HKUST),9,105,57479,7195861,1538664,8734525
2014-03-18,LG1,Non-HKUST,32,195,130514,508011384,34965138,542976522
2014-03-18,LG1,Total,3468,30394,32401493,358267492154,83645493402,441912985556
2014-03-18,LG3,Staff,138,357,218666,2173294114,797641114,2970935228
2014-03-18,LG3,TPG,284,1537,1755749,59544961232,10677349954,70222311186
2014-03-18,LG3,RPG,192,762,708019,7765817477,1762006430,9527823907
2014-03-18,LG3,UG,1560,5700,5740211,58655676926,8668946592,67324623518
2014-03-18,LG3,Alumni,5,34,40932,304857785,47613832,352471617
2014-03-18,LG3,Others(HKUST),6,25,15042,7330211,1565401,8895612
2014-03-18,LG3,Non-HKUST,14,67,129516,785147258,121709014,906856272
2014-03-18,LG3,Total,2199,8482,8608135,129237085003,22076832337,151313917340
2014-03-18,LG4,Staff,91,304,335182,1661890474,1330610893,2992501367
2014-03-18,LG4,TPG,354,5038,6943521,176451534331,48487332953,224938867284
2014-03-18,LG4,RPG,158,940,1313138,15274797606,2263350295,17538147901
2014-03-18,LG4,UG,1795,12739,14946090,249239709295,47120759074,296360468369
2014-03-18,LG4,Alumni,7,161,128767,211679080,47003251,258682331
2014-03-18,LG4,Others(HKUST),4,108,163308,15468117012,786142486,16254259498
2014-03-18,LG4,Non-HKUST,20,164,268098,1571056804,204512157,1775568961
2014-03-18,LG4,Total,2429,19454,24098104,459878784602,100239711109,560118495711
2014-03-18,All-Floors,Staff,316,2461,2272586,20871776701,4000565180,24872341881
2014-03-18,All-Floors,TPG,674,14812,16661111,396421717953,85313837597,481735555550
2014-03-18,All-Floors,RPG,416,3860,4129897,75183414381,17123593954,92307008335
2014-03-18,All-Floors,UG,4376,56826,59551960,909619647253,209864197626,1119483844879
2014-03-18,All-Floors,Alumni,12,265,228655,1710744827,999259654,2710004481
2014-03-18,All-Floors,Others(HKUST),18,276,320494,15682999468,822665420,16505664888
2014-03-18,All-Floors,Non-HKUST,60,506,585965,3570720741,758190028,4328910769
2014-03-18,All-Floors,Total,5872,79006,83750668,1423061021324,318882309459,1741943330783
2014-03-19,1,Staff,65,731,819677,2796653301,968686438,3765339739
2014-03-19,1,TPG,69,790,1263431,28126350850,6801234372,34927585222
2014-03-19,1,RPG,36,222,361210,31100741420,4682599780,35783341200
2014-03-19,1,UG,764,5766,7608732,162523223238,34813071983,197336295221
2014-03-19,1,Alumni,2,15,45782,2230689538,183165952,2413855490
2014-03-19,1,Others(HKUST),5,11,80103,2196033422,180635589,2376669011
2014-03-19,1,Non-HKUST,8,62,62617,1393412643,76000348,1469412991
2014-03-19,1,Total,949,7597,10241552,230367104412,47705394462,278072498874
2014-03-19,G,Staff,102,647,554267,4802710905,1203550592,6006261497
2014-03-19,G,TPG,362,1960,1271236,18968876782,3521167972,22490044754
2014-03-19,G,RPG,137,729,720160,7820575057,1074134397,8894709454
2014-03-19,G,UG,1906,9595,6762051,110497041929,12155362255,122652404184
2014-03-19,G,Alumni,7,86,71913,11446992022,1874023278,13321015300
2014-03-19,G,Others(HKUST),7,30,69122,3755387,2418192,6173579
2014-03-19,G,Non-HKUST,20,57,94976,4024344856,588485435,4612830291
2014-03-19,G,Total,2541,13104,9543725,157564296938,20419142121,177983439059
2014-03-19,LG1,Staff,92,478,368650,3766867516,824127928,4590995444
2014-03-19,LG1,TPG,507,5469,6276951,103835535258,16388743387,120224278645
2014-03-19,LG1,RPG,180,943,1104496,8507125858,2232420367,10739546225
2014-03-19,LG1,UG,2615,22756,27513137,264876608929,57087429668,321964038597
2014-03-19,LG1,Alumni,9,58,20332,136127661,29881777,166009438
2014-03-19,LG1,Others(HKUST),10,131,81776,75800352,24381068,100181420
2014-03-19,LG1,Non-HKUST,31,177,161553,13667968094,384846570,14052814664
2014-03-19,LG1,Total,3444,30012,35526895,394866033668,76971830765,471837864433
2014-03-19,LG3,Staff,95,224,148960,1979334292,184111868,2163446160
2014-03-19,LG3,TPG,279,1767,2087734,35195722094,5252955508,40448677602
2014-03-19,LG3,RPG,167,782,859097,16751878378,3657381280,20409259658
2014-03-19,LG3,UG,1590,5736,5722333,67886718753,16078977171,83965695924
2014-03-19,LG3,Alumni,7,89,39259,825213348,233713061,1058926409
2014-03-19,LG3,Others(HKUST),8,11,7359,246379633,52922753,299302386
2014-03-19,LG3,Non-HKUST,16,86,134741,306611448,25716167,332327615
2014-03-19,LG3,Total,2162,8695,8999483,123191857946,25485777808,148677635754
2014-03-19,LG4,Staff,78,345,309913,4546512194,937748613,5484260807
2014-03-19,LG4,TPG,386,5716,7493532,262470082982,34464763143,296934846125
2014-03-19,LG4,RPG,163,1165,1732263,37056710223,3904600086,40961310309
2014-03-19,LG4,UG,1664,13282,15589150,258240531430,53968079544,312208610974
2014-03-19,LG4,Alumni,8,130,122722,1894051644,54687329,1948738973
2014-03-19,LG4,Others(HKUST),8,117,206976,19144012554,3472130824,22616143378
2014-03-19,LG4,Non-HKUST,24,91,133121,134862892,42953527,177816419
2014-03-19,LG4,Total,2331,20846,25587677,583486763919,96844963066,680331726985
2014-03-19,All-Floors,Staff,276,2425,2201467,17892078208,4118225439,22010303647
2014-03-19,All-Floors,TPG,694,15702,18392884,448596567966,66428864382,515025432348
2014-03-19,All-Floors,RPG,405,3841,4777226,101237030936,15551135910,116788166846
2014-03-19,All-Floors,UG,4305,57135,63195403,864024124279,174102920621,1038127044900
2014-03-19,All-Floors,Alumni,14,378,300008,16533074213,2375471397,18908545610
2014-03-19,All-Floors,Others(HKUST),23,300,445336,21665981348,3732488426,25398469774
2014-03-19,All-Floors,Non-HKUST,62,473,587008,19527199933,1118002047,20645201980
2014-03-19,All-Floors,Total,5779,80254,89899332,1489476056883,267427108222,1756903165105
2014-03-20,1,Staff,69,745,837010,4144726858,785631032,4930357890
2014-03-20,1,TPG,75,747,1435438,23969902902,4459521093,28429423995
2014-03-20,1,RPG,29,153,329128,11265167987,1792283435,13057451422
2014-03-20,1,UG,733,5198,7549557,159042540915,31073483458,190116024373
2014-03-20,1,Alumni,1,24,18830,1982924704,61823497,2044748201
2014-03-20,1,Others(HKUST),4,16,41176,89887906,14182322,104070228
2014-03-20,1,Non-HKUST,5,22,6466,54308038,8371430,62679468
2014-03-20,1,Total,916,6905,10217605,200549459310,38195296267,238744755577
2014-03-20,G,Staff,113,719,646720,5306046692,671924174,5977970866
2014-03-20,G,TPG,345,1644,974823,30673140383,3657644248,34330784631
2014-03-20,G,RPG,137,780,614363,18073822183,6866383360,24940205543
2014-03-20,G,UG,1814,9460,6496266,144584970291,19948395627,164533365918
2014-03-20,G,Alumni,8,24,46334,4175707,506576,4682283
2014-03-20,G,Others(HKUST),11,45,133974,493107570,60491154,553598724
2014-03-20,G,Non-HKUST,23,78,65986,494838523,33416471,528254994
2014-03-20,G,Total,2451,12750,8978466,199630101349,31238761610,230868862959
2014-03-20,LG1,Staff,102,396,305265,2109079422,293676398,2402755820
2014-03-20,LG1,TPG,443,4789,5950995,114905082833,15538904070,130443986903
2014-03-20,LG1,RPG,168,1114,1348464,11888587885,3420052388,15308640273
2014-03-20,LG1,UG,2603,22379,25806582,279898082409,76651202175,356549284584
2014-03-20,LG1,Alumni,7,48,71813,1404524922,202247736,1606772658
2014-03-20,LG1,Others(HKUST),9,140,33461,118713819,6220505,124934324
2014-03-20,LG1,Non-HKUST,32,181,167053,3774401416,96559546,3870960962
2014-03-20,LG1,Total,3364,29047,33683633,414098472706,96208862818,510307335524
2014-03-20,LG3,Staff,76,211,155583,3465475085,360033914,3825508999
2014-03-20,LG3,TPG,251,1418,1697969,35555896619,4091440934,39647337553
2014-03-20,LG3,RPG,152,547,553970,12262599239,2288857787,14551457026
2014-03-20,LG3,UG,1430,5657,5942296,102853268929,13329904149,116183173078
2014-03-20,LG3,Alumni,9,95,73979,14599719486,1597707790,16197427276
2014-03-20,LG3,Others(HKUST),11,25,14210,320800,233394,554194
2014-03-20,LG3,Non-HKUST,14,87,154924,5184251645,376970449,5561222094
2014-03-20,LG3,Total,1943,8040,8592931,173921531803,22045148417,195966680220
2014-03-20,LG4,Staff,85,371,313444,1528724439,241683648,1770408087
2014-03-20,LG4,TPG,359,5005,7170035,151696697503,31409067464,183105764967
2014-03-20,LG4,RPG,127,1054,1412835,34582937200,4701930675,39284867875
2014-03-20,LG4,UG,1501,11157,13633594,209786777499,40365550656,250152328155
2014-03-20,LG4,Alumni,7,121,76698,432016713,37077734,469094447
2014-03-20,LG4,Others(HKUST),6,74,161925,9978019688,996178017,10974197705
2014-03-20,LG4,Non-HKUST,16,86,108492,467287121,130955714,598242835
2014-03-20,LG4,Total,2101,17868,22877023,408472460163,77882443908,486354904071
2014-03-20,All-Floors,Staff,256,2442,2258022,16554052496,2352949166,18907001662
2014-03-20,All-Floors,TPG,672,13603,17229260,356800720240,59156577809,415957298049
2014-03-20,All-Floors,RPG,370,3648,4258760,88073114494,19069507645,107142622139
2014-03-20,All-Floors,UG,4205,53851,59428295,896165640043,181368536065,1077534176108
2014-03-20,All-Floors,Alumni,14,312,287654,18423361532,1899363333,20322724865
2014-03-20,All-Floors,Others(HKUST),27,300,384746,10680049783,1077305392,11757355175
2014-03-20,All-Floors,Non-HKUST,52,454,502921,9975086743,646273610,10621360353
2014-03-20,All-Floors,Total,5596,74610,84349658,1396672025331,265570513020,1662242538351
2014-03-21,1,Staff,53,602,692736,3286554523,530327403,3816881926
2014-03-21,1,TPG,67,746,1415617,20463088533,5379917949,25843006482
2014-03-21,1,RPG,16,83,77388,2563191582,140715478,2703907060
2014-03-21,1,UG,545,4075,6147556,122666913254,40891828737,163558741991
2014-03-21,1,Alumni,2,21,15217,586215087,25696335,611911422
2014-03-21,1,Others(HKUST),4,10,63887,1397586106,95048006,1492634112
2014-03-21,1,Non-HKUST,7,43,37717,1020587397,37750647,1058338044
2014-03-21,1,Total,694,5580,8450118,151984136482,47101284555,199085421037
2014-03-21,G,Staff,104,606,481074,2988242817,743608316,3731851133
2014-03-21,G,TPG,309,1584,1166864,16732982221,2660200365,19393182586
2014-03-21,G,RPG,112,657,570628,11227261425,1312928807,12540190232
2014-03-21,G,UG,1513,7688,5320967,112962716494,16781354980,129744071474
2014-03-21,G,Alumni,4,8,14141,37183960,4669089,41853049
2014-03-21,G,Others(HKUST),10,73,116947,128056684,49069606,177126290
2014-03-21,G,Non-HKUST,14,50,54521,1856295923,129583663,1985879586
2014-03-21,G,Total,2066,10666,7725142,145932739524,21681414826,167614154350
2014-03-21,LG1,Staff,105,484,447742,5299098700,363455754,5662554454
2014-03-21,LG1,TPG,440,4990,6505508,132523002546,23262529212,155785531758
2014-03-21,LG1,RPG,153,939,1045535,18903553731,8059473603,26963027334
2014-03-21,LG1,UG,2235,18423,22233424,240007993650,60639359857,300647353507
2014-03-21,LG1,Alumni,15,159,170363,2670438609,867866292,3538304901
2014-03-21,LG1,Others(HKUST),9,128,25105,13572125,1748994,15321119
2014-03-21,LG1,Non-HKUST,26,107,137440,155600057,28156643,183756700
2014-03-21,LG1,Total,2983,25230,30565117,399573259418,93222590355,492795849773
2014-03-21,LG3,Staff,87,234,200645,2141971847,1164764312,3306736159
2014-03-21,LG3,TPG,218,1268,1671449,61119008896,7165606134,68284615030
2014-03-21,LG3,RPG,135,586,625601,6874619280,1416050880,8290670160
2014-03-21,LG3,UG,1195,4296,4259858,46815012295,7408214976,54223227271
2014-03-21,LG3,Alumni,7,109,66636,2126456865,714166870,2840623735
2014-03-21,LG3,Others(HKUST),5,14,3610,4744214,1279942,6024156
2014-03-21,LG3,Non-HKUST,17,71,170630,105792384,88307412,194099796
2014-03-21,LG3,Total,1664,6578,6998429,119187605781,17958390526,137145996307
2014-03-21,LG4,Staff,86,289,360985,4675990408,668136066,5344126474
2014-03-21,LG4,TPG,323,4271,6781177,114027604814,22621869314,136649474128
2014-03-21,LG4,RPG,138,753,1081430,26880279679,5753927354,32634207033
2014-03-21,LG4,UG,1248,8704,10734739,154795121646,18697643366,173492765012
2014-03-21,LG4,Alumni,8,80,98133,965599599,102968189,1068567788
2014-03-21,LG4,Others(HKUST),8,88,164367,13414987412,646221337,14061208749
2014-03-21,LG4,Non-HKUST,21,96,123770,3704052079,168780853,3872832932
2014-03-21,LG4,Total,1832,14281,19344601,318463635637,48659546479,367123182116
2014-03-21,All-Floors,Staff,263,2215,2183182,18391858295,3470291851,21862150146
2014-03-21,All-Floors,TPG,614,12859,17540615,344865687010,61090122974,405955809984
2014-03-21,All-Floors,RPG,360,3018,3400582,66448905697,16683096122,83132001819
2014-03-21,All-Floors,UG,3721,43186,48696544,677247757339,144418401916,821666159255
2014-03-21,All-Floors,Alumni,18,377,364490,6385894120,1715366775,8101260895
2014-03-21,All-Floors,Others(HKUST),23,313,373916,14958946541,793367885,15752314426
2014-03-21,All-Floors,Non-HKUST,48,367,524078,6842327840,452579218,7294907058
2014-03-21,All-Floors,Total,5047,62335,73083407,1135141376842,228623226741,1363764603583
2014-03-22,1,Staff,19,180,373061,4996760941,704945202,5701706143
2014-03-22,1,TPG,33,299,482512,19388798781,2344438157,21733236938
2014-03-22,1,RPG,12,82,98261,13459223051,1310574879,14769797930
2014-03-22,1,UG,169,1065,1812190,60716805571,10761698903,71478504474
2014-03-22,1,Alumni,3,56,127378,1773312959,109319652,1882632611
2014-03-22,1,Others(HKUST),1,5,9388,155341822,48538755,203880577
2014-03-22,1,Non-HKUST,6,21,36814,462901900,60938352,523840252
2014-03-22,1,Total,243,1708,2939604,100953145025,15340453900,116293598925
2014-03-22,G,Staff,33,172,155419,4125968655,545425378,4671394033
2014-03-22,G,TPG,221,847,755332,35738146929,14875182996,50613329925
2014-03-22,G,RPG,76,339,355033,9054844663,1125774683,10180619346
2014-03-22,G,UG,540,2743,2638823,47117150334,21933465904,69050616238
2014-03-22,G,Alumni,13,27,18603,100224016,3650254,103874270
2014-03-22,G,Others(HKUST),5,27,50445,85417143,47797529,133214672
2014-03-22,G,Non-HKUST,19,62,10004,336274731,27043630,363318361
2014-03-22,G,Total,907,4217,3983659,96558026471,38558340374,135116366845
2014-03-22,LG1,Staff,36,220,279818,2949908721,284827021,3234735742
2014-03-22,LG1,TPG,449,5677,8234364,108518474337,20755429936,129273904273
2014-03-22,LG1,RPG,145,1165,1635492,22873371072,6147928821,29021299893
2014-03-22,LG1,UG,1064,10990,15879372,247783607504,42143149140,289926756644
2014-03-22,LG1,Alumni,20,98,161316,10152651559,1229341319,11381992878
2014-03-22,LG1,Others(HKUST),6,133,63351,1620109,648733,2268842
2014-03-22,LG1,Non-HKUST,23,251,276435,2543286476,456275324,2999561800
2014-03-22,LG1,Total,1743,18534,26530148,394822919778,71017600294,465840520072
2014-03-22,LG3,Staff,22,58,58739,346642095,623417585,970059680
2014-03-22,LG3,TPG,171,893,1206999,26718732138,7769552582,34488284720
2014-03-22,LG3,RPG,80,417,394434,16255752455,2694276860,18950029315
2014-03-22,LG3,UG,479,1738,1947997,31082637384,6162167182,37244804566
2014-03-22,LG3,Alumni,9,79,99458,671027420,91829939,762857359
2014-03-22,LG3,Others(HKUST),5,7,8878,90181,55012,145193
2014-03-22,LG3,Non-HKUST,15,93,144097,641440233,164413807,805854040
2014-03-22,LG3,Total,781,3285,3860602,75716321906,17505712967,93222034873
2014-03-22,LG4,Staff,19,101,142881,877033012,83240100,960273112
2014-03-22,LG4,TPG,207,2061,3401919,46244233622,16428606652,62672840274
2014-03-22,LG4,RPG,83,436,679687,18301773634,2162287694,20464061328
2014-03-22,LG4,UG,422,2678,4357783,74271336106,23916354863,98187690969
2014-03-22,LG4,Alumni,20,190,479438,6246952060,1106503223,7353455283
2014-03-22,LG4,Others(HKUST),3,84,289248,12353103853,528758082,12881861935
2014-03-22,LG4,Non-HKUST,16,178,289099,3083416078,187774134,3271190212
2014-03-22,LG4,Total,770,5728,9640055,161377848365,44413524748,205791373113
2014-03-22,All-Floors,Staff,82,731,1009918,13296313424,2241855286,15538168710
2014-03-22,All-Floors,TPG,599,9777,14081126,236608385807,62173210323,298781596130
2014-03-22,All-Floors,RPG,245,2439,3162907,79944964875,13440842937,93385807812
2014-03-22,All-Floors,UG,1587,19214,26636165,460971536899,104916835992,565888372891
2014-03-22,All-Floors,Alumni,34,450,886193,18944168014,2540644387,21484812401
2014-03-22,All-Floors,Others(HKUST),12,256,421310,12595573108,625798111,13221371219
2014-03-22,All-Floors,Non-HKUST,44,605,756449,7067319418,896445247,7963764665
2014-03-22,All-Floors,Total,2603,33472,46954068,829428261545,186835632283,1016263893828
2014-03-23,1,Staff,13,139,284794,2125542709,200981465,2326524174
2014-03-23,1,TPG,41,361,627154,30617472250,4105843230,34723315480
2014-03-23,1,RPG,17,92,117263,4112865639,344256580,4457122219
2014-03-23,1,UG,171,1404,2590504,120554037759,15385715362,135939753121
2014-03-23,1,Alumni,5,63,118774,9165053104,444550285,9609603389
2014-03-23,1,Others(HKUST),1,1,4448,47830308,5905437,53735745
2014-03-23,1,Non-HKUST,5,17,62671,567588122,95082139,662670261
2014-03-23,1,Total,253,2077,3805608,167190389891,20582334498,187772724389
2014-03-23,G,Staff,32,109,61862,1801957280,130777404,1932734684
2014-03-23,G,TPG,201,1371,1063149,22935849281,4934520169,27870369450
2014-03-23,G,RPG,100,579,519384,4815432556,2481399803,7296832359
2014-03-23,G,UG,547,3672,3014462,56578802292,7958031482,64536833774
2014-03-23,G,Alumni,28,140,108905,119989426,29828331,149817757
2014-03-23,G,Others(HKUST),7,26,91726,1270885069,89181577,1360066646
2014-03-23,G,Non-HKUST,27,106,88106,5888502626,629753530,6518256156
2014-03-23,G,Total,942,6003,4947594,93411418530,16253492296,109664910826
2014-03-23,LG1,Staff,37,210,276088,2749339273,184599362,2933938635
2014-03-23,LG1,TPG,431,7603,9800349,391243072781,65852446429,457095519210
2014-03-23,LG1,RPG,147,1414,1818617,21592052799,5301748942,26893801741
2014-03-23,LG1,UG,1009,11960,15206955,250168706002,49266407258,299435113260
2014-03-23,LG1,Alumni,28,173,154887,7054746196,252878200,7307624396
2014-03-23,LG1,Others(HKUST),8,160,171167,84496598,13671749,98168347
2014-03-23,LG1,Non-HKUST,37,174,136696,1678098152,265644408,1943742560
2014-03-23,LG1,Total,1697,21694,27564759,674570511801,121137396348,795707908149
2014-03-23,LG3,Staff,33,54,50431,2908008248,86460927,2994469175
2014-03-23,LG3,TPG,224,1384,1617300,32144566353,6777791100,38922357453
2014-03-23,LG3,RPG,108,630,701558,13729662315,5362472475,19092134790
2014-03-23,LG3,UG,447,1901,2086719,39103864047,3154127243,42257991290
2014-03-23,LG3,Alumni,25,182,171153,2720620959,1767109926,4487730885
2014-03-23,LG3,Others(HKUST),4,5,4325,33665241,2026183,35691424
2014-03-23,LG3,Non-HKUST,19,106,220350,9357852117,655973902,10013826019
2014-03-23,LG3,Total,860,4262,4851836,99998239280,17805961756,117804201036
2014-03-23,LG4,Staff,20,105,130574,1078088499,103941150,1182029649
2014-03-23,LG4,TPG,239,3515,5056481,95438135897,21645723032,117083858929
2014-03-23,LG4,RPG,98,674,1059309,39849642216,4322288506,44171930722
2014-03-23,LG4,UG,511,4879,7019387,135439346786,27233929969,162673276755
2014-03-23,LG4,Alumni,34,345,503746,17363279524,2133044542,19496324066
2014-03-23,LG4,Others(HKUST),4,129,309191,15801903107,3737655016,19539558123
2014-03-23,LG4,Non-HKUST,35,293,592299,5184284505,737125769,5921410274
2014-03-23,LG4,Total,941,9940,14670987,310154680534,59913707984,370068388518
2014-03-23,All-Floors,Staff,79,617,803749,10662936009,706760308,11369696317
2014-03-23,All-Floors,TPG,506,14234,18164433,572379096562,103316323960,675695420522
2014-03-23,All-Floors,RPG,271,3389,4216131,84099655525,17812166306,101911821831
2014-03-23,All-Floors,UG,1416,23816,29918027,601844756886,102998211314,704842968200
2014-03-23,All-Floors,Alumni,55,903,1057465,36423689209,4627411284,41051100493
2014-03-23,All-Floors,Others(HKUST),13,321,580857,17238780323,3848439962,21087220285
2014-03-23,All-Floors,Non-HKUST,64,696,1100122,22676325522,2383579748,25059905270
2014-03-23,All-Floors,Total,2404,43976,55840784,1345325240036,235692892882,1581018132918
2014-03-24,1,Staff,54,591,798420,3203069556,892772364,4095841920
2014-03-24,1,TPG,71,925,1333824,36242119858,8558963536,44801083394
2014-03-24,1,RPG,27,152,268816,82169175303,7184700424,89353875727
2014-03-24,1,UG,796,6412,8524125,188354286022,31133994544,219488280566
2014-03-24,1,Alumni,4,59,105926,1062590784,62419733,1125010517
2014-03-24,1,Others(HKUST),7,85,75072,1378879986,113482695,1492362681
2014-03-24,1,Non-HKUST,10,52,38882,357321060,48926528,406247588
2014-03-24,1,Total,969,8276,11145065,312767442569,47995259824,360762702393
2014-03-24,G,Staff,120,649,651576,6429941210,838160423,7268101633
2014-03-24,G,TPG,343,2263,1386278,42249694672,7051725665,49301420337
2014-03-24,G,RPG,162,910,609366,13314209191,933066508,14247275699
2014-03-24,G,UG,1986,11487,6960576,155679569779,22787507608,178467077387
2014-03-24,G,Alumni,10,47,62374,1313896566,1012817005,2326713571
2014-03-24,G,Others(HKUST),11,105,118290,690284091,141239845,831523936
2014-03-24,G,Non-HKUST,29,118,99545,4287142104,168485186,4455627290
2014-03-24,G,Total,2661,15579,9888005,223964737613,32933002240,256897739853
2014-03-24,LG1,Staff,106,470,312191,4634687537,266878321,4901565858
2014-03-24,LG1,TPG,494,5889,6257296,104094416711,20420132515,124514549226
2014-03-24,LG1,RPG,161,1167,1242205,30248398119,4027741691,34276139810
2014-03-24,LG1,UG,2681,23039,24429357,231529092732,92617433462,324146526194
2014-03-24,LG1,Alumni,14,92,91360,2100240676,2106710869,4206951545
2014-03-24,LG1,Others(HKUST),10,197,212227,170012836,42234285,212247121
2014-03-24,LG1,Non-HKUST,28,109,72044,5972155659,374371233,6346526892
2014-03-24,LG1,Total,3494,30963,32616680,378749004270,119855502376,498604506646
2014-03-24,LG3,Staff,95,245,205414,263996754,136699667,400696421
2014-03-24,LG3,TPG,279,1779,2116139,34554857794,5653867258,40208725052
2014-03-24,LG3,RPG,180,787,844637,27391893419,4415772950,31807666369
2014-03-24,LG3,UG,1576,6307,5716172,107773442394,22461433378,130234875772
2014-03-24,LG3,Alumni,10,176,80422,1991148771,192656599,2183805370
2014-03-24,LG3,Others(HKUST),7,19,11539,22946341,4558852,27505193
2014-03-24,LG3,Non-HKUST,14,68,101683,98434798,14955151,113389949
2014-03-24,LG3,Total,2161,9381,9076006,172096720271,32879943855,204976664126
2014-03-24,LG4,Staff,108,478,450994,9623768249,696852897,10320621146
2014-03-24,LG4,TPG,374,5512,7728279,89826131107,19054701077,108880832184
2014-03-24,LG4,RPG,154,1371,1768205,95831482713,7261475751,103092958464
2014-03-24,LG4,UG,1735,14422,16751677,246680559302,80545736926,327226296228
2014-03-24,LG4,Alumni,12,125,167624,330268934,238292484,568561418
2014-03-24,LG4,Others(HKUST),8,59,177375,14054202961,3835391441,17889594402
2014-03-24,LG4,Non-HKUST,32,270,330629,2156058846,931818366,3087877212
2014-03-24,LG4,Total,2423,22237,27374783,458502472112,112564268942,571066741054
2014-03-24,All-Floors,Staff,286,2433,2418595,24155463306,2831363672,26986826978
2014-03-24,All-Floors,TPG,666,16368,18821816,306967220142,60739390051,367706610193
2014-03-24,All-Floors,RPG,370,4387,4733229,248955158745,23822757324,272777916069
2014-03-24,All-Floors,UG,4275,61667,62381907,930016950229,249546105918,1179563056147
2014-03-24,All-Floors,Alumni,24,499,507706,6798145731,3612896690,10411042421
2014-03-24,All-Floors,Others(HKUST),23,465,594503,16316326215,4136907118,20453233333
2014-03-24,All-Floors,Non-HKUST,66,617,642783,12871112467,1538556464,14409668931
2014-03-24,All-Floors,Total,5710,86436,90100539,1546080376835,346227977237,1892308354072
2014-03-25,1,Staff,60,718,823715,2677930986,299572358,2977503344
2014-03-25,1,TPG,69,818,1036247,24859328114,4501865143,29361193257
2014-03-25,1,RPG,19,99,203797,26775263328,1486374551,28261637879
2014-03-25,1,UG,782,6157,8540831,198194669415,44266445254,242461114669
2014-03-25,1,Alumni,2,34,29754,1163081780,57562704,1220644484
2014-03-25,1,Others(HKUST),2,50,27585,43166857,9367521,52534378
2014-03-25,1,Non-HKUST,4,9,1181,2169130,723021,2892151
2014-03-25,1,Total,938,7885,10663110,253715609610,50621910552,304337520162
2014-03-25,G,Staff,98,643,545381,6791990851,635926469,7427917320
2014-03-25,G,TPG,347,2256,1591210,18526444732,7402255345,25928700077
2014-03-25,G,RPG,160,736,604839,23770162737,1725798033,25495960770
2014-03-25,G,UG,1934,9445,6721622,125767390601,18324553515,144091944116
2014-03-25,G,Alumni,8,38,32886,6685326,2380655,9065981
2014-03-25,G,Others(HKUST),10,97,134519,255457027,42125743,297582770
2014-03-25,G,Non-HKUST,21,112,59969,2843566429,202420092,3045986521
2014-03-25,G,Total,2578,13327,9690426,177961697703,28335459852,206297157555
2014-03-25,LG1,Staff,109,476,393044,6798557730,798875561,7597433291
2014-03-25,LG1,TPG,499,6596,6581535,65348279238,25425203274,90773482512
2014-03-25,LG1,RPG,187,1414,1361727,24588760303,3428448867,28017209170
2014-03-25,LG1,UG,2571,22689,24039228,291038009005,96685071196,387723080201
2014-03-25,LG1,Alumni,13,251,83380,160140480,52720684,212861164
2014-03-25,LG1,Others(HKUST),9,83,35223,1969341,965788,2935129
2014-03-25,LG1,Non-HKUST,25,101,67765,769566428,79343495,848909923
2014-03-25,LG1,Total,3413,31610,32561902,388705282525,126470628865,515175911390
2014-03-25,LG3,Staff,110,264,192081,1643146859,2163000044,3806146903
2014-03-25,LG3,TPG,326,2215,2573284,35281225728,9319241359,44600467087
2014-03-25,LG3,RPG,177,850,951621,7058968822,1269102965,8328071787
2014-03-25,LG3,UG,1474,5226,4831954,76185264977,8522117606,84707382583
2014-03-25,LG3,Alumni,11,74,54950,169980816,26705191,196686007
2014-03-25,LG3,Others(HKUST),6,14,28339,1482257848,371551738,1853809586
2014-03-25,LG3,Non-HKUST,21,156,266635,34137762111,957245947,35095008058
2014-03-25,LG3,Total,2125,8799,8898864,155958607161,22628964850,178587572011
2014-03-25,LG4,Staff,87,342,310716,3167940280,735550071,3903490351
2014-03-25,LG4,TPG,388,5571,8324620,169411339967,21834701903,191246041870
2014-03-25,LG4,RPG,141,1263,1508873,37091225937,8816372801,45907598738
2014-03-25,LG4,UG,1742,12685,15832256,181086695568,55856997530,236943693098
2014-03-25,LG4,Alumni,10,142,141960,3000763586,164262849,3165026435
2014-03-25,LG4,Others(HKUST),6,55,121192,9343397702,2025291481,11368689183
2014-03-25,LG4,Non-HKUST,28,303,498750,855152890,483369468,1338522358
2014-03-25,LG4,Total,2402,20361,26738367,403956515930,89916546103,493873062033
2014-03-25,All-Floors,Staff,274,2443,2264937,21079566706,4632924503,25712491209
2014-03-25,All-Floors,TPG,688,17456,20106896,313426617779,68483267024,381909884803
2014-03-25,All-Floors,RPG,387,4362,4630857,119284381127,16726097217,136010478344
2014-03-25,All-Floors,UG,4265,56202,59965891,872272029566,223655185101,1095927214667
2014-03-25,All-Floors,Alumni,20,539,342930,4500651988,303632083,4804284071
2014-03-25,All-Floors,Others(HKUST),21,299,346858,11126248775,2449302271,13575551046
2014-03-25,All-Floors,Non-HKUST,57,681,894300,38608216988,1723102023,40331319011
2014-03-25,All-Floors,Total,5712,81982,88552669,1380297712929,317973510222,1698271223151
2014-03-26,1,Staff,55,528,797096,2425043276,349396162,2774439438
2014-03-26,1,TPG,75,598,858906,32851720457,1926630621,34778351078
2014-03-26,1,RPG,15,100,161823,5902398392,478828943,6381227335
2014-03-26,1,UG,743,5665,8388327,133936538021,32131259443,166067797464
2014-03-26,1,Alumni,3,38,63364,1159428666,84302948,1243731614
2014-03-26,1,Others(HKUST),5,19,29912,14157986,4444958,18602944
2014-03-26,1,Non-HKUST,8,16,19120,2653827552,60086217,2713913769
2014-03-26,1,Total,904,6964,10318548,178943114350,35034949292,213978063642
2014-03-26,G,Staff,113,704,559966,14399207786,1314538331,15713746117
2014-03-26,G,TPG,312,1867,1351253,28106676662,3029354310,31136030972
2014-03-26,G,RPG,122,533,521710,4403970222,2198232524,6602202746
2014-03-26,G,UG,1815,8668,6769768,98587851637,24221463798,122809315435
2014-03-26,G,Alumni,8,24,39367,696688150,437689672,1134377822
2014-03-26,G,Others(HKUST),14,73,110619,2978570856,7292853971,10271424827
2014-03-26,G,Non-HKUST,24,111,76232,643607454,1411947268,2055554722
2014-03-26,G,Total,2408,11980,9428915,149816572767,39906079874,189722652641
2014-03-26,LG1,Staff,132,577,407392,10609842045,913555610,11523397655
2014-03-26,LG1,TPG,497,5899,6929017,84264591254,15960836146,100225427400
2014-03-26,LG1,RPG,150,1055,1330590,19752327192,5054768018,24807095210
2014-03-26,LG1,UG,2650,20563,22593126,195741351624,44928962175,240670313799
2014-03-26,LG1,Alumni,12,132,130530,917220546,102836918,1020057464
2014-03-26,LG1,Others(HKUST),9,82,85574,340789762,135334215,476123977
2014-03-26,LG1,Non-HKUST,23,139,80233,605606772,93736802,699343574
2014-03-26,LG1,Total,3473,28447,31556462,312231729195,67190029884,379421759079
2014-03-26,LG3,Staff,116,207,145473,1909903524,1127636993,3037540517
2014-03-26,LG3,TPG,285,1686,1902518,33368281514,8344190077,41712471591
2014-03-26,LG3,RPG,137,592,693982,26706735704,6123543218,32830278922
2014-03-26,LG3,UG,1526,5802,5818103,68748369768,13450144464,82198514232
2014-03-26,LG3,Alumni,11,126,62290,856643597,130895943,987539540
2014-03-26,LG3,Others(HKUST),5,19,11380,428074,252643,680717
2014-03-26,LG3,Non-HKUST,10,101,139860,1011085626,103172955,1114258581
2014-03-26,LG3,Total,2090,8533,8773606,132601447807,29279836293,161881284100
2014-03-26,LG4,Staff,105,362,354894,3295621197,747633395,4043254592
2014-03-26,LG4,TPG,377,5747,7899101,105397296373,28920938815,134318235188
2014-03-26,LG4,RPG,150,1139,1519669,50959408149,17714677686,68674085835
2014-03-26,LG4,UG,1668,12462,15470872,202410794722,97150329487,299561124209
2014-03-26,LG4,Alumni,9,84,144594,960553966,470785050,1431339016
2014-03-26,LG4,Others(HKUST),9,59,94993,4402308037,152926195,4555234232
2014-03-26,LG4,Non-HKUST,20,129,140090,2027868243,341222186,2369090429
2014-03-26,LG4,Total,2338,19982,25624213,369453850687,145498512814,514952363501
2014-03-26,All-Floors,Staff,301,2378,2264821,32639617828,4452760491,37092378319
2014-03-26,All-Floors,TPG,687,15797,18940795,283988566260,58181949969,342170516229
2014-03-26,All-Floors,RPG,342,3419,4227774,107724839659,31570050389,139294890048
2014-03-26,All-Floors,UG,4244,53160,59040196,699424905772,211882159367,911307065139
2014-03-26,All-Floors,Alumni,24,404,440145,4590534925,1226510531,5817045456
2014-03-26,All-Floors,Others(HKUST),26,252,332478,7736254715,7585811982,15322066697
2014-03-26,All-Floors,Non-HKUST,46,496,455535,6941995647,2010165428,8952161075
2014-03-26,All-Floors,Total,5670,75906,85701744,1143046714806,316909408157,1459956122963
2014-03-27,1,Staff,64,568,811195,6485031925,1993806815,8478838740
2014-03-27,1,TPG,55,611,813903,27081811709,2525895498,29607707207
2014-03-27,1,RPG,17,103,227513,7092535009,12850588494,19943123503
2014-03-27,1,UG,615,4487,6701153,181084870305,58843515296,239928385601
2014-03-27,1,Alumni,6,32,66891,7309803026,1609776439,8919579465
2014-03-27,1,Others(HKUST),4,23,11558,366387695,54674205,421061900
2014-03-27,1,Non-HKUST,5,20,35481,142992766,70129657,213122423
2014-03-27,1,Total,766,5844,8667694,229563432435,77948386404,307511818839
2014-03-27,G,Staff,126,558,520561,3707076179,2964120045,6671196224
2014-03-27,G,TPG,272,1484,1233024,15848015662,4255509666,20103525328
2014-03-27,G,RPG,124,563,673953,17492034378,1371779467,18863813845
2014-03-27,G,UG,1654,8310,6263387,109444529145,31686927797,141131456942
2014-03-27,G,Alumni,9,35,47300,2916796410,147999320,3064795730
2014-03-27,G,Others(HKUST),10,49,174754,2165095738,361904369,2527000107
2014-03-27,G,Non-HKUST,27,73,66759,599324260,348429800,947754060
2014-03-27,G,Total,2222,11072,8979738,152172871772,41136670464,193309542236
2014-03-27,LG1,Staff,108,469,377811,4529935090,394671313,4924606403
2014-03-27,LG1,TPG,434,4861,5440812,72301349626,15736613150,88037962776
2014-03-27,LG1,RPG,160,964,1130427,11889194535,3736772630,15625967165
2014-03-27,LG1,UG,2396,18586,20927896,248142131200,52173581844,300315713044
2014-03-27,LG1,Alumni,14,78,64710,464902983,82855242,547758225
2014-03-27,LG1,Others(HKUST),8,92,68903,27198094,56939841,84137935
2014-03-27,LG1,Non-HKUST,15,53,78986,522647015,69068699,591715714
2014-03-27,LG1,Total,3135,25103,28089545,337877358543,72250502719,410127861262
2014-03-27,LG3,Staff,101,190,142024,492822958,1678320499,2171143457
2014-03-27,LG3,TPG,233,1371,1709838,32660707163,5843911863,38504619026
2014-03-27,LG3,RPG,152,748,926701,14872017060,3695800913,18567817973
2014-03-27,LG3,UG,1251,4323,4908987,68696212659,16583814994,85280027653
2014-03-27,LG3,Alumni,5,61,29191,485654332,133356116,619010448
2014-03-27,LG3,Others(HKUST),6,15,24354,22393123,2278694,24671817
2014-03-27,LG3,Non-HKUST,9,53,119891,1808408868,179645793,1988054661
2014-03-27,LG3,Total,1757,6761,7860986,119038216163,28117128872,147155345035
2014-03-27,LG4,Staff,126,529,568452,3168209924,285963568,3454173492
2014-03-27,LG4,TPG,312,3576,5857209,87411175762,14089200654,101500376416
2014-03-27,LG4,RPG,111,819,1198933,33100784051,12398586234,45499370285
2014-03-27,LG4,UG,1354,8594,11571641,175723071527,23741079640,199464151167
2014-03-27,LG4,Alumni,13,167,161585,1241553362,161982849,1403536211
2014-03-27,LG4,Others(HKUST),8,84,151391,9778882238,474111804,10252994042
2014-03-27,LG4,Non-HKUST,14,36,38945,66618160,10855123,77473283
2014-03-27,LG4,Total,1938,13805,19548156,310490295024,51161779872,361652074896
2014-03-27,All-Floors,Staff,305,2314,2420043,18383076076,7316882240,25699958316
2014-03-27,All-Floors,TPG,625,11903,15054786,235303059922,42451130831,277754190753
2014-03-27,All-Floors,RPG,347,3197,4157527,84446565033,34053527738,118500092771
2014-03-27,All-Floors,UG,3974,44300,50373064,783090814836,183028919571,966119734407
2014-03-27,All-Floors,Alumni,22,373,369677,12418710113,2135969966,14554680079
2014-03-27,All-Floors,Others(HKUST),25,263,430960,12359956888,949908913,13309865801
2014-03-27,All-Floors,Non-HKUST,47,235,340062,3139991069,678129072,3818120141
2014-03-27,All-Floors,Total,5345,62585,73146119,1149142173937,270614468331,1419756642268
2014-03-28,1,Staff,53,567,603403,5029177473,282284253,5311461726
2014-03-28,1,TPG,46,443,787219,17333976482,3721571212,21055547694
2014-03-28,1,RPG,15,106,221447,16768184302,2854130992,19622315294
2014-03-28,1,UG,460,3220,4997419,128689657285,20166990110,148856647395
2014-03-28,1,Alumni,4,51,108665,8816272933,1907234505,10723507438
2014-03-28,1,Others(HKUST),3,20,56828,1147476464,653388143,1800864607
2014-03-28,1,Non-HKUST,5,28,19394,453824815,24118948,477943763
2014-03-28,1,Total,586,4435,6794375,178238569754,29609718163,207848287917
2014-03-28,G,Staff,102,557,514540,6310778535,825434471,7136213006
2014-03-28,G,TPG,253,1510,1415814,19652843239,4827848009,24480691248
2014-03-28,G,RPG,106,559,538807,4130585656,648783295,4779368951
2014-03-28,G,UG,1431,6776,5254355,78698004540,19868726296,98566730836
2014-03-28,G,Alumni,5,28,49885,296036527,16655889,312692416
2014-03-28,G,Others(HKUST),7,25,82931,306161924,45020635,351182559
2014-03-28,G,Non-HKUST,15,75,64275,2631426549,87010919,2718437468
2014-03-28,G,Total,1919,9530,7920607,112025836970,26319479514,138345316484
2014-03-28,LG1,Staff,87,376,282971,1788519690,329106784,2117626474
2014-03-28,LG1,TPG,421,4854,6275017,72769773868,23585964194,96355738062
2014-03-28,LG1,RPG,148,1039,1035092,13560128351,4400037410,17960165761
2014-03-28,LG1,UG,2186,16181,19658899,238430095678,52087882014,290517977692
2014-03-28,LG1,Alumni,15,108,98703,611472121,73226971,684699092
2014-03-28,LG1,Others(HKUST),8,49,76703,104878878,13848207,118727085
2014-03-28,LG1,Non-HKUST,30,90,158176,677978525,103778245,781756770
2014-03-28,LG1,Total,2895,22697,27585561,327942847111,80593843825,408536690936
2014-03-28,LG3,Staff,81,285,222874,1021545023,1331876733,2353421756
2014-03-28,LG3,TPG,230,1447,2044400,44097962871,5028974877,49126937748
2014-03-28,LG3,RPG,130,535,767431,9908370683,1002794871,10911165554
2014-03-28,LG3,UG,1026,3892,4084306,101166210732,20361647831,121527858563
2014-03-28,LG3,Alumni,9,65,41300,1314976975,179741126,1494718101
2014-03-28,LG3,Others(HKUST),5,10,2878,79737342,5094208,84831550
2014-03-28,LG3,Non-HKUST,11,33,35966,230192578,17186319,247378897
2014-03-28,LG3,Total,1492,6267,7199155,157818996204,27927315965,185746312169
2014-03-28,LG4,Staff,69,370,488071,1365647859,310735224,1676383083
2014-03-28,LG4,TPG,267,2865,4894872,100739103760,19223186158,119962289918
2014-03-28,LG4,RPG,89,716,999282,28414178722,4578275491,32992454213
2014-03-28,LG4,UG,1000,7241,9154180,156778607189,24816296795,181594903984
2014-03-28,LG4,Alumni,10,117,113954,5769663342,281042413,6050705755
2014-03-28,LG4,Others(HKUST),8,57,98250,8469469021,284766529,8754235550
2014-03-28,LG4,Non-HKUST,14,152,225015,1958645623,285484629,2244130252
2014-03-28,LG4,Total,1457,11518,15973624,303495315516,49779787239,353275102755
2014-03-28,All-Floors,Staff,225,2155,2111859,15515668580,3079437465,18595106045
2014-03-28,All-Floors,TPG,610,11119,15417322,254593660220,56387544450,310981204670
2014-03-28,All-Floors,RPG,307,2955,3562059,72781447714,13484022059,86265469773
2014-03-28,All-Floors,UG,3456,37310,43149159,703762575424,137301543046,841064118470
2014-03-28,All-Floors,Alumni,22,369,412507,16808421898,2457900904,19266322802
2014-03-28,All-Floors,Others(HKUST),20,161,317590,10107723629,1002117722,11109841351
2014-03-28,All-Floors,Non-HKUST,45,378,502826,5952068090,517579060,6469647150
2014-03-28,All-Floors,Total,4685,54447,65473322,1079521565555,214230144706,1293751710261
2014-03-29,1,Staff,15,216,202523,1024891967,67617199,1092509166
2014-03-29,1,TPG,35,234,413309,14824599043,5318430301,20143029344
2014-03-29,1,RPG,10,50,45889,9770995317,2762913692,12533909009
2014-03-29,1,UG,147,1136,1912345,41451424086,55045468504,96496892590
2014-03-29,1,Alumni,6,83,172878,14032040580,502274480,14534315060
2014-03-29,1,Others(HKUST),1,1,0,139850,41783,181633
2014-03-29,1,Non-HKUST,4,95,114298,2880565494,69271076,2949836570
2014-03-29,1,Total,218,1815,2861242,83984656337,63766017035,147750673372
2014-03-29,G,Staff,26,172,196901,2517578819,250103299,2767682118
2014-03-29,G,TPG,177,779,512615,10055836985,2205236647,12261073632
2014-03-29,G,RPG,62,281,331519,6526560189,761243262,7287803451
2014-03-29,G,UG,440,2287,2571246,92602946936,14978409113,107581356049
2014-03-29,G,Alumni,22,43,9368,1235725230,36703440,1272428670
2014-03-29,G,Others(HKUST),5,17,49140,946444233,48704099,995148332
2014-03-29,G,Non-HKUST,8,26,11051,17352519,4127148,21479667
2014-03-29,G,Total,740,3605,3681840,113902444911,18284527008,132186971919
2014-03-29,LG1,Staff,41,251,266528,10764601067,807747624,11572348691
2014-03-29,LG1,TPG,420,5073,7669289,141683314657,33464008091,175147322748
2014-03-29,LG1,RPG,125,1031,1410579,21626157676,7955271519,29581429195
2014-03-29,LG1,UG,999,10033,14993133,208027322445,52071183302,260098505747
2014-03-29,LG1,Alumni,27,217,282923,3280236528,219564243,3499800771
2014-03-29,LG1,Others(HKUST),6,27,112947,1505724,364490,1870214
2014-03-29,LG1,Non-HKUST,18,151,356415,3439619123,255624948,3695244071
2014-03-29,LG1,Total,1636,16783,25091814,388822757220,94773764217,483596521437
2014-03-29,LG3,Staff,15,35,55416,1496193893,3332054167,4828248060
2014-03-29,LG3,TPG,153,662,880103,17915768920,8814184302,26729953222
2014-03-29,LG3,RPG,77,305,412313,9912867433,2066262770,11979130203
2014-03-29,LG3,UG,371,1448,1879689,124257273984,11733158748,135990432732
2014-03-29,LG3,Alumni,20,189,216335,3548704377,377449521,3926153898
2014-03-29,LG3,Others(HKUST),0,0,0,0,0,0
2014-03-29,LG3,Non-HKUST,13,59,86306,135918225,44253520,180171745
2014-03-29,LG3,Total,649,2698,3530162,157266726832,26367363028,183634089860
2014-03-29,LG4,Staff,14,85,122094,221171925,27293485,248465410
2014-03-29,LG4,TPG,144,1213,1912377,33922670652,10986084614,44908755266
2014-03-29,LG4,RPG,59,483,880830,16641384565,6053135564,22694520129
2014-03-29,LG4,UG,324,2666,4251396,113927736858,38361185256,152288922114
2014-03-29,LG4,Alumni,30,349,501401,7137800857,1366709237,8504510094
2014-03-29,LG4,Others(HKUST),2,119,294435,30996229073,7450796211,38447025284
2014-03-29,LG4,Non-HKUST,5,31,74690,1027491,4834125,5861616
2014-03-29,LG4,Total,578,4946,8037223,202848021421,64250038492,267098059913
2014-03-29,All-Floors,Staff,71,759,843462,16024437671,4484815774,20509253445
2014-03-29,All-Floors,TPG,547,7961,11387693,218402190257,60787943955,279190134212
2014-03-29,All-Floors,RPG,207,2150,3081130,64477965180,19598826807,84076791987
2014-03-29,All-Floors,UG,1423,17570,25607809,580266704309,172189404923,752456109232
2014-03-29,All-Floors,Alumni,48,881,1182905,29234507572,2502700921,31737208493
2014-03-29,All-Floors,Others(HKUST),13,164,456522,31944318880,7499906583,39444225463
2014-03-29,All-Floors,Non-HKUST,33,362,642760,6474482852,378110817,6852593669
2014-03-29,All-Floors,Total,2342,29847,43202281,946824606721,267441709780,1214266316501
2014-03-30,1,Staff,9,203,279129,416675514,107492078,524167592
2014-03-30,1,TPG,35,273,549366,12356685054,2411174385,14767859439
2014-03-30,1,RPG,15,54,109295,4770956069,613153411,5384109480
2014-03-30,1,UG,125,731,1516346,50865362615,4968118242,55833480857
2014-03-30,1,Alumni,9,81,181619,6634404164,1217081996,7851486160
2014-03-30,1,Others(HKUST),0,0,0,0,0,0
2014-03-30,1,Non-HKUST,5,82,180558,6595235094,473594678,7068829772
2014-03-30,1,Total,198,1424,2816313,81639318510,9790614790,91429933300
2014-03-30,G,Staff,27,235,204961,2237994066,350265860,2588259926
2014-03-30,G,TPG,181,1139,929954,28526973563,7758793156,36285766719
2014-03-30,G,RPG,82,392,438389,31349568397,3441736406,34791304803
2014-03-30,G,UG,422,2675,2465316,47507122993,10662303722,58169426715
2014-03-30,G,Alumni,27,63,8741,215950043,9837985,225788028
2014-03-30,G,Others(HKUST),4,16,63959,206671323,31794919,238466242
2014-03-30,G,Non-HKUST,24,83,66497,3707906602,188023292,3895929894
2014-03-30,G,Total,767,4603,4177817,113752186987,22442755340,136194942327
2014-03-30,LG1,Staff,22,144,300243,10714038152,1763280011,12477318163
2014-03-30,LG1,TPG,383,6528,9705029,153108074314,29920640973,183028715287
2014-03-30,LG1,RPG,128,1272,1781518,26660483398,6982817644,33643301042
2014-03-30,LG1,UG,959,9880,14082274,166305091057,34682731345,200987822402
2014-03-30,LG1,Alumni,27,174,230577,692132966,189872807,882005773
2014-03-30,LG1,Others(HKUST),2,23,85385,20711,25200,45911
2014-03-30,LG1,Non-HKUST,29,191,270459,1012151035,181629284,1193780319
2014-03-30,LG1,Total,1550,18212,26455485,358491991633,73720997264,432212988897
2014-03-30,LG3,Staff,24,49,53307,2938460306,225984954,3164445260
2014-03-30,LG3,TPG,173,755,1047359,25475503695,4826567723,30302071418
2014-03-30,LG3,RPG,85,358,328066,2651431466,448575077,3100006543
2014-03-30,LG3,UG,399,1697,1867192,18867482179,4971695042,23839177221
2014-03-30,LG3,Alumni,30,175,279898,2485087560,394906485,2879994045
2014-03-30,LG3,Others(HKUST),0,0,0,0,0,0
2014-03-30,LG3,Non-HKUST,20,114,177986,748065188,185430227,933495415
2014-03-30,LG3,Total,731,3148,3753808,53166030394,11053159508,64219189902
2014-03-30,LG4,Staff,17,97,145247,734158451,77117106,811275557
2014-03-30,LG4,TPG,168,2056,3210586,50418276462,11748648282,62166924744
2014-03-30,LG4,RPG,81,615,1025752,19994028989,5509396394,25503425383
2014-03-30,LG4,UG,340,2808,4057069,88222697215,8655926131,96878623346
2014-03-30,LG4,Alumni,27,296,389142,5658222041,554647420,6212869461
2014-03-30,LG4,Others(HKUST),1,34,163631,13321711369,4259156610,17580867979
2014-03-30,LG4,Non-HKUST,22,213,396912,4318822543,1162246704,5481069247
2014-03-30,LG4,Total,656,6119,9388339,182667917070,31967138647,214635055717
2014-03-30,All-Floors,Staff,67,728,982887,17041326489,2524140009,19565466498
2014-03-30,All-Floors,TPG,470,10751,15442294,269885513088,56665824519,326551337607
2014-03-30,All-Floors,RPG,226,2691,3683020,85426468319,16995678932,102422147251
2014-03-30,All-Floors,UG,1321,17791,23988197,371767756059,63940774482,435708530541
2014-03-30,All-Floors,Alumni,58,789,1089977,15685796774,2366346693,18052143467
2014-03-30,All-Floors,Others(HKUST),7,73,312975,13528403403,4290976729,17819380132
2014-03-30,All-Floors,Non-HKUST,53,683,1092412,16382180462,2190924185,18573104647
2014-03-30,All-Floors,Total,2202,33506,46591762,789717444594,148974665549,938692110143
2014-03-31,1,Staff,52,551,764164,4854596664,373245819,5227842483
2014-03-31,1,TPG,58,573,927115,93567510845,5451819266,99019330111
2014-03-31,1,RPG,21,126,307961,8998320740,5910583260,14908904000
2014-03-31,1,UG,545,4799,6427294,160452471590,120603362857,281055834447
2014-03-31,1,Alumni,5,54,74905,6700796937,750479948,7451276885
2014-03-31,1,Others(HKUST),4,25,19131,73146600,13904186,87050786
2014-03-31,1,Non-HKUST,8,57,67947,615132722,51449666,666582388
2014-03-31,1,Total,693,6185,8588517,275261976098,133154845002,408416821100
2014-03-31,G,Staff,90,582,607090,5507215642,1983923584,7491139226
2014-03-31,G,TPG,272,1745,1314132,24053785200,3633726598,27687511798
2014-03-31,G,RPG,115,673,570919,4214084484,3611593140,7825677624
2014-03-31,G,UG,1489,7902,5298226,101220662295,29321037615,130541699910
2014-03-31,G,Alumni,7,39,55912,4135932,2322735,6458667
2014-03-31,G,Others(HKUST),7,41,116457,205333726,34478809,239812535
2014-03-31,G,Non-HKUST,22,51,56452,809691757,211743231,1021434988
2014-03-31,G,Total,2002,11033,8019188,136014909036,38798825712,174813734748
2014-03-31,LG1,Staff,94,368,274500,670397006,188177241,858574247
2014-03-31,LG1,TPG,400,4793,5370413,166942461888,17826016421,184768478309
2014-03-31,LG1,RPG,148,1156,1327061,15096753343,3538314701,18635068044
2014-03-31,LG1,UG,2194,19747,21090599,194287674172,68333235689,262620909861
2014-03-31,LG1,Alumni,10,85,64502,14713448,3681537,18394985
2014-03-31,LG1,Others(HKUST),9,25,94356,2156024,1200381,3356405
2014-03-31,LG1,Non-HKUST,25,128,151665,998997345,88686437,1087683782
2014-03-31,LG1,Total,2880,26302,28373096,378013153226,89979312407,467992465633
2014-03-31,LG3,Staff,84,218,129163,2733612044,109244946,2842856990
2014-03-31,LG3,TPG,209,1231,1637066,35038072478,2643811672,37681884150
2014-03-31,LG3,RPG,135,465,490008,4704744120,1276471294,5981215414
2014-03-31,LG3,UG,1204,4639,4568172,103637167214,12846590626,116483757840
2014-03-31,LG3,Alumni,7,90,62190,266641230,53470943,320112173
2014-03-31,LG3,Others(HKUST),3,5,11409,2728747,430598,3159345
2014-03-31,LG3,Non-HKUST,13,52,129357,375188856,126969445,502158301
2014-03-31,LG3,Total,1655,6700,7027365,146758154689,17056989524,163815144213
2014-03-31,LG4,Staff,58,237,149123,1030800668,112452834,1143253502
2014-03-31,LG4,TPG,236,2860,4614988,97952074864,14747945062,112700019926
2014-03-31,LG4,RPG,117,765,1414192,20433676655,4202496016,24636172671
2014-03-31,LG4,UG,1066,7334,9978386,158022772219,32477700907,190500473126
2014-03-31,LG4,Alumni,8,127,128200,357101252,80060560,437161812
2014-03-31,LG4,Others(HKUST),5,76,177601,11274513019,403178127,11677691146
2014-03-31,LG4,Non-HKUST,12,105,110229,1529303632,70298460,1599602092
2014-03-31,LG4,Total,1502,11504,16572719,290600242309,52094131966,342694374275
2014-03-31,All-Floors,Staff,232,1956,1924040,14796622024,2767044424,17563666448
2014-03-31,All-Floors,TPG,570,11202,13863714,417553905275,44303319019,461857224294
2014-03-31,All-Floors,RPG,304,3185,4110141,53447579342,18539458411,71987037753
2014-03-31,All-Floors,UG,3586,44421,47362677,717620747490,263581927694,981202675184
2014-03-31,All-Floors,Alumni,17,395,385709,7343388799,890015723,8233404522
2014-03-31,All-Floors,Others(HKUST),20,172,418954,11557878116,453192101,12011070217
2014-03-31,All-Floors,Non-HKUST,42,393,515650,4328314312,549147239,4877461551
2014-03-31,All-Floors,Total,4771,61724,68580885,1226648435358,331084104611,1557732539969