Date,Floor,User-Group,User-Count,WiFi-Conn,Duration-Sec,Traffic-In-Byte,Traffic-Out-Byte,Traffic-Both-Byte
2014-04-01,1,Staff,57,759,859254,4123510924,1454642264,5578153188
2014-04-01,1,TPG,56,645,1036579,27804793658,2407073179,30211866837
2014-04-01,1,RPG,20,193,356293,20760910734,2425123156,23186033890
2014-04-01,1,UG,518,4163,5264792,182899926499,48121797593,231021724092
2014-04-01,1,Alumni,2,16,53238,31901087,7009510,38910597
2014-04-01,1,Others(HKUST),4,37,27323,536720403,63113063,599833466
2014-04-01,1,Non-HKUST,7,37,70199,1635639608,477452225,2113091833
2014-04-01,1,Total,664,5850,7667678,237793402913,54956210990,292749613903
2014-04-01,G,Staff,82,604,471106,7137194802,1297088735,8434283537
2014-04-01,G,TPG,286,1918,1255109,13976322144,3502691726,17479013870
2014-04-01,G,RPG,136,892,644970,6499857972,1217432138,7717290110
2014-04-01,G,UG,1487,8044,5736136,142342687219,24374759640,166717446859
2014-04-01,G,Alumni,8,31,39449,104339605,3967080,108306685
2014-04-01,G,Others(HKUST),10,61,139623,304119740,73854439,377974179
2014-04-01,G,Non-HKUST,14,39,16015,113258419,93642391,206900810
2014-04-01,G,Total,2023,11589,8302408,170477779901,30563436149,201041216050
2014-04-01,LG1,Staff,100,474,337343,955217803,193374665,1148592468
2014-04-01,LG1,TPG,448,5881,6283977,122677907943,23216079784,145893987727
2014-04-01,LG1,RPG,172,1326,1296125,19208589077,5208218489,24416807566
2014-04-01,LG1,UG,2335,21032,22269327,227770815253,63804475205,291575290458
2014-04-01,LG1,Alumni,10,101,104720,1766391300,174703290,1941094590
2014-04-01,LG1,Others(HKUST),8,106,55905,613693,372612,986305
2014-04-01,LG1,Non-HKUST,22,110,64269,1992859533,174640339,2167499872
2014-04-01,LG1,Total,3095,29030,30411666,374372394602,92771864384,467144258986
2014-04-01,LG3,Staff,96,231,180307,3024143379,2593105877,5617249256
2014-04-01,LG3,TPG,242,1443,1705490,28740052077,4261178893,33001230970
2014-04-01,LG3,RPG,156,608,806534,10145124693,1850932237,11996056930
2014-04-01,LG3,UG,1296,4642,4276532,68860765617,9422300996,78283066613
2014-04-01,LG3,Alumni,8,77,27499,159879690,35655997,195535687
2014-04-01,LG3,Others(HKUST),5,15,9016,32604076,7074658,39678734
2014-04-01,LG3,Non-HKUST,17,132,206594,3114698063,421896097,3536594160
2014-04-01,LG3,Total,1820,7148,7211972,114077267595,18592144755,132669412350
2014-04-01,LG4,Staff,88,388,282272,1494195305,193479515,1687674820
2014-04-01,LG4,TPG,284,3634,5424136,109195573935,13006247001,122201820936
2014-04-01,LG4,RPG,114,930,1436979,52140870886,16605059847,68745930733
2014-04-01,LG4,UG,1232,8799,10534160,173125075629,25678821042,198803896671
2014-04-01,LG4,Alumni,10,211,184555,888093010,92866301,980959311
2014-04-01,LG4,Others(HKUST),6,69,139291,9299158151,339016496,9638174647
2014-04-01,LG4,Non-HKUST,14,90,182970,1739112886,729118340,2468231226
2014-04-01,LG4,Total,1748,14121,18184363,347882079802,56644608542,404526688344
2014-04-01,All-Floors,Staff,257,2456,2130282,16734262213,5731691056,22465953269
2014-04-01,All-Floors,TPG,627,13521,15705291,302394649757,46393270583,348787920340
2014-04-01,All-Floors,RPG,351,3949,4540901,108755353362,27306765867,136062119229
2014-04-01,All-Floors,UG,3791,46680,48080947,794999270217,171402154476,966401424693
2014-04-01,All-Floors,Alumni,17,436,409461,2950604692,314202178,3264806870
2014-04-01,All-Floors,Others(HKUST),22,288,371158,10173216063,483431268,10656647331
2014-04-01,All-Floors,Non-HKUST,41,408,540047,8595568509,1896749392,10492317901
2014-04-01,All-Floors,Total,5106,67738,71778087,1244602924813,253528264820,1498131189633
2014-04-02,1,Staff,54,672,851137,14101468443,878849401,14980317844
2014-04-02,1,TPG,51,478,691436,33458759123,3697516041,37156275164
2014-04-02,1,RPG,28,222,330138,28870610814,1728699969,30599310783
2014-04-02,1,UG,567,4251,5946617,160457422497,53749602727,214207025224
2014-04-02,1,Alumni,2,41,53320,1832159508,541452251,2373611759
2014-04-02,1,Others(HKUST),4,23,75305,875894373,62468153,938362526
2014-04-02,1,Non-HKUST,9,62,81456,3514860095,177441367,3692301462
2014-04-02,1,Total,715,5749,8029409,243111174853,60836029909,303947204762
2014-04-02,G,Staff,87,610,495013,9528270858,914123991,10442394849
2014-04-02,G,TPG,301,1553,839595,22043054481,3935412438,25978466919
2014-04-02,G,RPG,143,1067,836624,10140486144,972215881,11112702025
2014-04-02,G,UG,1483,7671,5401565,109121039962,20113861028,129234900990
2014-04-02,G,Alumni,12,45,76534,2485906930,130682001,2616588931
2014-04-02,G,Others(HKUST),14,81,115341,292256302,46808194,339064496
2014-04-02,G,Non-HKUST,12,26,8895,126702828,24937054,151639882
2014-04-02,G,Total,2052,11053,7773567,153737717505,26138040587,179875758092
2014-04-02,LG1,Staff,94,395,232569,1540045330,112461009,1652506339
2014-04-02,LG1,TPG,459,5256,6022574,143857474470,18946647486,162804121956
2014-04-02,LG1,RPG,192,1307,1416330,16359609209,3445186362,19804795571
2014-04-02,LG1,UG,2239,19553,21184495,238228254783,52363588430,290591843213
2014-04-02,LG1,Alumni,16,133,128280,14474811121,799630507,15274441628
2014-04-02,LG1,Others(HKUST),11,85,71668,1894468,7712791,9607259
2014-04-02,LG1,Non-HKUST,31,113,89590,344499296,200551542,545050838
2014-04-02,LG1,Total,3042,26842,29145506,414806588677,75875778127,490682366804
2014-04-02,LG3,Staff,92,233,163495,2467111418,837224021,3304335439
2014-04-02,LG3,TPG,252,1601,1981495,54932473863,9426489804,64358963667
2014-04-02,LG3,RPG,139,517,554946,3370849026,549903620,3920752646
2014-04-02,LG3,UG,1218,4739,4658743,76915333789,20020282151,96935615940
2014-04-02,LG3,Alumni,9,61,53445,1642238147,256281094,1898519241
2014-04-02,LG3,Others(HKUST),6,55,28090,2903356,20436508,23339864
2014-04-02,LG3,Non-HKUST,12,21,31076,943320,178318,1121638
2014-04-02,LG3,Total,1728,7227,7471290,139331852919,31110795516,170442648435
2014-04-02,LG4,Staff,72,279,239144,1170695336,294316969,1465012305
2014-04-02,LG4,TPG,328,4096,6328689,146251401059,25036870060,171288271119
2014-04-02,LG4,RPG,133,1126,1827829,29813082540,5849402269,35662484809
2014-04-02,LG4,UG,1177,8377,10525005,224400668354,32808965249,257209633603
2014-04-02,LG4,Alumni,13,338,321328,3753108372,323645282,4076753654
2014-04-02,LG4,Others(HKUST),6,65,125402,6395327689,212304515,6607632204
2014-04-02,LG4,Non-HKUST,19,139,284453,3496708586,216166145,3712874731
2014-04-02,LG4,Total,1748,14420,19651850,415280991936,64741670489,480022662425
2014-04-02,All-Floors,Staff,250,2189,1981358,28807591385,3036975391,31844566776
2014-04-02,All-Floors,TPG,650,12984,15863789,400543162996,61042935829,461586098825
2014-04-02,All-Floors,RPG,370,4239,4965867,88554637733,12545408101,101100045834
2014-04-02,All-Floors,UG,3769,44591,47716425,809122719385,179056299585,988179018970
2014-04-02,All-Floors,Alumni,22,618,632907,24188224078,2051691135,26239915213
2014-04-02,All-Floors,Others(HKUST),23,309,415806,7568276188,349730161,7918006349
2014-04-02,All-Floors,Non-HKUST,51,361,495470,7483714125,619274426,8102988551
2014-04-02,All-Floors,Total,5135,65291,72071622,1366268325890,258702314628,1624970640518
2014-04-03,1,Staff,52,676,781602,7130952317,539001160,7669953477
2014-04-03,1,TPG,49,697,1054811,34064502457,5648107090,39712609547
2014-04-03,1,RPG,21,224,326877,63692169941,3480838200,67173008141
2014-04-03,1,UG,538,3724,5651157,154498033392,54203706454,208701739846
2014-04-03,1,Alumni,4,33,72376,2023899751,642900130,2666799881
2014-04-03,1,Others(HKUST),3,31,20444,95666603,7808968,103475571
2014-04-03,1,Non-HKUST,14,76,109164,15378185468,686563070,16064748538
2014-04-03,1,Total,681,5461,8016431,276883409929,65208925072,342092335001
2014-04-03,G,Staff,94,461,455264,8355273525,592993879,8948267404
2014-04-03,G,TPG,280,1525,1295505,17247524807,2519022029,19766546836
2014-04-03,G,RPG,130,648,600559,19624136698,2232833293,21856969991
2014-04-03,G,UG,1481,7366,5292540,113711432780,16212680308,129924113088
2014-04-03,G,Alumni,6,28,32980,499387724,111852600,611240324
2014-04-03,G,Others(HKUST),6,113,156844,862338857,375236006,1237574863
2014-04-03,G,Non-HKUST,13,36,28209,2953493031,137558486,3091051517
2014-04-03,G,Total,2010,10177,7861901,163253587422,22182176601,185435764023
2014-04-03,LG1,Staff,108,476,436744,3958697713,406544320,4365242033
2014-04-03,LG1,TPG,417,4848,5921173,180457938097,51763471261,232221409358
2014-04-03,LG1,RPG,169,1042,1401836,32965892105,4748063289,37713955394
2014-04-03,LG1,UG,2106,17088,20510672,441380720282,73689580237,515070300519
2014-04-03,LG1,Alumni,17,176,240433,8488239579,1658867067,10147106646
2014-04-03,LG1,Others(HKUST),10,113,83130,1199055465,461337771,1660393236
2014-04-03,LG1,Non-HKUST,24,126,129922,3820940002,280203880,4101143882
2014-04-03,LG1,Total,2851,23869,28723910,672271483243,133008067825,805279551068
2014-04-03,LG3,Staff,76,221,237936,1423241482,978198926,2401440408
2014-04-03,LG3,TPG,188,1199,1506151,50616956080,8247208057,58864164137
2014-04-03,LG3,RPG,125,601,835235,22345089065,3990227248,26335316313
2014-04-03,LG3,UG,1091,3873,4158116,107930116249,19559866358,127489982607
2014-04-03,LG3,Alumni,9,72,45430,461333267,79779607,541112874
2014-04-03,LG3,Others(HKUST),8,17,9528,2032947068,77111448,2110058516
2014-04-03,LG3,Non-HKUST,12,63,88105,412566856,288376647,700943503
2014-04-03,LG3,Total,1509,6046,6880501,185222250067,33220768291,218443018358
2014-04-03,LG4,Staff,101,389,291303,3333355595,1141610512,4474966107
2014-04-03,LG4,TPG,295,3381,5894198,173502536598,27687282697,201189819295
2014-04-03,LG4,RPG,125,965,1507224,63325904116,15127068692,78452972808
2014-04-03,LG4,UG,1090,6496,8838041,216363297688,37539668589,253902966277
2014-04-03,LG4,Alumni,13,153,185000,7669595396,701845561,8371440957
2014-04-03,LG4,Others(HKUST),6,60,84523,10188650674,390624398,10579275072
2014-04-03,LG4,Non-HKUST,24,111,277024,11883600751,1219395923,13102996674
2014-04-03,LG4,Total,1654,11555,17077313,486266940818,83807496372,570074437190
2014-04-03,All-Floors,Staff,273,2223,2202849,24201520632,3658348797,27859869429
2014-04-03,All-Floors,TPG,600,11650,15671838,455889458039,95865091134,551754549173
2014-04-03,All-Floors,RPG,345,3480,4671731,201953191925,29579030722,231532222647
2014-04-03,All-Floors,UG,3525,38547,44450526,1033883600391,201205501946,1235089102337
2014-04-03,All-Floors,Alumni,27,462,576219,19142455717,3195244965,22337700682
2014-04-03,All-Floors,Others(HKUST),25,334,354469,14378658667,1312118591,15690777258
2014-04-03,All-Floors,Non-HKUST,53,412,632424,34448786108,2612098006,37060884114
2014-04-03,All-Floors,Total,4848,57108,68560056,1783897671479,337427434161,2121325105640
2014-04-04,1,Staff,51,550,673358,6595388038,651032283,7246420321
2014-04-04,1,TPG,47,500,825469,30405065618,6319908253,36724973871
2014-04-04,1,RPG,18,97,207835,18057053729,3125249391,21182303120
2014-04-04,1,UG,381,2661,3846852,107826963594,21285337353,129112300947
2014-04-04,1,Alumni,1,33,14699,1085678325,48256021,1133934346
2014-04-04,1,Others(HKUST),1,19,8501,13237247,3227397,16464644
2014-04-04,1,Non-HKUST,7,27,53916,1976643227,54990509,2031633736
2014-04-04,1,Total,506,3887,5630630,165960029778,31488001207,197448030985
2014-04-04,G,Staff,90,555,472809,3677709709,357290031,4034999740
2014-04-04,G,TPG,252,1253,967038,21854652006,2194519032,24049171038
2014-04-04,G,RPG,106,618,698402,9595457094,1721983528,11317440622
2014-04-04,G,UG,1199,5719,4472427,78428132404,11836083772,90264216176
2014-04-04,G,Alumni,8,34,46263,184256267,48960105,233216372
2014-04-04,G,Others(HKUST),7,33,58182,4956028,2880079,7836107
2014-04-04,G,Non-HKUST,13,80,132233,2507556213,156548548,2664104761
2014-04-04,G,Total,1675,8292,6847354,116252719721,16318265095,132570984816
2014-04-04,LG1,Staff,75,257,280996,3229117469,364156638,3593274107
2014-04-04,LG1,TPG,382,4968,6521285,143776904608,24836832192,168613736800
2014-04-04,LG1,RPG,137,726,1015143,16153125206,6271110437,22424235643
2014-04-04,LG1,UG,1792,12734,16135401,269231871922,42960855829,312192727751
2014-04-04,LG1,Alumni,10,83,87115,293816232,32263739,326079971
2014-04-04,LG1,Others(HKUST),5,62,30520,8047225,1570649,9617874
2014-04-04,LG1,Non-HKUST,21,71,145422,6397302210,440638217,6837940427
2014-04-04,LG1,Total,2422,18901,24215882,439090184872,74907427701,513997612573
2014-04-04,LG3,Staff,79,228,177141,3878618490,1487460373,5366078863
2014-04-04,LG3,TPG,194,1097,1576712,66628159784,17783123508,84411283292
2014-04-04,LG3,RPG,115,486,750541,30533520002,4727577937,35261097939
2014-04-04,LG3,UG,980,3162,3552642,81338173469,13060838199,94399011668
2014-04-04,LG3,Alumni,8,101,50881,1014728529,96358161,1111086690
2014-04-04,LG3,Others(HKUST),6,9,5880,403687,335341,739028
2014-04-04,LG3,Non-HKUST,16,36,66501,26856938895,558743967,27415682862
2014-04-04,LG3,Total,1398,5119,6180298,210250542856,37714437486,247964980342
2014-04-04,LG4,Staff,65,290,260670,3050296244,462321162,3512617406
2014-04-04,LG4,TPG,249,2786,4885507,196719356328,25320656891,222040013219
2014-04-04,LG4,RPG,94,754,1010214,35304901767,7624143653,42929045420
2014-04-04,LG4,UG,824,4789,6740317,178933816650,24965671991,203899488641
2014-04-04,LG4,Alumni,13,179,194634,10272768461,369591981,10642360442
2014-04-04,LG4,Others(HKUST),4,58,92764,5979384803,399185180,6378569983
2014-04-04,LG4,Non-HKUST,16,61,129042,3708241975,472975885,4181217860
2014-04-04,LG4,Total,1265,8917,13313148,433968766228,59614546743,493583312971
2014-04-04,All-Floors,Staff,238,1880,1864974,20431129950,3322260487,23753390437
2014-04-04,All-Floors,TPG,543,10604,14776011,459384138344,76455039876,535839178220
2014-04-04,All-Floors,RPG,285,2681,3682135,109644057798,23470064946,133114122744
2014-04-04,All-Floors,UG,3088,29065,34747639,715758958039,114108787144,829867745183
2014-04-04,All-Floors,Alumni,19,430,393592,12851247814,595430007,13446677821
2014-04-04,All-Floors,Others(HKUST),15,181,195847,6006028990,407198646,6413227636
2014-04-04,All-Floors,Non-HKUST,54,275,527114,41446682520,1683897126,43130579646
2014-04-04,All-Floors,Total,4242,45116,56187312,1365522243455,220042678232,1585564921687
2014-04-05,1,Staff,4,163,82550,31026645,6741134,37767779
2014-04-05,1,TPG,0,0,0,0,0,0
2014-04-05,1,RPG,1,1,0,0,0,0
2014-04-05,1,UG,10,10,834,217032,98588,315620
2014-04-05,1,Alumni,0,0,0,0,0,0
2014-04-05,1,Others(HKUST),1,6,3364,1099433,1592093,2691526
2014-04-05,1,Non-HKUST,0,0,0,0,0,0
2014-04-05,1,Total,16,180,86748,32343110,8431815,40774925
2014-04-05,G,Staff,3,4,122,5990,4056,10046
2014-04-05,G,TPG,17,25,10552,1008674516,156126469,1164800985
2014-04-05,G,RPG,3,3,1681,1427510,427405,1854915
2014-04-05,G,UG,13,14,11762,685316121,183083372,868399493
2014-04-05,G,Alumni,0,0,0,0,0,0
2014-04-05,G,Others(HKUST),1,60,10309,1267456,892621,2160077
2014-04-05,G,Non-HKUST,0,0,0,0,0,0
2014-04-05,G,Total,37,106,34426,1696691593,340533923,2037225516
2014-04-05,LG1,Staff,19,113,106118,2901869125,186029995,3087899120
2014-04-05,LG1,TPG,274,4373,8560662,238173745319,72672795842,310846541161
2014-04-05,LG1,RPG,91,688,1182897,17301781034,5361805967,22663587001
2014-04-05,LG1,UG,561,6179,11242610,153101351590,34588935708,187690287298
2014-04-05,LG1,Alumni,6,172,188035,6473342337,766460786,7239803123
2014-04-05,LG1,Others(HKUST),1,56,33225,5626545,1297600,6924145
2014-04-05,LG1,Non-HKUST,10,110,212766,5875117142,366364560,6241481702
2014-04-05,LG1,Total,962,11691,21526313,423832833092,113943690458,537776523550
2014-04-05,LG3,Staff,12,14,9251,179295523,7348339,186643862
2014-04-05,LG3,TPG,55,81,79381,4589707099,428492224,5018199323
2014-04-05,LG3,RPG,40,44,7894,589473308,19956142,609429450
2014-04-05,LG3,UG,159,199,83034,1363569714,344383687,1707953401
2014-04-05,LG3,Alumni,5,7,2393,4766388,5137102,9903490
2014-04-05,LG3,Others(HKUST),1,1,0,4736,3407,8143
2014-04-05,LG3,Non-HKUST,6,10,19566,198559039,15694447,214253486
2014-04-05,LG3,Total,278,356,201519,6925375807,821015348,7746391155
2014-04-05,LG4,Staff,12,17,10560,50642160,8730192,59372352
2014-04-05,LG4,TPG,24,28,1570,235759989,36449099,272209088
2014-04-05,LG4,RPG,21,32,5993,9668525,2226593,11895118
2014-04-05,LG4,UG,107,150,25762,721694094,39741177,761435271
2014-04-05,LG4,Alumni,3,3,3362,29446653,2523885,31970538
2014-04-05,LG4,Others(HKUST),3,27,83033,13078782995,529917060,13608700055
2014-04-05,LG4,Non-HKUST,4,6,3252,21334237,18146404,39480641
2014-04-05,LG4,Total,174,263,133532,14147328653,637734410,14785063063
2014-04-05,All-Floors,Staff,45,311,208601,3162839443,208853716,3371693159
2014-04-05,All-Floors,TPG,286,4507,8652165,244007886923,73293863634,317301750557
2014-04-05,All-Floors,RPG,135,768,1198465,17902350377,5384416107,23286766484
2014-04-05,All-Floors,UG,696,6552,11364002,155872148551,35156242532,191028391083
2014-04-05,All-Floors,Alumni,12,182,193790,6507555378,774121773,7281677151
2014-04-05,All-Floors,Others(HKUST),6,150,129931,13086781165,533702781,13620483946
2014-04-05,All-Floors,Non-HKUST,17,126,235584,6095010418,400205411,6495215829
2014-04-05,All-Floors,Total,1197,12596,21982538,446634572255,115751405954,562385978209
2014-04-06,1,Staff,17,249,212164,1235092207,277464302,1512556509
2014-04-06,1,TPG,26,261,564475,35256577237,8342842639,43599419876
2014-04-06,1,RPG,21,183,235339,20602628721,1399407825,22002036546
2014-04-06,1,UG,85,818,1327131,50779722194,12464836220,63244558414
2014-04-06,1,Alumni,10,90,136350,1815618125,172014547,1987632672
2014-04-06,1,Others(HKUST),1,8,4320,3181781,891343,4073124
2014-04-06,1,Non-HKUST,8,27,50503,1102405834,135445307,1237851141
2014-04-06,1,Total,168,1636,2530282,110795226099,22792902183,133588128282
2014-04-06,G,Staff,29,205,117283,2257108438,123851540,2380959978
2014-04-06,G,TPG,155,874,865058,15733517991,1936095240,17669613231
2014-04-06,G,RPG,71,311,395506,9271501610,5196685713,14468187323
2014-04-06,G,UG,347,2197,2384907,41743672713,8600039271,50343711984
2014-04-06,G,Alumni,21,81,38141,734411216,193031576,927442792
2014-04-06,G,Others(HKUST),4,77,66743,19175626,5047279,24222905
2014-04-06,G,Non-HKUST,25,112,190974,4021487077,1831038238,5852525315
2014-04-06,G,Total,652,3857,4058612,73780874671,17885788857,91666663528
2014-04-06,LG1,Staff,28,121,113100,6430849595,499119124,6929968719
2014-04-06,LG1,TPG,355,6086,9119162,303110748384,46599741162,349710489546
2014-04-06,LG1,RPG,123,1006,1496323,39716942031,8082226653,47799168684
2014-04-06,LG1,UG,826,8755,12754332,217606569670,47998284263,265604853933
2014-04-06,LG1,Alumni,35,195,230151,9186976441,1075386969,10262363410
2014-04-06,LG1,Others(HKUST),4,98,39125,330305640,64370318,394675958
2014-04-06,LG1,Non-HKUST,34,233,393183,7078453372,724455296,7802908668
2014-04-06,LG1,Total,1405,16494,24145376,583460845133,105043583785,688504428918
2014-04-06,LG3,Staff,29,97,100955,1824561797,185244391,2009806188
2014-04-06,LG3,TPG,148,840,1189107,72718726755,8010315856,80729042611
2014-04-06,LG3,RPG,92,416,578447,49932025588,11526322489,61458348077
2014-04-06,LG3,UG,367,1665,2487168,59993875938,10294602340,70288478278
2014-04-06,LG3,Alumni,32,194,247284,9125777933,1040529827,10166307760
2014-04-06,LG3,Others(HKUST),2,6,1213,99617,51735,151352
2014-04-06,LG3,Non-HKUST,18,71,116139,2741307086,240402175,2981709261
2014-04-06,LG3,Total,688,3289,4720313,196336374714,31297468813,227633843527
2014-04-06,LG4,Staff,30,113,96878,1869845821,261675629,2131521450
2014-04-06,LG4,TPG,162,1945,3333980,156007796200,24912089494,180919885694
2014-04-06,LG4,RPG,77,552,766846,25946442793,3389564218,29336007011
2014-04-06,LG4,UG,286,2209,3490752,98411664487,53163772524,151575437011
2014-04-06,LG4,Alumni,34,279,474243,17317234313,905740951,18222975264
2014-04-06,LG4,Others(HKUST),2,58,127999,14197081053,547315456,14744396509
2014-04-06,LG4,Non-HKUST,22,203,319891,11316998070,2864757546,14181755616
2014-04-06,LG4,Total,613,5359,8610589,325067062737,86044915818,411111978555
2014-04-06,All-Floors,Staff,77,785,640380,13617457858,1347354986,14964812844
2014-04-06,All-Floors,TPG,429,10006,15071782,582827366567,89801084391,672628450958
2014-04-06,All-Floors,RPG,227,2468,3472461,145469540743,29594206898,175063747641
2014-04-06,All-Floors,UG,1127,15644,22444290,468535505002,132521534618,601057039620
2014-04-06,All-Floors,Alumni,65,839,1126169,38180018028,3386703870,41566721898
2014-04-06,All-Floors,Others(HKUST),10,247,239400,14549843717,617676131,15167519848
2014-04-06,All-Floors,Non-HKUST,55,646,1070690,26260651439,5796098562,32056750001
2014-04-06,All-Floors,Total,1990,30635,44065172,1289440383354,263064659456,1552505042810
2014-04-07,1,Staff,52,657,668052,6612527269,794906485,7407433754
2014-04-07,1,TPG,53,452,787561,31919190328,8110957374,40030147702
2014-04-07,1,RPG,22,144,300441,6214194914,2278289242,8492484156
2014-04-07,1,UG,575,4034,5953891,154085050605,24720464926,178805515531
2014-04-07,1,Alumni,2,16,15990,103632551,10260655,113893206
2014-04-07,1,Others(HKUST),1,1,2404,6288822,2142143,8430965
2014-04-07,1,Non-HKUST,6,48,55660,1828368289,94373876,1922742165
2014-04-07,1,Total,711,5352,7783999,200769252778,36011394701,236780647479
2014-04-07,G,Staff,104,636,549878,1749510348,606296515,2355806863
2014-04-07,G,TPG,328,1967,1472888,23822779681,10553731883,34376511564
2014-04-07,G,RPG,132,764,649789,4494399979,607874645,5102274624
2014-04-07,G,UG,1622,8443,5863725,64799444358,13536347053,78335791411
2014-04-07,G,Alumni,5,20,32108,347552875,76372846,423925721
2014-04-07,G,Others(HKUST),9,107,91104,109907818,31372994,141280812
2014-04-07,G,Non-HKUST,13,41,50678,476398129,36181358,512579487
2014-04-07,G,Total,2213,11978,8710170,95799993188,25448177294,121248170482
2014-04-07,LG1,Staff,87,421,326479,7559892800,921958223,8481851023
2014-04-07,LG1,TPG,437,4699,5804691,117822324156,29668949531,147491273687
2014-04-07,LG1,RPG,152,860,1085156,19320053579,3535797394,22855850973
2014-04-07,LG1,UG,2368,20015,22499857,383135009231,93325492192,476460501423
2014-04-07,LG1,Alumni,13,160,202303,460968432,66984410,527952842
2014-04-07,LG1,Others(HKUST),9,85,34896,15181549,4075548,19257097
2014-04-07,LG1,Non-HKUST,29,112,118863,5804182109,318529022,6122711131
2014-04-07,LG1,Total,3095,26352,30072245,534117611856,127841786320,661959398176
2014-04-07,LG3,Staff,103,285,209141,3214834793,2142059163,5356893956
2014-04-07,LG3,TPG,213,1205,1650219,78386001949,11462250034,89848251983
2014-04-07,LG3,RPG,135,612,822499,15565027692,5124972518,20690000210
2014-04-07,LG3,UG,1270,4668,4758004,133488002180,20890701899,154378704079
2014-04-07,LG3,Alumni,8,74,64003,1278512843,150738614,1429251457
2014-04-07,LG3,Others(HKUST),4,9,14516,148204490,16271279,164475769
2014-04-07,LG3,Non-HKUST,12,60,90203,3392271301,122171809,3514443110
2014-04-07,LG3,Total,1745,6913,7608585,235472855248,39909165316,275382020564
2014-04-07,LG4,Staff,75,325,342615,5511286241,1525679900,7036966141
2014-04-07,LG4,TPG,300,4176,6588460,201617771659,55230558569,256848330228
2014-04-07,LG4,RPG,139,880,1346021,35993181583,6174933047,42168114630
2014-04-07,LG4,UG,1228,7640,9812151,171683699457,33654235060,205337934517
2014-04-07,LG4,Alumni,7,131,155231,1615192521,170914727,1786107248
2014-04-07,LG4,Others(HKUST),5,100,105642,23253226749,764741897,24017968646
2014-04-07,LG4,Non-HKUST,15,70,116370,1532399439,168150325,1700549764
2014-04-07,LG4,Total,1769,13322,18466490,441206757649,97689213525,538895971174
2014-04-07,All-Floors,Staff,262,2324,2096165,24648051451,5990900286,30638951737
2014-04-07,All-Floors,TPG,609,12499,16303819,453568067773,115026447391,568594515164
2014-04-07,All-Floors,RPG,334,3260,4203906,81586857747,17721866846,99308724593
2014-04-07,All-Floors,UG,3847,44800,48887628,907191205831,186127241130,1093318446961
2014-04-07,All-Floors,Alumni,20,401,469635,3805859222,475271252,4281130474
2014-04-07,All-Floors,Others(HKUST),20,302,248562,23532809428,818603861,24351413289
2014-04-07,All-Floors,Non-HKUST,48,331,431774,13033619267,739406390,13773025657
2014-04-07,All-Floors,Total,5140,63917,72641489,1507366470719,326899737156,1834266207875
2014-04-08,1,Staff,54,699,651143,4206749337,599148307,4805897644
2014-04-08,1,TPG,62,601,974160,35725924464,9115468916,44841393380
2014-04-08,1,RPG,22,179,205697,57373796506,3579640082,60953436588
2014-04-08,1,UG,551,4152,5614260,155967218867,24374176520,180341395387
2014-04-08,1,Alumni,4,77,52851,3229987021,127644189,3357631210
2014-04-08,1,Others(HKUST),2,3,12772,7457879,3031132,10489011
2014-04-08,1,Non-HKUST,7,57,79753,857636137,83083113,940719250
2014-04-08,1,Total,702,5768,7590636,257368770211,37882192259,295250962470
2014-04-08,G,Staff,106,635,604374,9318065359,1284905031,10602970390
2014-04-08,G,TPG,295,1836,1183668,22990921804,4540223331,27531145135
2014-04-08,G,RPG,145,933,752726,10385669247,1784932654,12170601901
2014-04-08,G,UG,1459,7851,5494584,75683900452,12056561266,87740461718
2014-04-08,G,Alumni,10,31,27178,19017175,5000549,24017724
2014-04-08,G,Others(HKUST),11,95,124561,346563308,112216277,458779585
2014-04-08,G,Non-HKUST,16,25,18380,122869751,26239632,149109383
2014-04-08,G,Total,2042,11406,8205471,118867007096,19810078740,138677085836
2014-04-08,LG1,Staff,106,488,494230,6321446779,754150076,7075596855
2014-04-08,LG1,TPG,414,4282,5118407,138947203458,17928579804,156875783262
2014-04-08,LG1,RPG,161,1167,1181418,19971150844,5250922015,25222072859
2014-04-08,LG1,UG,2259,18339,20896523,247695320989,41820767106,289516088095
2014-04-08,LG1,Alumni,12,96,77488,3083463749,2334682850,5418146599
2014-04-08,LG1,Others(HKUST),14,144,50546,439934744,54677992,494612736
2014-04-08,LG1,Non-HKUST,22,156,116861,1300645098,120356586,1421001684
2014-04-08,LG1,Total,2988,24672,27935473,417759165661,68264136429,486023302090
2014-04-08,LG3,Staff,118,220,119985,8880005453,2038875302,10918880755
2014-04-08,LG3,TPG,219,1218,1450150,46909014977,5528116403,52437131380
2014-04-08,LG3,RPG,150,733,1057330,14746030656,3065733401,17811764057
2014-04-08,LG3,UG,1294,4672,4383127,106163886790,10736298749,116900185539
2014-04-08,LG3,Alumni,7,77,39675,461337929,64571791,525909720
2014-04-08,LG3,Others(HKUST),10,36,32526,130726399,20871235,151597634
2014-04-08,LG3,Non-HKUST,9,16,49180,426349639,64150608,490500247
2014-04-08,LG3,Total,1807,6972,7131973,177717351843,21518617489,199235969332
2014-04-08,LG4,Staff,98,359,502694,21899181908,1386239960,23285421868
2014-04-08,LG4,TPG,290,3654,6184401,254669805224,48124779240,302794584464
2014-04-08,LG4,RPG,147,802,1338630,31166770676,7120407211,38287177887
2014-04-08,LG4,UG,1259,7413,9556393,174121028514,27665203347,201786231861
2014-04-08,LG4,Alumni,13,234,414339,14492431256,843737387,15336168643
2014-04-08,LG4,Others(HKUST),2,65,105158,10983430022,382473574,11365903596
2014-04-08,LG4,Non-HKUST,18,82,174959,2216371226,448116828,2664488054
2014-04-08,LG4,Total,1827,12609,18276574,509549018826,85970957547,595519976373
2014-04-08,All-Floors,Staff,299,2401,2372426,50625448836,6063318676,56688767512
2014-04-08,All-Floors,TPG,583,11591,14910786,499242869927,85237167694,584480037621
2014-04-08,All-Floors,RPG,383,3814,4535801,133643417929,20801635363,154445053292
2014-04-08,All-Floors,UG,3756,42427,45944887,759631355612,116653006988,876284362600
2014-04-08,All-Floors,Alumni,21,515,611531,21286237130,3375636766,24661873896
2014-04-08,All-Floors,Others(HKUST),23,343,325563,11908112352,573270210,12481382562
2014-04-08,All-Floors,Non-HKUST,50,336,439133,4923871851,741946767,5665818618
2014-04-08,All-Floors,Total,5115,61427,69140127,1481261313637,233445982464,1714707296101
2014-04-09,1,Staff,55,572,751484,8551076417,886763940,9437840357
2014-04-09,1,TPG,46,357,572153,35622685171,3279100912,38901786083
2014-04-09,1,RPG,21,108,227189,6819068924,1180821243,7999890167
2014-04-09,1,UG,543,4055,5616653,167739068846,22401804531,190140873377
2014-04-09,1,Alumni,2,39,29127,325267534,37659656,362927190
2014-04-09,1,Others(HKUST),4,21,26855,280307734,25131322,305439056
2014-04-09,1,Non-HKUST,7,18,42762,364890530,113810856,478701386
2014-04-09,1,Total,678,5170,7266223,219702365156,27925092460,247627457616
2014-04-09,G,Staff,94,662,527644,22754211507,807536791,23561748298
2014-04-09,G,TPG,276,1665,1210339,26368288733,4613778853,30982067586
2014-04-09,G,RPG,122,759,724998,21012885417,3123303626,24136189043
2014-04-09,G,UG,1478,8130,5999857,102796671246,14808407798,117605079044
2014-04-09,G,Alumni,7,25,39925,414005190,94008449,508013639
2014-04-09,G,Others(HKUST),7,38,89553,103913879,37219687,141133566
2014-04-09,G,Non-HKUST,19,59,21307,110004559,16594147,126598706
2014-04-09,G,Total,2003,11338,8613623,173559980531,23500849351,197060829882
2014-04-09,LG1,Staff,88,340,324203,6146596395,553343679,6699940074
2014-04-09,LG1,TPG,443,4476,5918874,150229201951,31123161675,181352363626
2014-04-09,LG1,RPG,162,1041,1211389,39655734172,3979716315,43635450487
2014-04-09,LG1,UG,2284,18563,21282725,440645977286,74665345295,515311322581
2014-04-09,LG1,Alumni,15,152,196717,5434266642,923731701,6357998343
2014-04-09,LG1,Others(HKUST),13,160,67061,193962556,24490198,218452754
2014-04-09,LG1,Non-HKUST,29,139,101312,1853145558,214845075,2067990633
2014-04-09,LG1,Total,3034,24871,29102281,644158884560,111484633938,755643518498
2014-04-09,LG3,Staff,96,257,180948,3047499109,1240031644,4287530753
2014-04-09,LG3,TPG,221,1314,1626132,65406531704,6673269618,72079801322
2014-04-09,LG3,RPG,134,591,780630,30887140323,3782079444,34669219767
2014-04-09,LG3,UG,1245,4906,5010745,132686286476,16672648981,149358935457
2014-04-09,LG3,Alumni,11,31,26032,643798752,50246592,694045344
2014-04-09,LG3,Others(HKUST),2,3,596,87405,88203,175608
2014-04-09,LG3,Non-HKUST,15,27,42876,89572929,7876873,97449802
2014-04-09,LG3,Total,1724,7129,7667959,232760916698,28426241355,261187158053
2014-04-09,LG4,Staff,68,281,279341,30415257634,2070744426,32486002060
2014-04-09,LG4,TPG,301,3682,6153889,310459867423,71064135186,381524002609
2014-04-09,LG4,RPG,143,943,1611042,83240400271,12435626012,95676026283
2014-04-09,LG4,UG,1196,7027,9657247,282488182742,42518189658,325006372400
2014-04-09,LG4,Alumni,15,272,282015,6768042205,447374518,7215416723
2014-04-09,LG4,Others(HKUST),7,62,101010,7919272144,294068994,8213341138
2014-04-09,LG4,Non-HKUST,29,188,372693,5761433975,2385492773,8146926748
2014-04-09,LG4,Total,1759,12455,18457237,727052456394,131215631567,858268087961
2014-04-09,All-Floors,Staff,241,2112,2063620,70914641062,5558420480,76473061542
2014-04-09,All-Floors,TPG,633,11494,15481387,588086574982,116753446244,704840021226
2014-04-09,All-Floors,RPG,344,3442,4555248,181615229107,24501546640,206116775747
2014-04-09,All-Floors,UG,3856,42681,47567227,1126356186596,171066396263,1297422582859
2014-04-09,All-Floors,Alumni,25,519,573816,13585380323,1553020916,15138401239
2014-04-09,All-Floors,Others(HKUST),22,284,285075,8497543718,380998404,8878542122
2014-04-09,All-Floors,Non-HKUST,60,431,580950,8179047551,2738619724,10917667275
2014-04-09,All-Floors,Total,5181,60963,71107323,1997234603339,322552448671,2319787052010
2014-04-10,1,Staff,52,532,662822,2197229703,278673905,2475903608
2014-04-10,1,TPG,51,493,967279,39901340873,7040061494,46941402367
2014-04-10,1,RPG,20,83,220787,6260056549,2929674397,9189730946
2014-04-10,1,UG,480,3183,4869949,137950366017,23652656324,161603022341
2014-04-10,1,Alumni,3,31,116635,12887936581,1441460627,14329397208
2014-04-10,1,Others(HKUST),4,23,12979,115661354,8882197,124543551
2014-04-10,1,Non-HKUST,4,24,26756,228526116,26116653,254642769
2014-04-10,1,Total,614,4369,6877207,199541117193,35377525597,234918642790
2014-04-10,G,Staff,86,523,487656,12548348926,490778061,13039126987
2014-04-10,G,TPG,238,1323,1224191,38246943045,5060142270,43307085315
2014-04-10,G,RPG,140,642,608905,12700597761,1200093522,13900691283
2014-04-10,G,UG,1319,7204,5528642,95506207869,13827956329,109334164198
2014-04-10,G,Alumni,10,24,8449,8918695,1514135,10432830
2014-04-10,G,Others(HKUST),10,53,145767,1094079029,110691862,1204770891
2014-04-10,G,Non-HKUST,17,57,57509,1777460138,209733559,1987193697
2014-04-10,G,Total,1820,9826,8061119,161882555463,20900909738,182783465201
2014-04-10,LG1,Staff,100,353,354204,11738362596,1461394058,13199756654
2014-04-10,LG1,TPG,395,3932,5781546,127696777370,20204183739,147900961109
2014-04-10,LG1,RPG,148,848,1052632,37296606223,4324113382,41620719605
2014-04-10,LG1,UG,2006,14959,19289673,382900372281,68391779782,451292152063
2014-04-10,LG1,Alumni,13,94,143374,8021007824,1102522171,9123529995
2014-04-10,LG1,Others(HKUST),13,80,70396,158342264,11443913,169786177
2014-04-10,LG1,Non-HKUST,23,55,60253,561010986,46150796,607161782
2014-04-10,LG1,Total,2698,20321,26752078,568372479544,95541587841,663914067385
2014-04-10,LG3,Staff,65,204,165972,2747455631,1266736643,4014192274
2014-04-10,LG3,TPG,177,986,1431584,47158024369,6278734614,53436758983
2014-04-10,LG3,RPG,109,501,798209,19467422866,3256049754,22723472620
2014-04-10,LG3,UG,965,3239,3952330,117032256347,20529430297,137561686644
2014-04-10,LG3,Alumni,6,17,54762,573161947,133110352,706272299
2014-04-10,LG3,Others(HKUST),8,15,13944,1923841386,71478294,1995319680
2014-04-10,LG3,Non-HKUST,9,20,43241,265557392,28980423,294537815
2014-04-10,LG3,Total,1339,4982,6460042,189167719938,31564520377,220732240315
2014-04-10,LG4,Staff,77,240,284001,4760622376,421790697,5182413073
2014-04-10,LG4,TPG,258,2597,5309016,141312255617,21874888040,163187143657
2014-04-10,LG4,RPG,131,914,1720164,61931207191,11118198612,73049405803
2014-04-10,LG4,UG,936,5114,7153167,170723681399,24214292097,194937973496
2014-04-10,LG4,Alumni,14,191,275045,7933598626,1536634180,9470232806
2014-04-10,LG4,Others(HKUST),8,73,114405,5406197265,227078713,5633275978
2014-04-10,LG4,Non-HKUST,14,97,180730,1902703986,427112389,2329816375
2014-04-10,LG4,Total,1438,9226,15036528,393970266460,59819994728,453790261188
2014-04-10,All-Floors,Staff,238,1852,1954655,33992019232,3919373364,37911392596
2014-04-10,All-Floors,TPG,560,9331,14713616,394315341274,60458010157,454773351431
2014-04-10,All-Floors,RPG,339,2988,4400697,137655890590,22828129667,160484020257
2014-04-10,All-Floors,UG,3370,33699,40793761,904112883913,150616114829,1054728998742
2014-04-10,All-Floors,Alumni,24,357,598265,29424623673,4215241465,33639865138
2014-04-10,All-Floors,Others(HKUST),26,244,357491,8698121298,429574979,9127696277
2014-04-10,All-Floors,Non-HKUST,42,253,368489,4735258618,738093820,5473352438
2014-04-10,All-Floors,Total,4599,48724,63186974,1512934138598,243204538281,1756138676879
2014-04-11,1,Staff,50,570,748135,6207166393,324440445,6531606838
2014-04-11,1,TPG,54,410,778833,18602304773,3900672077,22502976850
2014-04-11,1,RPG,18,45,106468,2736833528,362050568,3098884096
2014-04-11,1,UG,440,2662,3915190,112754205695,15760041047,128514246742
2014-04-11,1,Alumni,5,31,87852,6835746699,672459820,7508206519
2014-04-11,1,Others(HKUST),2,15,17210,20541417,6498663,27040080
2014-04-11,1,Non-HKUST,4,16,30258,115838813,18756837,134595650
2014-04-11,1,Total,573,3749,5683946,147272637318,21044919457,168317556775
2014-04-11,G,Staff,109,541,494163,11723284703,825887861,12549172564
2014-04-11,G,TPG,274,1677,1335053,60364908495,9036056907,69400965402
2014-04-11,G,RPG,110,527,469650,16102265895,5424618397,21526884292
2014-04-11,G,UG,1290,6389,4309197,100784379286,15800115505,116584494791
2014-04-11,G,Alumni,8,47,55245,5089862952,210204062,5300067014
2014-04-11,G,Others(HKUST),7,27,69306,264838565,73614573,338453138
2014-04-11,G,Non-HKUST,17,108,180463,1636644148,347399783,1984043931
2014-04-11,G,Total,1815,9316,6913077,195966184044,31717897088,227684081132
2014-04-11,LG1,Staff,97,354,213173,9469078641,990737245,10459815886
2014-04-11,LG1,TPG,379,3678,4596970,75491426880,10393679297,85885106177
2014-04-11,LG1,RPG,171,1024,1457124,28234766715,4940892609,33175659324
2014-04-11,LG1,UG,1914,14776,17152558,279106264638,50560432066,329666696704
2014-04-11,LG1,Alumni,15,117,116174,244580436,50300047,294880483
2014-04-11,LG1,Others(HKUST),8,110,21823,4074197,1575854,5650051
2014-04-11,LG1,Non-HKUST,32,117,160221,3827805494,196288088,4024093582
2014-04-11,LG1,Total,2616,20176,23718043,396377997001,67133905206,463511902207
2014-04-11,LG3,Staff,111,242,147088,1415428996,1095679030,2511108026
2014-04-11,LG3,TPG,188,960,1336981,46884248394,5563333885,52447582279
2014-04-11,LG3,RPG,145,500,650695,17975699454,3950467984,21926167438
2014-04-11,LG3,UG,1113,3765,4120086,102665806787,20205233906,122871040693
2014-04-11,LG3,Alumni,8,104,90756,1732132373,518281810,2250414183
2014-04-11,LG3,Others(HKUST),8,16,26153,329806143,41986777,371792920
2014-04-11,LG3,Non-HKUST,19,91,147884,10412227634,642036972,11054264606
2014-04-11,LG3,Total,1592,5678,6519643,181415349781,32017020364,213432370145
2014-04-11,LG4,Staff,95,413,395870,5862043083,668975442,6531018525
2014-04-11,LG4,TPG,230,2554,4277071,108770196948,19418412349,128188609297
2014-04-11,LG4,RPG,118,622,910615,45285464840,3780310914,49065775754
2014-04-11,LG4,UG,1135,5931,7751959,180306229348,23814371625,204120600973
2014-04-11,LG4,Alumni,10,190,305999,10761552949,577946188,11339499137
2014-04-11,LG4,Others(HKUST),6,80,96964,6007996296,925075110,6933071406
2014-04-11,LG4,Non-HKUST,23,94,204542,10917607997,418731523,11336339520
2014-04-11,LG4,Total,1617,9884,13943020,367911091461,49603823151,417514914612
2014-04-11,All-Floors,Staff,290,2120,1998429,34677001816,3905720023,38582721839
2014-04-11,All-Floors,TPG,561,9279,12324908,310113085490,48312154515,358425240005
2014-04-11,All-Floors,RPG,359,2718,3594552,110335030432,18458340472,128793370904
2014-04-11,All-Floors,UG,3403,33523,37248990,775616885754,126140194149,901757079903
2014-04-11,All-Floors,Alumni,24,489,656026,24663875409,2029191927,26693067336
2014-04-11,All-Floors,Others(HKUST),19,248,231456,6627256618,1048750977,7676007595
2014-04-11,All-Floors,Non-HKUST,56,426,723368,26910124086,1623213203,28533337289
2014-04-11,All-Floors,Total,4712,48803,56777729,1288943259605,201517565266,1490460824871
2014-04-12,1,Staff,8,65,193857,636724792,80562016,717286808
2014-04-12,1,TPG,27,181,410088,23356605056,1700934113,25057539169
2014-04-12,1,RPG,7,20,44686,353298325,89420329,442718654
2014-04-12,1,UG,54,203,372233,14493023211,993104161,15486127372
2014-04-12,1,Alumni,6,27,28758,483209199,60551212,543760411
2014-04-12,1,Others(HKUST),3,14,4455,14562720,2715153,17277873
2014-04-12,1,Non-HKUST,4,37,42248,1103201253,90571458,1193772711
2014-04-12,1,Total,109,547,1096325,40440624556,3017858442,43458482998
2014-04-12,G,Staff,28,80,81997,3132131251,4027337539,7159468790
2014-04-12,G,TPG,185,756,611650,18258629055,1570831876,19829460931
2014-04-12,G,RPG,69,312,321492,21064241191,7003578644,28067819835
2014-04-12,G,UG,306,1320,1352155,49495249750,4689068712,54184318462
2014-04-12,G,Alumni,19,50,32703,673693095,90492632,764185727
2014-04-12,G,Others(HKUST),5,19,54268,41075941,10232907,51308848
2014-04-12,G,Non-HKUST,17,45,44228,1581589930,190072422,1771662352
2014-04-12,G,Total,629,2582,2498493,94246610213,17581614732,111828224945
2014-04-12,LG1,Staff,30,164,136515,977228859,213117985,1190346844
2014-04-12,LG1,TPG,363,4292,7047104,129522748832,35289978098,164812726930
2014-04-12,LG1,RPG,109,710,1159632,21338645623,3191156569,24529802192
2014-04-12,LG1,UG,720,5738,9083827,176455928420,38723841606,215179770026
2014-04-12,LG1,Alumni,27,275,529634,2275858850,246400963,2522259813
2014-04-12,LG1,Others(HKUST),5,27,50305,605286363,46613902,651900265
2014-04-12,LG1,Non-HKUST,32,334,594560,10364352332,706140730,11070493062
2014-04-12,LG1,Total,1286,11540,18601577,341540049279,78417249853,419957299132
2014-04-12,LG3,Staff,27,44,18383,2328957180,101246333,2430203513
2014-04-12,LG3,TPG,143,462,639601,18575750424,2846422383,21422172807
2014-04-12,LG3,RPG,70,273,243090,3080653413,384571133,3465224546
2014-04-12,LG3,UG,318,839,997581,29007765744,3408036524,32415802268
2014-04-12,LG3,Alumni,19,94,113532,1497435329,155993330,1653428659
2014-04-12,LG3,Others(HKUST),7,10,7213,150917246,5116435,156033681
2014-04-12,LG3,Non-HKUST,13,58,85973,7107495818,932312365,8039808183
2014-04-12,LG3,Total,597,1780,2105373,61748975154,7833698503,69582673657
2014-04-12,LG4,Staff,19,121,141319,1667879261,307812813,1975692074
2014-04-12,LG4,TPG,138,862,1442628,65825729851,9082965256,74908695107
2014-04-12,LG4,RPG,69,321,490601,22838884733,4155320700,26994205433
2014-04-12,LG4,UG,283,1203,1621088,39316915030,5438904138,44755819168
2014-04-12,LG4,Alumni,29,323,574683,12303842138,2362911796,14666753934
2014-04-12,LG4,Others(HKUST),4,87,232667,25731250803,3558613740,29289864543
2014-04-12,LG4,Non-HKUST,13,83,130872,2534635760,340736660,2875372420
2014-04-12,LG4,Total,555,3000,4633858,170219137576,25247265103,195466402679
2014-04-12,All-Floors,Staff,85,474,572071,8742921343,4730076686,13472998029
2014-04-12,All-Floors,TPG,477,6553,10151071,255539463218,50491131726,306030594944
2014-04-12,All-Floors,RPG,209,1636,2259501,68675723285,14824047375,83499770660
2014-04-12,All-Floors,UG,1100,9303,13426884,308768882155,53252955141,362021837296
2014-04-12,All-Floors,Alumni,53,769,1279310,17234038611,2916349933,20150388544
2014-04-12,All-Floors,Others(HKUST),17,157,348908,26543093073,3623292137,30166385210
2014-04-12,All-Floors,Non-HKUST,53,557,897881,22691275093,2259833635,24951108728
2014-04-12,All-Floors,Total,1994,19449,28935626,708195396778,132097686633,840293083411
2014-04-13,1,Staff,9,73,202279,778743039,70827235,849570274
2014-04-13,1,TPG,22,243,438917,23571576602,4356771396,27928347998
2014-04-13,1,RPG,14,56,113237,6845051298,865893117,7710944415
2014-04-13,1,UG,75,601,969180,34723726214,6101318202,40825044416
2014-04-13,1,Alumni,7,71,154999,11747164623,965000081,12712164704
2014-04-13,1,Others(HKUST),0,0,0,0,0,0
2014-04-13,1,Non-HKUST,7,29,96398,4547896512,417938451,4965834963
2014-04-13,1,Total,134,1073,1975010,82214158288,12777748482,94991906770
2014-04-13,G,Staff,29,181,121003,6363316620,1351838769,7715155389
2014-04-13,G,TPG,133,737,833018,20250661437,7202697705,27453359142
2014-04-13,G,RPG,85,471,410811,5520572011,1544867906,7065439917
2014-04-13,G,UG,350,1896,1985599,45942141370,9676474977,55618616347
2014-04-13,G,Alumni,38,96,93044,5608793260,1192750061,6801543321
2014-04-13,G,Others(HKUST),3,5,45125,61190758,5971484,67162242
2014-04-13,G,Non-HKUST,28,132,229505,2877492311,346859140,3224351451
2014-04-13,G,Total,666,3518,3718105,86624167767,21321460042,107945627809
2014-04-13,LG1,Staff,29,143,189361,2273655993,1293269411,3566925404
2014-04-13,LG1,TPG,244,3640,5860213,79631040734,14644811955,94275852689
2014-04-13,LG1,RPG,134,1501,2285805,31510706238,8823280149,40333986387
2014-04-13,LG1,UG,736,7995,11994591,174710785774,31775960492,206486746266
2014-04-13,LG1,Alumni,34,262,303101,1992914243,938313733,2931227976
2014-04-13,LG1,Others(HKUST),4,25,67177,593225,397724,990949
2014-04-13,LG1,Non-HKUST,41,232,297395,2552410227,394488261,2946898488
2014-04-13,LG1,Total,1222,13798,20997643,292672106434,57870521725,350542628159
2014-04-13,LG3,Staff,22,47,86577,737520483,350928296,1088448779
2014-04-13,LG3,TPG,96,491,854762,22936998816,5796896011,28733894827
2014-04-13,LG3,RPG,100,284,218759,4735760791,1569229788,6304990579
2014-04-13,LG3,UG,334,1350,1629292,32501550130,5683673736,38185223866
2014-04-13,LG3,Alumni,29,247,323679,11566334366,7106284382,18672618748
2014-04-13,LG3,Others(HKUST),4,6,11759,290656947,44019358,334676305
2014-04-13,LG3,Non-HKUST,34,152,279214,1645657515,231773503,1877431018
2014-04-13,LG3,Total,619,2577,3404042,74414479048,20782805074,95197284122
2014-04-13,LG4,Staff,28,113,120508,624458120,90033509,714491629
2014-04-13,LG4,TPG,123,1135,1975100,87254600661,14145172018,101399772679
2014-04-13,LG4,RPG,91,449,798127,32135160684,17760374165,49895534849
2014-04-13,LG4,UG,309,1595,2409400,58057584170,12254723092,70312307262
2014-04-13,LG4,Alumni,35,387,627645,20067257312,2076627439,22143884751
2014-04-13,LG4,Others(HKUST),4,68,197415,15287617676,1301586920,16589204596
2014-04-13,LG4,Non-HKUST,33,229,456141,11740766379,3849249922,15590016301
2014-04-13,LG4,Total,623,3976,6584336,225167445002,51477767065,276645212067
2014-04-13,All-Floors,Staff,78,557,719728,10777694255,3156897220,13934591475
2014-04-13,All-Floors,TPG,319,6246,9962010,233644878250,46146349085,279791227335
2014-04-13,All-Floors,RPG,258,2761,3826739,80747251022,30563645125,111310896147
2014-04-13,All-Floors,UG,1090,13437,18988062,345935787658,65492150499,411427938157
2014-04-13,All-Floors,Alumni,67,1063,1502468,50982463804,12278975696,63261439500
2014-04-13,All-Floors,Others(HKUST),11,104,321476,15640058606,1351975486,16992034092
2014-04-13,All-Floors,Non-HKUST,83,774,1358653,23364222944,5240309277,28604532221
2014-04-13,All-Floors,Total,1906,24942,36679136,761092356539,164230302388,925322658927
2014-04-14,1,Staff,47,436,665244,5816917438,1152316782,6969234220
2014-04-14,1,TPG,43,443,805383,28496528295,6590468271,35086996566
2014-04-14,1,RPG,20,78,253288,9785123783,25587386672,35372510455
2014-04-14,1,UG,459,2870,4181386,140685025761,17260343813,157945369574
2014-04-14,1,Alumni,4,23,78200,2374954038,191314870,2566268908
2014-04-14,1,Others(HKUST),2,20,10996,22578865,5623451,28202316
2014-04-14,1,Non-HKUST,7,23,29180,1390831449,259952885,1650784334
2014-04-14,1,Total,582,3893,6023677,188571959629,51047406744,239619366373
2014-04-14,G,Staff,96,579,602700,8602639897,1342531255,9945171152
2014-04-14,G,TPG,250,1721,1175048,35624399413,7231303176,42855702589
2014-04-14,G,RPG,132,688,588440,11967151907,4130364562,16097516469
2014-04-14,G,UG,1440,7621,4670601,92102524933,14597745160,106700270093
2014-04-14,G,Alumni,8,38,42939,99393147,37548670,136941817
2014-04-14,G,Others(HKUST),7,78,108376,8509113300,2910957187,11420070487
2014-04-14,G,Non-HKUST,15,28,3944,104792126,5458224,110250350
2014-04-14,G,Total,1948,10753,7192048,157010014723,30255908234,187265922957
2014-04-14,LG1,Staff,92,371,244948,1712673589,154349012,1867022601
2014-04-14,LG1,TPG,345,4277,5051630,142270891263,21419486106,163690377369
2014-04-14,LG1,RPG,167,1247,1560746,38765859530,5257585254,44023444784
2014-04-14,LG1,UG,2137,16735,18269567,335107758685,49486593550,384594352235
2014-04-14,LG1,Alumni,14,171,172318,2649342646,128138283,2777480929
2014-04-14,LG1,Others(HKUST),9,67,81713,12576161,3417305,15993466
2014-04-14,LG1,Non-HKUST,22,96,74560,1581970225,114754474,1696724699
2014-04-14,LG1,Total,2786,22964,25455482,522101072099,76564323984,598665396083
2014-04-14,LG3,Staff,109,247,190288,3766998529,267157832,4034156361
2014-04-14,LG3,TPG,161,817,1020953,44890516030,10727975462,55618491492
2014-04-14,LG3,RPG,173,640,722065,20984391115,1887152663,22871543778
2014-04-14,LG3,UG,1288,3974,3896983,112490027708,14503978003,126994005711
2014-04-14,LG3,Alumni,9,86,42772,450218634,68386090,518604724
2014-04-14,LG3,Others(HKUST),4,10,12405,53364,39431,92795
2014-04-14,LG3,Non-HKUST,15,86,117803,4765992899,267207076,5033199975
2014-04-14,LG3,Total,1759,5860,6003269,187348198279,27721896557,215070094836
2014-04-14,LG4,Staff,111,302,276580,5893509106,505756505,6399265611
2014-04-14,LG4,TPG,223,2007,3676225,146479579432,19920519641,166400099073
2014-04-14,LG4,RPG,148,828,1405663,68020928114,12624602089,80645530203
2014-04-14,LG4,UG,1249,5763,7126542,162752540105,25212182397,187964722502
2014-04-14,LG4,Alumni,14,317,420257,7061221176,526665190,7587886366
2014-04-14,LG4,Others(HKUST),4,66,121714,16502395538,546586023,17048981561
2014-04-14,LG4,Non-HKUST,19,73,195806,1674158343,197110874,1871269217
2014-04-14,LG4,Total,1768,9356,13222787,408384331814,59533422719,467917754533
2014-04-14,All-Floors,Staff,296,1935,1979760,25792738559,3422111386,29214849945
2014-04-14,All-Floors,TPG,497,9265,11729239,397761914433,65889752656,463651667089
2014-04-14,All-Floors,RPG,388,3481,4530202,149523454449,49487091240,199010545689
2014-04-14,All-Floors,UG,3676,36963,38145079,843137877192,121060842923,964198720115
2014-04-14,All-Floors,Alumni,23,635,756486,12635129641,952053103,13587182744
2014-04-14,All-Floors,Others(HKUST),20,241,335204,25046717228,3466623397,28513340625
2014-04-14,All-Floors,Non-HKUST,47,306,421293,9517745042,844483533,10362228575
2014-04-14,All-Floors,Total,4947,52826,57897263,1463415576544,245122958238,1708538534782
2014-04-15,1,Staff,61,560,854895,9677039367,1396169431,11073208798
2014-04-15,1,TPG,30,373,566581,32713202737,10784574101,43497776838
2014-04-15,1,RPG,23,53,74183,1275801746,108281564,1384083310
2014-04-15,1,UG,324,1895,2733278,81352631647,13276724032,94629355679
2014-04-15,1,Alumni,5,65,143335,3473263771,1629572842,5102836613
2014-04-15,1,Others(HKUST),1,12,9382,60568935,5892204,66461139
2014-04-15,1,Non-HKUST,6,18,47718,1648519819,58125413,1706645232
2014-04-15,1,Total,450,2976,4429372,130201028022,27259339587,157460367609
2014-04-15,G,Staff,116,572,480108,3211531853,1189278465,4400810318
2014-04-15,G,TPG,210,1342,1127362,26440734929,5980152960,32420887889
2014-04-15,G,RPG,125,679,636796,15880117683,1419507469,17299625152
2014-04-15,G,UG,1241,6060,3535339,96954024894,13938352419,110892377313
2014-04-15,G,Alumni,16,31,2183,40696992,5440762,46137754
2014-04-15,G,Others(HKUST),9,46,87413,1535265925,94617470,1629883395
2014-04-15,G,Non-HKUST,19,73,77067,4399117703,485609829,4884727532
2014-04-15,G,Total,1736,8803,5946268,148461489979,23112959374,171574449353
2014-04-15,LG1,Staff,130,521,424001,2828608831,293215814,3121824645
2014-04-15,LG1,TPG,294,3118,3955047,90783163683,20404937959,111188101642
2014-04-15,LG1,RPG,185,1012,1176042,32519004021,4826320130,37345324151
2014-04-15,LG1,UG,1835,12962,15048292,258113748427,67095660234,325209408661
2014-04-15,LG1,Alumni,17,110,128694,1314064836,567223014,1881287850
2014-04-15,LG1,Others(HKUST),10,103,80119,49185513,7895371,57080884
2014-04-15,LG1,Non-HKUST,27,109,111593,714837084,77205134,792042218
2014-04-15,LG1,Total,2498,17935,20923788,386322612395,93272457656,479595070051
2014-04-15,LG3,Staff,130,271,122230,4974931734,584239567,5559171301
2014-04-15,LG3,TPG,150,744,862941,18979585958,21993613454,40973199412
2014-04-15,LG3,RPG,163,668,765720,11228180232,1087417002,12315597234
2014-04-15,LG3,UG,1311,3542,3102853,123939163924,11871397095,135810561019
2014-04-15,LG3,Alumni,13,118,71136,2452488583,295148564,2747637147
2014-04-15,LG3,Others(HKUST),10,19,20762,457629765,18486686,476116451
2014-04-15,LG3,Non-HKUST,13,46,81520,572820990,53120835,625941825
2014-04-15,LG3,Total,1790,5408,5027162,162604801186,35903423203,198508224389
2014-04-15,LG4,Staff,105,340,310448,4487996920,539463530,5027460450
2014-04-15,LG4,TPG,166,1582,3101989,117196633507,28482738163,145679371670
2014-04-15,LG4,RPG,143,770,1214406,32203045743,9622500569,41825546312
2014-04-15,LG4,UG,1085,3847,4118709,145779808163,17039251228,162819059391
2014-04-15,LG4,Alumni,21,224,309778,8003148805,567883991,8571032796
2014-04-15,LG4,Others(HKUST),10,99,180013,21070616821,1128360990,22198977811
2014-04-15,LG4,Non-HKUST,17,62,133681,6629937879,1347720177,7977658056
2014-04-15,LG4,Total,1547,6924,9369024,335371187838,58727918648,394099106486
2014-04-15,All-Floors,Staff,340,2264,2191682,25180108705,4002366807,29182475512
2014-04-15,All-Floors,TPG,419,7159,9613920,286113320814,87646016637,373759337451
2014-04-15,All-Floors,RPG,398,3182,3867147,93106149425,17064026734,110170176159
2014-04-15,All-Floors,UG,3436,28306,28538471,706139377055,123221385008,829360762063
2014-04-15,All-Floors,Alumni,33,548,655126,15283662987,3065269173,18348932160
2014-04-15,All-Floors,Others(HKUST),27,279,377689,23173266959,1255252721,24428519680
2014-04-15,All-Floors,Non-HKUST,50,308,451579,13965233475,2021781388,15987014863
2014-04-15,All-Floors,Total,4703,42046,45695614,1162961119420,238276098468,1401237217888
2014-04-16,1,Staff,48,486,781197,10329853767,538751175,10868604942
2014-04-16,1,TPG,11,73,134794,16947273845,1550599804,18497873649
2014-04-16,1,RPG,8,34,63993,15424349212,1766966978,17191316190
2014-04-16,1,UG,85,550,1120289,29610687186,4491261262,34101948448
2014-04-16,1,Alumni,5,48,138609,3366761830,243652426,3610414256
2014-04-16,1,Others(HKUST),1,23,7988,11083471,5004188,16087659
2014-04-16,1,Non-HKUST,3,31,63251,404449733,41427407,445877140
2014-04-16,1,Total,161,1245,2310121,76094459044,8637663240,84732122284
2014-04-16,G,Staff,97,495,483496,11430842653,696444724,12127287377
2014-04-16,G,TPG,106,570,461053,15564126611,1318830594,16882957205
2014-04-16,G,RPG,102,514,545944,21313528472,2973911505,24287439977
2014-04-16,G,UG,400,1887,1847871,50718454119,9737815626,60456269745
2014-04-16,G,Alumni,5,27,23025,2486387181,87540313,2573927494
2014-04-16,G,Others(HKUST),12,68,142781,5103065914,214375928,5317441842
2014-04-16,G,Non-HKUST,6,12,122,221767,162369,384136
2014-04-16,G,Total,728,3573,3504292,106616626717,15029081059,121645707776
2014-04-16,LG1,Staff,83,368,335347,8068680886,543815336,8612496222
2014-04-16,LG1,TPG,228,2988,4979465,152673003154,18830805210,171503808364
2014-04-16,LG1,RPG,137,1119,1735654,39882335850,6141296060,46023631910
2014-04-16,LG1,UG,678,5489,8818164,168889793921,23201907779,192091701700
2014-04-16,LG1,Alumni,12,99,137977,872194629,109714266,981908895
2014-04-16,LG1,Others(HKUST),8,109,30676,131656414,7764270,139420684
2014-04-16,LG1,Non-HKUST,15,67,118868,208934230,28965526,237899756
2014-04-16,LG1,Total,1161,10239,16156151,370726599084,48864268447,419590867531
2014-04-16,LG3,Staff,118,238,73957,1608958711,66325927,1675284638
2014-04-16,LG3,TPG,107,467,755410,67154699199,9831538378,76986237577
2014-04-16,LG3,RPG,142,572,590651,8619472372,1310126155,9929598527
2014-04-16,LG3,UG,433,1316,1502812,39472305285,4028420543,43500725828
2014-04-16,LG3,Alumni,9,80,33951,2224398793,189431559,2413830352
2014-04-16,LG3,Others(HKUST),6,11,23037,963747501,52943169,1016690670
2014-04-16,LG3,Non-HKUST,10,21,35986,711873379,21936102,733809481
2014-04-16,LG3,Total,825,2705,3015804,120755455240,15500721833,136256177073
2014-04-16,LG4,Staff,88,361,296329,2249737127,358768208,2608505335
2014-04-16,LG4,TPG,116,1180,2313054,148952966998,16118794304,165071761302
2014-04-16,LG4,RPG,122,707,1024952,43025412556,3549822732,46575235288
2014-04-16,LG4,UG,338,1618,1999492,81433800954,16206572597,97640373551
2014-04-16,LG4,Alumni,9,134,142840,5102229569,488301315,5590530884
2014-04-16,LG4,Others(HKUST),7,65,152702,15918484608,757964088,16676448696
2014-04-16,LG4,Non-HKUST,10,111,214065,9633567985,990934088,10624502073
2014-04-16,LG4,Total,690,4176,6143434,306316199797,38471157332,344787357129
2014-04-16,All-Floors,Staff,282,1948,1970326,33688073144,2204105370,35892178514
2014-04-16,All-Floors,TPG,287,5278,8643776,401292069807,47650568290,448942638097
2014-04-16,All-Floors,RPG,333,2946,3961194,128265098462,15742123430,144007221892
2014-04-16,All-Floors,UG,1252,10860,15288628,370125041465,57665977807,427791019272
2014-04-16,All-Floors,Alumni,22,388,476402,14051972002,1118639879,15170611881
2014-04-16,All-Floors,Others(HKUST),26,276,357184,22128037908,1038051643,23166089551
2014-04-16,All-Floors,Non-HKUST,23,242,432292,10959047094,1083425492,12042472586
2014-04-16,All-Floors,Total,2225,21938,31129802,980509339882,126502891911,1107012231793
2014-04-17,1,Staff,50,445,699654,1879958930,322577608,2202536538
2014-04-17,1,TPG,11,102,276741,9522458011,1611877213,11134335224
2014-04-17,1,RPG,8,26,47182,3484507352,262000980,3746508332
2014-04-17,1,UG,55,364,783581,24072699590,8113616686,32186316276
2014-04-17,1,Alumni,4,31,82421,5069006748,314736450,5383743198
2014-04-17,1,Others(HKUST),2,2,359,1472981,199454,1672435
2014-04-17,1,Non-HKUST,3,13,53298,1052172374,63857033,1116029407
2014-04-17,1,Total,133,983,1943236,45082275986,10688865424,55771141410
2014-04-17,G,Staff,95,536,529131,5840548993,641139879,6481688872
2014-04-17,G,TPG,84,630,778620,17646632745,3183436116,20830068861
2014-04-17,G,RPG,90,361,544181,12453453703,2086488579,14539942282
2014-04-17,G,UG,289,1304,1402931,30027091609,2669374382,32696465991
2014-04-17,G,Alumni,7,21,19802,339819759,57702854,397522613
2014-04-17,G,Others(HKUST),6,35,127331,692434032,95252873,787686905
2014-04-17,G,Non-HKUST,11,41,47161,513380836,49391267,562772103
2014-04-17,G,Total,582,2928,3449157,67513361677,8782785950,76296147627
2014-04-17,LG1,Staff,91,302,305410,15574219107,2258828267,17833047374
2014-04-17,LG1,TPG,194,2545,4163334,134121805792,39551529741,173673335533
2014-04-17,LG1,RPG,155,1020,1694055,24150861269,4644303971,28795165240
2014-04-17,LG1,UG,553,4832,8523211,154846014662,76548299503,231394314165
2014-04-17,LG1,Alumni,15,94,62868,632202830,49066870,681269700
2014-04-17,LG1,Others(HKUST),6,93,61602,768082576,33181009,801263585
2014-04-17,LG1,Non-HKUST,16,76,106781,1100104678,227319594,1327424272
2014-04-17,LG1,Total,1030,8962,14917261,331193290914,123312528955,454505819869
2014-04-17,LG3,Staff,105,194,80592,1052595329,63618599,1116213928
2014-04-17,LG3,TPG,84,304,571459,16471354396,1788201748,18259556144
2014-04-17,LG3,RPG,121,362,506832,15539584020,1592688689,17132272709
2014-04-17,LG3,UG,332,1171,1240535,44654933923,14350814756,59005748679
2014-04-17,LG3,Alumni,15,119,83670,1532211001,157594821,1689805822
2014-04-17,LG3,Others(HKUST),8,23,32142,1155704012,83983536,1239687548
2014-04-17,LG3,Non-HKUST,4,73,104632,1227623607,191469143,1419092750
2014-04-17,LG3,Total,669,2246,2619862,81634006288,18228371292,99862377580
2014-04-17,LG4,Staff,81,233,212448,11384681274,523596508,11908277782
2014-04-17,LG4,TPG,95,966,2017673,81340793597,10624450462,91965244059
2014-04-17,LG4,RPG,96,469,699252,23512749699,5119915876,28632665575
2014-04-17,LG4,UG,253,1303,1944332,43611110530,7262575946,50873686476
2014-04-17,LG4,Alumni,16,194,230397,7625598599,1405165973,9030764572
2014-04-17,LG4,Others(HKUST),8,76,168060,26346162936,927249992,27273412928
2014-04-17,LG4,Non-HKUST,8,90,229540,9786730584,2923049899,12709780483
2014-04-17,LG4,Total,557,3331,5501702,203607827219,28786004656,232393831875
2014-04-17,All-Floors,Staff,269,1710,1827235,35732003633,3809760861,39541764494
2014-04-17,All-Floors,TPG,261,4547,7807827,259103044541,56759495280,315862539821
2014-04-17,All-Floors,RPG,315,2238,3491502,79141156043,13705398095,92846554138
2014-04-17,All-Floors,UG,930,8974,13894590,297211850314,108944681273,406156531587
2014-04-17,All-Floors,Alumni,27,459,479158,15198838937,1984266968,17183105905
2014-04-17,All-Floors,Others(HKUST),20,229,389494,28963856537,1139866864,30103723401
2014-04-17,All-Floors,Non-HKUST,20,293,541412,13680012079,3455086936,17135099015
2014-04-17,All-Floors,Total,1842,18450,28431218,729030762084,189798556277,918829318361
2014-04-18,1,Staff,7,101,204043,548122446,79230616,627353062
2014-04-18,1,TPG,1,1,242,17397,8332,25729
2014-04-18,1,RPG,3,9,27002,540197411,44505751,584703162
2014-04-18,1,UG,18,51,76983,2291328843,278492985,2569821828
2014-04-18,1,Alumni,6,34,33482,398193341,58290678,456484019
2014-04-18,1,Others(HKUST),0,0,0,0,0,0
2014-04-18,1,Non-HKUST,3,16,20063,1979696564,63000881,2042697445
2014-04-18,1,Total,38,212,361815,5757556002,523529243,6281085245
2014-04-18,G,Staff,14,75,101477,3032142295,119785309,3151927604
2014-04-18,G,TPG,34,73,51503,1079774925,145829371,1225604296
2014-04-18,G,RPG,27,82,125459,2029183529,364119850,2393303379
2014-04-18,G,UG,113,318,341812,7707398902,1079618405,8787017307
2014-04-18,G,Alumni,8,12,1089,3864123,868906,4733029
2014-04-18,G,Others(HKUST),2,9,21490,56513425,7087645,63601070
2014-04-18,G,Non-HKUST,9,26,11164,299546475,21684058,321230533
2014-04-18,G,Total,207,595,653994,14208423674,1738993544,15947417218
2014-04-18,LG1,Staff,19,94,152998,10893549914,799560433,11693110347
2014-04-18,LG1,TPG,160,2912,5236072,123117925174,82849415126,205967340300
2014-04-18,LG1,RPG,84,853,1722670,16954464245,2783167753,19737631998
2014-04-18,LG1,UG,506,4765,8662471,165314817171,35310082346,200624899517
2014-04-18,LG1,Alumni,15,252,234934,1771615800,250406906,2022022706
2014-04-18,LG1,Others(HKUST),4,18,93972,1418670458,64333973,1483004431
2014-04-18,LG1,Non-HKUST,18,222,393603,4564526849,1195028170,5759555019
2014-04-18,LG1,Total,806,9116,16496720,324035569611,123251994707,447287564318
2014-04-18,LG3,Staff,23,41,12272,36245388,4348893,40594281
2014-04-18,LG3,TPG,43,104,121070,4435783320,311273239,4747056559
2014-04-18,LG3,RPG,38,64,113438,7907441154,467377054,8374818208
2014-04-18,LG3,UG,173,380,368752,5360078404,741125514,6101203918
2014-04-18,LG3,Alumni,10,27,22002,1552936227,109125402,1662061629
2014-04-18,LG3,Others(HKUST),1,1,0,0,0,0
2014-04-18,LG3,Non-HKUST,10,52,46357,515735100,53849658,569584758
2014-04-18,LG3,Total,298,669,683891,19808219593,1687099760,21495319353
2014-04-18,LG4,Staff,16,43,45876,590077895,66743355,656821250
2014-04-18,LG4,TPG,28,124,159334,3399192767,383457223,3782649990
2014-04-18,LG4,RPG,32,77,88975,5362751373,6108743510,11471494883
2014-04-18,LG4,UG,167,575,747784,12555042150,4004641952,16559684102
2014-04-18,LG4,Alumni,11,74,124171,3032168155,267593933,3299762088
2014-04-18,LG4,Others(HKUST),5,68,197056,115226635277,10625423882,125852059159
2014-04-18,LG4,Non-HKUST,7,14,15857,619880300,793621524,1413501824
2014-04-18,LG4,Total,266,975,1379053,140785747917,22250225379,163035973296
2014-04-18,All-Floors,Staff,49,354,516666,15100137938,1069668606,16169806544
2014-04-18,All-Floors,TPG,176,3214,5568221,132032693583,83689983291,215722676874
2014-04-18,All-Floors,RPG,142,1085,2077544,32794037712,9767913918,42561951630
2014-04-18,All-Floors,UG,672,6089,10197802,193228665470,41413961202,234642626672
2014-04-18,All-Floors,Alumni,28,399,415678,6758777646,686285825,7445063471
2014-04-18,All-Floors,Others(HKUST),9,96,312518,116701819160,10696845500,127398664660
2014-04-18,All-Floors,Non-HKUST,28,330,487044,7979385288,2127184291,10106569579
2014-04-18,All-Floors,Total,1104,11567,19575473,504595516797,149451842633,654047359430
2014-04-19,1,Staff,9,102,208616,928082249,125151689,1053233938
2014-04-19,1,TPG,2,8,16331,237370928,17447174,254818102
2014-04-19,1,RPG,0,0,0,0,0,0
2014-04-19,1,UG,14,39,77040,1445325518,125667315,1570992833
2014-04-19,1,Alumni,5,22,52691,1407397502,58149458,1465546960
2014-04-19,1,Others(HKUST),0,0,0,0,0,0
2014-04-19,1,Non-HKUST,4,8,8401,217777657,12734137,230511794
2014-04-19,1,Total,34,179,363079,4235953854,339149773,4575103627
2014-04-19,G,Staff,17,51,95561,923986079,135453026,1059439105
2014-04-19,G,TPG,34,94,119363,16211161872,1158852090,17370013962
2014-04-19,G,RPG,16,52,83211,2283928657,303759850,2587688507
2014-04-19,G,UG,81,297,370487,8484556660,2321767109,10806323769
2014-04-19,G,Alumni,5,5,0,118959,53816,172775
2014-04-19,G,Others(HKUST),1,4,14998,9648662,2850990,12499652
2014-04-19,G,Non-HKUST,5,8,14054,157798848,11422334,169221182
2014-04-19,G,Total,159,511,697674,28071199737,3934159215,32005358952
2014-04-19,LG1,Staff,18,116,207688,2504685024,217344413,2722029437
2014-04-19,LG1,TPG,191,3165,5745110,120956497733,29220534115,150177031848
2014-04-19,LG1,RPG,85,1012,1836631,25271224084,4071034302,29342258386
2014-04-19,LG1,UG,397,4189,7906580,122652756008,23251088721,145903844729
2014-04-19,LG1,Alumni,22,374,429055,4693143837,480803859,5173947696
2014-04-19,LG1,Others(HKUST),3,24,84373,4034172,547016,4581188
2014-04-19,LG1,Non-HKUST,12,149,211952,2850712188,211866064,3062578252
2014-04-19,LG1,Total,728,9029,16421389,278933053046,57453218490,336386271536
2014-04-19,LG3,Staff,12,23,17644,130272608,17666391,147938999
2014-04-19,LG3,TPG,63,214,204419,8591019823,1277318751,9868338574
2014-04-19,LG3,RPG,41,63,57411,5556406550,177617295,5734023845
2014-04-19,LG3,UG,96,196,212549,5635571591,1929598075,7565169666
2014-04-19,LG3,Alumni,9,27,41543,2998779485,505870458,3504649943
2014-04-19,LG3,Others(HKUST),2,2,243,41602,41100,82702
2014-04-19,LG3,Non-HKUST,3,16,16204,482726166,21890838,504617004
2014-04-19,LG3,Total,226,541,550013,23394817825,3930002908,27324820733
2014-04-19,LG4,Staff,11,51,49847,98227571,7400490,105628061
2014-04-19,LG4,TPG,35,165,245677,6119449937,875795986,6995245923
2014-04-19,LG4,RPG,36,92,96334,1649624457,182489624,1832114081
2014-04-19,LG4,UG,93,188,225507,5666123609,1311825298,6977948907
2014-04-19,LG4,Alumni,12,36,116013,2334065864,172193446,2506259310
2014-04-19,LG4,Others(HKUST),2,24,144752,32139481950,8614356687,40753838637
2014-04-19,LG4,Non-HKUST,5,18,45874,702150899,80770621,782921520
2014-04-19,LG4,Total,194,574,924004,48709124287,11244832152,59953956439
2014-04-19,All-Floors,Staff,44,343,579356,4585253531,503016009,5088269540
2014-04-19,All-Floors,TPG,215,3646,6330900,152115500293,32549948116,184665448409
2014-04-19,All-Floors,RPG,129,1219,2073587,34761183748,4734901071,39496084819
2014-04-19,All-Floors,UG,512,4909,8792163,143884333386,28939946518,172824279904
2014-04-19,All-Floors,Alumni,34,464,639302,11433505647,1217071037,12650576684
2014-04-19,All-Floors,Others(HKUST),7,54,244366,32153206386,8617795793,40771002179
2014-04-19,All-Floors,Non-HKUST,17,199,296485,4411165758,338683994,4749849752
2014-04-19,All-Floors,Total,958,10834,18956159,383344148749,76901362538,460245511287
2014-04-20,1,Staff,4,121,210487,529029415,79475865,608505280
2014-04-20,1,TPG,1,1,0,0,0,0
2014-04-20,1,RPG,0,0,0,0,0,0
2014-04-20,1,UG,6,6,237,178453136,9222696,187675832
2014-04-20,1,Alumni,0,0,0,0,0,0
2014-04-20,1,Others(HKUST),2,2,0,0,0,0
2014-04-20,1,Non-HKUST,0,0,0,0,0,0
2014-04-20,1,Total,13,130,210724,707482551,88698561,796181112
2014-04-20,G,Staff,2,2,0,1913785,137491,2051276
2014-04-20,G,TPG,12,16,6114,199280893,58134974,257415867
2014-04-20,G,RPG,7,9,591,381450,80159,461609
2014-04-20,G,UG,12,17,13082,1088934282,55077522,1144011804
2014-04-20,G,Alumni,0,0,0,0,0,0
2014-04-20,G,Others(HKUST),0,0,0,0,0,0
2014-04-20,G,Non-HKUST,2,3,365,971033,269414,1240447
2014-04-20,G,Total,35,47,20152,1291481443,113699560,1405181003
2014-04-20,LG1,Staff,12,64,100900,1064537030,128715895,1193252925
2014-04-20,LG1,TPG,227,4550,8290202,165781135865,26375120672,192156256537
2014-04-20,LG1,RPG,74,713,1279141,26100542408,6324252648,32424795056
2014-04-20,LG1,UG,458,5915,9859298,107709271056,21064090084,128773361140
2014-04-20,LG1,Alumni,6,146,243496,1496714186,130655454,1627369640
2014-04-20,LG1,Others(HKUST),2,9,87968,260035137,109206318,369241455
2014-04-20,LG1,Non-HKUST,4,56,128730,167624365,22322632,189946997
2014-04-20,LG1,Total,783,11453,19989735,302579860047,54154363703,356734223750
2014-04-20,LG3,Staff,14,16,722,46050040,1918017,47968057
2014-04-20,LG3,TPG,56,89,28991,459037599,167999393,627036992
2014-04-20,LG3,RPG,33,40,8535,489900744,17219506,507120250
2014-04-20,LG3,UG,142,180,33731,661365676,31859836,693225512
2014-04-20,LG3,Alumni,3,3,0,0,0,0
2014-04-20,LG3,Others(HKUST),1,2,248,6860,5983,12843
2014-04-20,LG3,Non-HKUST,3,5,12604,33393818,4213122,37606940
2014-04-20,LG3,Total,252,335,84831,1689754737,223215857,1912970594
2014-04-20,LG4,Staff,15,17,2388,46054824,2040280,48095104
2014-04-20,LG4,TPG,31,34,9844,2969315,2048455,5017770
2014-04-20,LG4,RPG,34,52,57830,8583875318,202394592,8786269910
2014-04-20,LG4,UG,98,127,15850,963109962,26714100,989824062
2014-04-20,LG4,Alumni,2,8,32991,597496028,55395516,652891544
2014-04-20,LG4,Others(HKUST),1,60,159501,223918330192,79712047474,303630377666
2014-04-20,LG4,Non-HKUST,1,1,0,0,0,0
2014-04-20,LG4,Total,182,299,278404,234111835639,80000640417,314112476056
2014-04-20,All-Floors,Staff,43,220,314497,1687585094,212287548,1899872642
2014-04-20,All-Floors,TPG,233,4690,8335151,166442423672,26603303494,193045727166
2014-04-20,All-Floors,RPG,127,814,1346097,35174699920,6543946905,41718646825
2014-04-20,All-Floors,UG,546,6245,9922198,110601134112,21186964238,131788098350
2014-04-20,All-Floors,Alumni,10,157,276487,2094210214,186050970,2280261184
2014-04-20,All-Floors,Others(HKUST),6,73,247717,224178372189,79821259775,303999631964
2014-04-20,All-Floors,Non-HKUST,9,65,141699,201989216,26805168,228794384
2014-04-20,All-Floors,Total,974,12264,20583846,540380414417,134580618098,674961032515
2014-04-21,1,Staff,17,197,364619,6400952932,338547560,6739500492
2014-04-21,1,TPG,25,134,274915,7877332969,539525396,8416858365
2014-04-21,1,RPG,8,39,68205,2064957882,93035841,2157993723
2014-04-21,1,UG,101,576,1228050,25438720040,13821109075,39259829115
2014-04-21,1,Alumni,6,48,78051,862122210,825425514,1687547724
2014-04-21,1,Others(HKUST),1,1,10551,197291132,18636254,215927386
2014-04-21,1,Non-HKUST,4,8,19223,1877467154,146782870,2024250024
2014-04-21,1,Total,162,1003,2043614,44718844319,15783062510,60501906829
2014-04-21,G,Staff,34,224,153318,6577641168,743187436,7320828604
2014-04-21,G,TPG,134,610,600797,24938374292,8505995043,33444369335
2014-04-21,G,RPG,51,188,147187,17868376965,2789230435,20657607400
2014-04-21,G,UG,451,2220,1947909,61600105733,6866603585,68466709318
2014-04-21,G,Alumni,15,28,38755,823771119,46287320,870058439
2014-04-21,G,Others(HKUST),2,6,29147,9572512,3323703,12896215
2014-04-21,G,Non-HKUST,9,12,21471,1360232367,61949074,1422181441
2014-04-21,G,Total,696,3288,2938584,113178074156,19016576596,132194650752
2014-04-21,LG1,Staff,20,119,182064,1040339928,160016027,1200355955
2014-04-21,LG1,TPG,295,5354,9238039,183823528032,40740865248,224564393280
2014-04-21,LG1,RPG,115,1172,1810060,40777771314,7849498756,48627270070
2014-04-21,LG1,UG,1004,10159,15749559,173398380469,39528843838,212927224307
2014-04-21,LG1,Alumni,21,170,336441,1121234972,101065379,1222300351
2014-04-21,LG1,Others(HKUST),4,77,34818,1202634838,39739623,1242374461
2014-04-21,LG1,Non-HKUST,24,174,296839,3954677161,281318876,4235996037
2014-04-21,LG1,Total,1483,17225,27647820,405318566714,88701347747,494019914461
2014-04-21,LG3,Staff,21,54,53136,3426212025,1027558911,4453770936
2014-04-21,LG3,TPG,146,525,647487,36232187722,6469680794,42701868516
2014-04-21,LG3,RPG,77,259,190301,6019989706,6126100155,12146089861
2014-04-21,LG3,UG,472,1502,1394228,31306891730,8332893016,39639784746
2014-04-21,LG3,Alumni,17,85,86011,1160870220,133652687,1294522907
2014-04-21,LG3,Others(HKUST),4,30,20391,150336404,33759422,184095826
2014-04-21,LG3,Non-HKUST,12,95,112727,4888589793,429213716,5317803509
2014-04-21,LG3,Total,749,2550,2504281,83185077600,22552858701,105737936301
2014-04-21,LG4,Staff,20,73,85029,1776078975,154684536,1930763511
2014-04-21,LG4,TPG,138,1115,1885055,71759019563,12679498427,84438517990
2014-04-21,LG4,RPG,71,411,531648,13765282392,1987699058,15752981450
2014-04-21,LG4,UG,419,2619,3886914,91124026168,16653981841,107778008009
2014-04-21,LG4,Alumni,25,168,330147,9443297045,713727107,10157024152
2014-04-21,LG4,Others(HKUST),4,108,212852,15051842173,3019549253,18071391426
2014-04-21,LG4,Non-HKUST,21,192,331896,9201481797,496985503,9698467300
2014-04-21,LG4,Total,698,4686,7263541,212121028113,35706125725,247827153838
2014-04-21,All-Floors,Staff,75,667,838166,19221225028,2423994470,21645219498
2014-04-21,All-Floors,TPG,362,7738,12646293,324630442578,68935564908,393566007486
2014-04-21,All-Floors,RPG,206,2069,2747401,80496378259,18845564245,99341942504
2014-04-21,All-Floors,UG,1429,17076,24206660,382868124140,85203431355,468071555495
2014-04-21,All-Floors,Alumni,44,499,869405,13411295566,1820158007,15231453573
2014-04-21,All-Floors,Others(HKUST),9,222,307759,16611677059,3115008255,19726685314
2014-04-21,All-Floors,Non-HKUST,41,481,782156,21282448272,1416250039,22698698311
2014-04-21,All-Floors,Total,2166,28752,42397840,858521590902,181759971279,1040281562181
2014-04-22,1,Staff,47,592,825199,25884652682,1720596250,27605248932
2014-04-22,1,TPG,63,619,873271,49188289832,5269116233,54457406065
2014-04-22,1,RPG,12,69,108436,2505792159,987626924,3493419083
2014-04-22,1,UG,633,4618,6208547,160370535163,50391402881,210761938044
2014-04-22,1,Alumni,4,32,63380,500341440,84323825,584665265
2014-04-22,1,Others(HKUST),2,16,25406,349377208,26398901,375776109
2014-04-22,1,Non-HKUST,9,40,79462,403108865,19845516,422954381
2014-04-22,1,Total,770,5986,8183701,239202097349,58499310530,297701407879
2014-04-22,G,Staff,108,722,531604,3415977380,668363946,4084341326
2014-04-22,G,TPG,319,1917,1407995,18692477573,7319191474,26011669047
2014-04-22,G,RPG,135,721,637253,15684511544,2901574413,18586085957
2014-04-22,G,UG,1720,8408,6106105,106676658743,29600233802,136276892545
2014-04-22,G,Alumni,6,45,39882,78643453,12354125,90997578
2014-04-22,G,Others(HKUST),8,43,131809,1833304554,140269688,1973574242
2014-04-22,G,Non-HKUST,17,81,40074,1634708579,135931374,1770639953
2014-04-22,G,Total,2313,11937,8894722,148016281826,40777918822,188794200648
2014-04-22,LG1,Staff,102,517,438570,4003366870,367842949,4371209819
2014-04-22,LG1,TPG,423,5009,6242448,131083832440,80664500889,211748333329
2014-04-22,LG1,RPG,159,847,1032874,14606653282,3394629179,18001282461
2014-04-22,LG1,UG,2350,18464,20171923,228746383374,61409767150,290156150524
2014-04-22,LG1,Alumni,9,38,25258,22621159,1518853,24140012
2014-04-22,LG1,Others(HKUST),11,143,58565,3096254,1178893,4275147
2014-04-22,LG1,Non-HKUST,24,147,158288,2927456146,155388502,3082844648
2014-04-22,LG1,Total,3078,25165,28127926,381393409525,145994826415,527388235940
2014-04-22,LG3,Staff,109,257,127447,5250915553,2210649471,7461565024
2014-04-22,LG3,TPG,220,1123,1334418,70522380500,12583532697,83105913197
2014-04-22,LG3,RPG,165,561,715565,13449391187,3207195989,16656587176
2014-04-22,LG3,UG,1618,5581,5269733,148515160803,27883605757,176398766560
2014-04-22,LG3,Alumni,8,24,42945,1831867925,146979307,1978847232
2014-04-22,LG3,Others(HKUST),5,18,26179,2949582465,79676110,3029258575
2014-04-22,LG3,Non-HKUST,14,102,212956,1881855019,212529904,2094384923
2014-04-22,LG3,Total,2139,7666,7729243,244401153452,46324169235,290725322687
2014-04-22,LG4,Staff,96,324,319317,4589160542,1017883631,5607044173
2014-04-22,LG4,TPG,270,3054,4793268,150283983302,21579577512,171863560814
2014-04-22,LG4,RPG,155,797,1468449,48385378522,16622964444,65008342966
2014-04-22,LG4,UG,1570,8443,10061995,206066643764,44020915715,250087559479
2014-04-22,LG4,Alumni,9,172,239012,6429632854,191170176,6620803030
2014-04-22,LG4,Others(HKUST),11,91,187440,20674102984,2182347820,22856450804
2014-04-22,LG4,Non-HKUST,18,176,267326,8060986140,631168006,8692154146
2014-04-22,LG4,Total,2129,13057,17336807,444489888108,86246027304,530735915412
2014-04-22,All-Floors,Staff,294,2412,2242137,43144073027,5985336247,49129409274
2014-04-22,All-Floors,TPG,569,11722,14651400,419770963647,127415918805,547186882452
2014-04-22,All-Floors,RPG,399,2995,3962577,94631726694,27113990949,121745717643
2014-04-22,All-Floors,UG,4184,45514,47818303,850375381847,213305925305,1063681307152
2014-04-22,All-Floors,Alumni,21,311,410477,8863106831,436346286,9299453117
2014-04-22,All-Floors,Others(HKUST),28,311,429399,25809463465,2429871412,28239334877
2014-04-22,All-Floors,Non-HKUST,53,546,758106,14908114749,1154863302,16062978051
2014-04-22,All-Floors,Total,5548,63811,70272399,1457502830260,377842252306,1835345082566
2014-04-23,1,Staff,56,580,818927,3775571493,404999433,4180570926
2014-04-23,1,TPG,61,745,1324452,30531224948,3972456820,34503681768
2014-04-23,1,RPG,20,124,218366,3906234038,652862434,4559096472
2014-04-23,1,UG,514,3531,5448031,134235499631,31391919608,165627419239
2014-04-23,1,Alumni,6,79,122301,13166235398,693157174,13859392572
2014-04-23,1,Others(HKUST),2,20,9113,10344690,4983284,15327974
2014-04-23,1,Non-HKUST,4,26,46445,189159096,15286884,204445980
2014-04-23,1,Total,663,5105,7987635,185814269294,37135665637,222949934931
2014-04-23,G,Staff,100,712,612070,11413978791,765543711,12179522502
2014-04-23,G,TPG,315,1822,1508362,28348361232,7251249705,35599610937
2014-04-23,G,RPG,132,758,774707,17345457529,2382726095,19728183624
2014-04-23,G,UG,1534,6959,4877398,107053979832,22418530494,129472510326
2014-04-23,G,Alumni,6,33,40031,398516147,98344774,496860921
2014-04-23,G,Others(HKUST),8,34,48675,556499936,31954366,588454302
2014-04-23,G,Non-HKUST,19,65,61966,1445946069,542216950,1988163019
2014-04-23,G,Total,2114,10383,7923209,166562739536,33490566095,200053305631
2014-04-23,LG1,Staff,104,446,401426,4697773827,1191605048,5889378875
2014-04-23,LG1,TPG,446,5606,6971516,151902415951,330898264788,482800680739
2014-04-23,LG1,RPG,151,992,993874,12936399247,2658512281,15594911528
2014-04-23,LG1,UG,2437,19748,21547348,251152065209,72567406669,323719471878
2014-04-23,LG1,Alumni,13,117,134238,1486633348,642950937,2129584285
2014-04-23,LG1,Others(HKUST),14,163,56628,48257709,9035403,57293112
2014-04-23,LG1,Non-HKUST,30,103,134089,2796781821,528126191,3324908012
2014-04-23,LG1,Total,3195,27175,30239119,425020327112,408495901317,833516228429
2014-04-23,LG3,Staff,111,213,86491,604671896,71054091,675725987
2014-04-23,LG3,TPG,254,1281,1471469,43621388979,8539515991,52160904970
2014-04-23,LG3,RPG,181,617,559928,6909202103,2278989063,9188191166
2014-04-23,LG3,UG,1572,5080,4616237,107349708588,15678608016,123028316604
2014-04-23,LG3,Alumni,7,15,8259,256122141,50015936,306138077
2014-04-23,LG3,Others(HKUST),9,26,9725,76808563,8674929,85483492
2014-04-23,LG3,Non-HKUST,18,106,199145,3131889442,222188890,3354078332
2014-04-23,LG3,Total,2152,7338,6951254,161949791712,26849046916,188798838628
2014-04-23,LG4,Staff,106,337,392890,2776590381,434079897,3210670278
2014-04-23,LG4,TPG,342,3871,5610577,208785559810,48413483298,257199043108
2014-04-23,LG4,RPG,188,888,1400593,32689694612,3563422322,36253116934
2014-04-23,LG4,UG,1641,8704,9651056,222412299319,38255105043,260667404362
2014-04-23,LG4,Alumni,9,129,169221,6935131223,1288708561,8223839784
2014-04-23,LG4,Others(HKUST),10,90,139863,13983386774,1537626961,15521013735
2014-04-23,LG4,Non-HKUST,18,97,181899,832510664,97131007,929641671
2014-04-23,LG4,Total,2314,14116,17546099,488415172783,93589557089,582004729872
2014-04-23,All-Floors,Staff,292,2288,2311804,23268586388,2867282180,26135868568
2014-04-23,All-Floors,TPG,643,13325,16886376,463188950920,399074970602,862263921522
2014-04-23,All-Floors,RPG,433,3379,3947468,73786987529,11536512195,85323499724
2014-04-23,All-Floors,UG,4142,44022,46140070,822203552579,180311569830,1002515122409
2014-04-23,All-Floors,Alumni,21,373,474050,22242638257,2773177382,25015815639
2014-04-23,All-Floors,Others(HKUST),27,333,264004,14675297672,1592274943,16267572615
2014-04-23,All-Floors,Non-HKUST,51,397,623544,8396287092,1404949922,9801237014
2014-04-23,All-Floors,Total,5609,64117,70647316,1427762300437,599560737054,2027323037491
2014-04-24,1,Staff,56,527,679957,4664895825,533726962,5198622787
2014-04-24,1,TPG,57,660,1063519,29155973519,6329659611,35485633130
2014-04-24,1,RPG,23,156,271694,9410187515,1099290698,10509478213
2014-04-24,1,UG,519,3406,4946464,133143980700,15677269692,148821250392
2014-04-24,1,Alumni,7,93,135029,3873766651,430674767,4304441418
2014-04-24,1,Others(HKUST),4,74,89070,6447886325,405010615,6852896940
2014-04-24,1,Non-HKUST,2,3,2403,38965029,3179554,42144583
2014-04-24,1,Total,668,4919,7188136,186735655564,24478811899,211214467463
2014-04-24,G,Staff,117,689,684726,5224628957,707416380,5932045337
2014-04-24,G,TPG,292,1781,1430874,20630088872,3422391091,24052479963
2014-04-24,G,RPG,128,575,604590,19967795697,9807419953,29775215650
2014-04-24,G,UG,1469,7157,5260541,118361770704,49239404275,167601174979
2014-04-24,G,Alumni,8,51,52503,96313045,15574613,111887658
2014-04-24,G,Others(HKUST),10,64,129610,9524615112,207673311,9732288423
2014-04-24,G,Non-HKUST,13,33,11878,250701724,22841709,273543433
2014-04-24,G,Total,2037,10350,8174722,174055914111,63422721332,237478635443
2014-04-24,LG1,Staff,109,494,412850,4210316880,369899409,4580216289
2014-04-24,LG1,TPG,438,4655,6032740,86020718939,41160546571,127181265510
2014-04-24,LG1,RPG,144,990,1415801,27917421030,5898250365,33815671395
2014-04-24,LG1,UG,2353,18679,22325427,250874640007,65659275204,316533915211
2014-04-24,LG1,Alumni,10,70,36961,517339687,32989089,550328776
2014-04-24,LG1,Others(HKUST),17,155,64429,129211727,13241138,142452865
2014-04-24,LG1,Non-HKUST,20,151,168636,3166794483,425446424,3592240907
2014-04-24,LG1,Total,3091,25194,30456844,372836442753,113559648200,486396090953
2014-04-24,LG3,Staff,120,233,107640,1666538811,416065230,2082604041
2014-04-24,LG3,TPG,216,1239,1463845,23148170496,15536226888,38684397384
2014-04-24,LG3,RPG,161,485,543943,3512924501,1854615807,5367540308
2014-04-24,LG3,UG,1492,4845,4416217,85389662175,15590318404,100979980579
2014-04-24,LG3,Alumni,6,29,29411,182407812,18395421,200803233
2014-04-24,LG3,Others(HKUST),14,28,41658,119724523,11038075,130762598
2014-04-24,LG3,Non-HKUST,12,93,172233,1873694544,215085445,2088779989
2014-04-24,LG3,Total,2021,6952,6774947,115893122862,33641745270,149534868132
2014-04-24,LG4,Staff,128,429,422266,4748424151,898260437,5646684588
2014-04-24,LG4,TPG,298,3356,5503546,135059469608,24030942324,159090411932
2014-04-24,LG4,RPG,168,845,1123801,25770109521,10197888851,35967998372
2014-04-24,LG4,UG,1593,8173,10012006,208008886037,41983844408,249992730445
2014-04-24,LG4,Alumni,8,104,124028,893304872,72717186,966022058
2014-04-24,LG4,Others(HKUST),7,110,159923,28601286000,2359659284,30960945284
2014-04-24,LG4,Non-HKUST,18,88,99942,4159417616,208475917,4367893533
2014-04-24,LG4,Total,2220,13105,17445512,407240897805,79751788407,486992686212
2014-04-24,All-Floors,Staff,314,2372,2307439,20514804624,2925368418,23440173042
2014-04-24,All-Floors,TPG,606,11691,15494524,294014421434,90479766485,384494187919
2014-04-24,All-Floors,RPG,400,3051,3959829,86578438264,28857465674,115435903938
2014-04-24,All-Floors,UG,4042,42260,46960655,795778939623,188150111983,983929051606
2014-04-24,All-Floors,Alumni,23,347,377932,5563132067,570351076,6133483143
2014-04-24,All-Floors,Others(HKUST),32,431,484690,44822723687,2996622423,47819346110
2014-04-24,All-Floors,Non-HKUST,42,368,455092,9489573396,875029049,10364602445
2014-04-24,All-Floors,Total,5459,60520,70040161,1256762033095,314854715108,1571616748203
2014-04-25,1,Staff,54,485,912632,6284997783,623144815,6908142598
2014-04-25,1,TPG,44,416,688777,56752393380,6911665387,63664058767
2014-04-25,1,RPG,15,82,162352,5580234909,576479871,6156714780
2014-04-25,1,UG,379,2637,3973515,128717213939,25075817449,153793031388
2014-04-25,1,Alumni,5,51,110702,6549246162,472083662,7021329824
2014-04-25,1,Others(HKUST),3,33,57499,2801184357,165156753,2966341110
2014-04-25,1,Non-HKUST,6,15,28225,179158668,15172950,194331618
2014-04-25,1,Total,506,3719,5933702,206864429198,33839520887,240703950085
2014-04-25,G,Staff,100,658,728285,9262171671,2390846324,11653017995
2014-04-25,G,TPG,285,1876,1545489,27239961276,18788904095,46028865371
2014-04-25,G,RPG,119,592,689348,9491235380,962136640,10453372020
2014-04-25,G,UG,1198,5954,4267529,95413684004,19830943038,115244627042
2014-04-25,G,Alumni,5,14,5533,20392813,6483917,26876730
2014-04-25,G,Others(HKUST),9,51,166820,3383713257,408625279,3792338536
2014-04-25,G,Non-HKUST,15,87,73608,2075959037,218310048,2294269085
2014-04-25,G,Total,1731,9232,7476612,146887117438,42606249341,189493366779
2014-04-25,LG1,Staff,91,383,435523,4185725250,432004339,4617729589
2014-04-25,LG1,TPG,395,5078,6480946,123895492996,21942063098,145837556094
2014-04-25,LG1,RPG,152,911,1295563,39203811362,4804576385,44008387747
2014-04-25,LG1,UG,1954,15089,18951534,253910811786,52514485506,306425297292
2014-04-25,LG1,Alumni,12,139,173961,13651503332,2273191243,15924694575
2014-04-25,LG1,Others(HKUST),8,88,56747,103735363,18976581,122711944
2014-04-25,LG1,Non-HKUST,27,108,222202,1106181381,692148636,1798330017
2014-04-25,LG1,Total,2639,21796,27616476,436057261470,82677445788,518734707258
2014-04-25,LG3,Staff,112,248,163780,9134450564,613254709,9747705273
2014-04-25,LG3,TPG,200,1056,1325081,22217940683,4478389293,26696329976
2014-04-25,LG3,RPG,120,416,589328,27692644470,1414019020,29106663490
2014-04-25,LG3,UG,1154,3877,4163413,107740303539,13935544634,121675848173
2014-04-25,LG3,Alumni,9,54,31393,1874450572,165249265,2039699837
2014-04-25,LG3,Others(HKUST),8,20,23628,1399894328,53131853,1453026181
2014-04-25,LG3,Non-HKUST,12,85,159313,3402025303,145707913,3547733216
2014-04-25,LG3,Total,1615,5756,6455936,173461709459,20805296687,194267006146
2014-04-25,LG4,Staff,89,279,245163,7792275147,652471576,8444746723
2014-04-25,LG4,TPG,278,3435,6120997,232932392159,39128479552,272060871711
2014-04-25,LG4,RPG,121,634,962422,23288085448,2442347316,25730432764
2014-04-25,LG4,UG,1017,5085,6434516,151574404873,27468482948,179042887821
2014-04-25,LG4,Alumni,5,82,154904,2026492705,1532358399,3558851104
2014-04-25,LG4,Others(HKUST),4,98,137098,14480164099,1148957205,15629121304
2014-04-25,LG4,Non-HKUST,16,59,174507,3760059686,226655147,3986714833
2014-04-25,LG4,Total,1530,9672,14229607,435853874117,72599752143,508453626260
2014-04-25,All-Floors,Staff,287,2053,2485383,36659620415,4711721763,41371342178
2014-04-25,All-Floors,TPG,577,11861,16161290,463038180494,91249501425,554287681919
2014-04-25,All-Floors,RPG,334,2635,3699013,105256011569,10199559232,115455570801
2014-04-25,All-Floors,UG,3346,32642,37790507,737356418141,138825273575,876181691716
2014-04-25,All-Floors,Alumni,18,340,476493,24122085584,4449366486,28571452070
2014-04-25,All-Floors,Others(HKUST),23,290,441792,22168691404,1794847671,23963539075
2014-04-25,All-Floors,Non-HKUST,51,354,657855,10523384075,1297994694,11821378769
2014-04-25,All-Floors,Total,4636,50175,61712333,1399124391682,252528264846,1651652656528
2014-04-26,1,Staff,16,172,405813,1917802351,197091398,2114893749
2014-04-26,1,TPG,27,187,400195,19439058925,3379912494,22818971419
2014-04-26,1,RPG,7,25,85327,2697990769,328586691,3026577460
2014-04-26,1,UG,80,495,982392,45111236917,5068229478,50179466395
2014-04-26,1,Alumni,8,106,147809,3382945130,786579398,4169524528
2014-04-26,1,Others(HKUST),2,5,6854,72260419,9190239,81450658
2014-04-26,1,Non-HKUST,2,47,44037,311757780,31914914,343672694
2014-04-26,1,Total,142,1037,2072427,72933052291,9801504612,82734556903
2014-04-26,G,Staff,40,215,179121,5389146367,289280597,5678426964
2014-04-26,G,TPG,199,907,700462,15394949311,2414338713,17809288024
2014-04-26,G,RPG,83,377,483836,11031465024,4372819511,15404284535
2014-04-26,G,UG,319,1613,1752799,56385621550,8231637793,64617259343
2014-04-26,G,Alumni,27,59,22955,4480027187,189229277,4669256464
2014-04-26,G,Others(HKUST),6,18,80309,20371293,17116436,37487729
2014-04-26,G,Non-HKUST,9,27,53855,301861213,37628070,339489283
2014-04-26,G,Total,683,3216,3273337,93003441945,15552050397,108555492342
2014-04-26,LG1,Staff,33,164,256122,5889013081,600636168,6489649249
2014-04-26,LG1,TPG,424,6207,9162050,134886491676,46099245836,180985737512
2014-04-26,LG1,RPG,134,1083,1500266,26651289002,3786448802,30437737804
2014-04-26,LG1,UG,870,7743,11978577,136476323145,39363720983,175840044128
2014-04-26,LG1,Alumni,25,243,317715,3809734330,404473212,4214207542
2014-04-26,LG1,Others(HKUST),4,58,45335,6540782,1615094,8155876
2014-04-26,LG1,Non-HKUST,32,171,284525,1071701021,471848361,1543549382
2014-04-26,LG1,Total,1522,15669,23544590,308791093037,90727988456,399519081493
2014-04-26,LG3,Staff,29,71,73337,402137138,52095470,454232608
2014-04-26,LG3,TPG,153,582,558275,28398829258,21631844987,50030674245
2014-04-26,LG3,RPG,108,346,423969,8279380415,862286022,9141666437
2014-04-26,LG3,UG,419,1336,1420634,44665945562,6789340698,51455286260
2014-04-26,LG3,Alumni,23,135,229842,9602154465,619228055,10221382520
2014-04-26,LG3,Others(HKUST),6,19,23979,2241584187,88415989,2330000176
2014-04-26,LG3,Non-HKUST,12,93,67281,782638273,381375292,1164013565
2014-04-26,LG3,Total,750,2582,2797317,94372669298,30424586513,124797255811
2014-04-26,LG4,Staff,27,104,83531,504703919,77156866,581860785
2014-04-26,LG4,TPG,173,1252,2080811,79819660042,49121047803,128940707845
2014-04-26,LG4,RPG,80,388,818099,21260207057,8880576398,30140783455
2014-04-26,LG4,UG,370,1881,2458813,55551506194,6437034561,61988540755
2014-04-26,LG4,Alumni,30,256,363656,30856880536,2164706075,33021586611
2014-04-26,LG4,Others(HKUST),6,120,278375,6861224625,630285383,7491510008
2014-04-26,LG4,Non-HKUST,21,228,367758,9829161507,587643182,10416804689
2014-04-26,LG4,Total,707,4229,6451043,204683343880,67898450268,272581794148
2014-04-26,All-Floors,Staff,91,726,997924,14102802856,1216260499,15319063355
2014-04-26,All-Floors,TPG,557,9135,12901793,277938989212,122646389833,400585379045
2014-04-26,All-Floors,RPG,263,2219,3311497,69920332267,18230717424,88151049691
2014-04-26,All-Floors,UG,1323,13068,18593215,338190633368,65889963513,404080596881
2014-04-26,All-Floors,Alumni,60,799,1081977,52131741648,4164216017,56295957665
2014-04-26,All-Floors,Others(HKUST),16,220,434852,9201981306,746623141,9948604447
2014-04-26,All-Floors,Non-HKUST,46,566,817456,12297119794,1510409819,13807529613
2014-04-26,All-Floors,Total,2356,26733,38138714,773783600451,214404580246,988188180697
2014-04-27,1,Staff,16,158,396879,3619583270,398026360,4017609630
2014-04-27,1,TPG,50,456,858888,33378447815,5246054843,38624502658
2014-04-27,1,RPG,8,28,119387,2250344505,223220445,2473564950
2014-04-27,1,UG,104,871,1598526,41223052109,6796687505,48019739614
2014-04-27,1,Alumni,8,65,190854,2597528208,538124907,3135653115
2014-04-27,1,Others(HKUST),1,11,21606,338612646,46877562,385490208
2014-04-27,1,Non-HKUST,3,54,65679,1310058912,112879907,1422938819
2014-04-27,1,Total,190,1643,3251819,84717627465,13361871529,98079498994
2014-04-27,G,Staff,38,226,215887,4492483314,1691249936,6183733250
2014-04-27,G,TPG,218,1513,1345268,49402499333,17374076813,66776576146
2014-04-27,G,RPG,93,336,356669,6045683693,1911954963,7957638656
2014-04-27,G,UG,391,2151,2218748,36270053014,7684625188,43954678202
2014-04-27,G,Alumni,21,39,13593,237278636,20673384,257952020
2014-04-27,G,Others(HKUST),3,9,68443,40444818,14443830,54888648
2014-04-27,G,Non-HKUST,17,33,49320,490994211,24568016,515562227
2014-04-27,G,Total,781,4307,4267928,96979437019,28721592130,125701029149
2014-04-27,LG1,Staff,40,196,211575,2955707955,194855049,3150563004
2014-04-27,LG1,TPG,423,7183,9898946,235244787011,182118333359,417363120370
2014-04-27,LG1,RPG,155,1995,2521992,94438213535,20491996440,114930209975
2014-04-27,LG1,UG,960,10041,13827233,183003133538,47000422516,230003556054
2014-04-27,LG1,Alumni,36,303,287612,7495977624,917616594,8413594218
2014-04-27,LG1,Others(HKUST),6,132,37900,126839230,10991567,137830797
2014-04-27,LG1,Non-HKUST,29,180,245796,3996551031,977522130,4974073161
2014-04-27,LG1,Total,1649,20030,27031054,527261209924,251711737655,778972947579
2014-04-27,LG3,Staff,28,81,117798,1943467835,2304095122,4247562957
2014-04-27,LG3,TPG,191,759,967644,18703555533,8359462853,27063018386
2014-04-27,LG3,RPG,107,421,449386,13180400816,1856698606,15037099422
2014-04-27,LG3,UG,472,2169,2279240,39016953186,7886018725,46902971911
2014-04-27,LG3,Alumni,29,166,204988,2609816364,338108162,2947924526
2014-04-27,LG3,Others(HKUST),2,9,20508,967248544,69338902,1036587446
2014-04-27,LG3,Non-HKUST,15,124,104892,618791690,251307230,870098920
2014-04-27,LG3,Total,844,3729,4144456,77040233968,21065029600,98105263568
2014-04-27,LG4,Staff,35,147,127922,1620345823,256112360,1876458183
2014-04-27,LG4,TPG,211,2098,3406406,101958887521,12134030002,114092917523
2014-04-27,LG4,RPG,85,556,973784,23199822593,5394694834,28594517427
2014-04-27,LG4,UG,457,2718,4092782,91391092701,19381636209,110772728910
2014-04-27,LG4,Alumni,28,301,431447,19525109367,4089469552,23614578919
2014-04-27,LG4,Others(HKUST),5,82,250882,11739446646,1009098068,12748544714
2014-04-27,LG4,Non-HKUST,26,218,400041,3799339885,601394030,4400733915
2014-04-27,LG4,Total,847,6120,9683264,253234044536,42866435055,296100479591
2014-04-27,All-Floors,Staff,97,808,1070061,14631588197,4844338827,19475927024
2014-04-27,All-Floors,TPG,527,12009,16477152,438688177213,225231957870,663920135083
2014-04-27,All-Floors,RPG,267,3336,4421218,139114465142,29878565288,168993030430
2014-04-27,All-Floors,UG,1370,17950,24016529,390904284548,88749390143,479653674691
2014-04-27,All-Floors,Alumni,62,874,1128494,32465710199,5903992599,38369702798
2014-04-27,All-Floors,Others(HKUST),11,243,399339,13212591884,1150749929,14363341813
2014-04-27,All-Floors,Non-HKUST,56,609,865728,10215735729,1967671313,12183407042
2014-04-27,All-Floors,Total,2390,35829,48378521,1039232552912,357726665969,1396959218881
2014-04-28,1,Staff,58,649,1048418,4339666613,1054514611,5394181224
2014-04-28,1,TPG,56,757,1068913,89521847277,19807824807,109329672084
2014-04-28,1,RPG,12,94,205944,13746164739,54359107194,68105271933
2014-04-28,1,UG,508,3907,5120171,204119810671,35457208891,239577019562
2014-04-28,1,Alumni,6,47,90001,9009868566,3274631450,12284500016
2014-04-28,1,Others(HKUST),3,70,30979,7484106373,379939144,7864045517
2014-04-28,1,Non-HKUST,5,18,24716,218687803,28106183,246793986
2014-04-28,1,Total,648,5542,7589142,328440152042,114361332280,442801484322
2014-04-28,G,Staff,114,687,653007,3003569551,819547077,3823116628
2014-04-28,G,TPG,312,2305,1819170,37996456716,13723606376,51720063092
2014-04-28,G,RPG,140,690,555039,16412934694,5481417226,21894351920
2014-04-28,G,UG,1573,8158,5465388,137997641957,24898813711,162896455668
2014-04-28,G,Alumni,9,14,1940,73510186,109667984,183178170
2014-04-28,G,Others(HKUST),17,94,174901,1890748662,138918190,2029666852
2014-04-28,G,Non-HKUST,21,74,33669,799003362,126705098,925708460
2014-04-28,G,Total,2186,12022,8703114,198173865128,45298675662,243472540790
2014-04-28,LG1,Staff,112,612,558240,5621369362,437757736,6059127098
2014-04-28,LG1,TPG,433,5901,7114607,72538304923,22034159471,94572464394
2014-04-28,LG1,RPG,160,974,1343859,21362467953,3976230983,25338698936
2014-04-28,LG1,UG,2319,20076,20869598,212589603611,45729671689,258319275300
2014-04-28,LG1,Alumni,14,130,223017,2054305504,2155454103,4209759607
2014-04-28,LG1,Others(HKUST),11,201,157398,350825560,44183928,395009488
2014-04-28,LG1,Non-HKUST,28,73,92313,611541090,75578834,687119924
2014-04-28,LG1,Total,3077,27967,30359032,315128418003,74453036744,389581454747
2014-04-28,LG3,Staff,136,300,157826,5625595524,211779003,5837374527
2014-04-28,LG3,TPG,232,1120,1499802,31984572848,22953112414,54937685262
2014-04-28,LG3,RPG,181,712,817327,13207702910,2220110059,15427812969
2014-04-28,LG3,UG,1434,5163,4948033,89762402077,12427369963,102189772040
2014-04-28,LG3,Alumni,8,29,10513,321104382,41329381,362433763
2014-04-28,LG3,Others(HKUST),8,15,9463,3073000,459691,3532691
2014-04-28,LG3,Non-HKUST,15,54,94993,1167118920,132001802,1299120722
2014-04-28,LG3,Total,2014,7393,7537957,142071569661,37986162313,180057731974
2014-04-28,LG4,Staff,98,298,310420,4159518516,649501786,4809020302
2014-04-28,LG4,TPG,300,3488,5380014,148008285866,38808434364,186816720230
2014-04-28,LG4,RPG,149,921,1541371,34782249153,5288098634,40070347787
2014-04-28,LG4,UG,1378,7028,8142170,146066534903,29683134389,175749669292
2014-04-28,LG4,Alumni,11,176,195687,1256321199,198538072,1454859271
2014-04-28,LG4,Others(HKUST),9,84,135662,10354931319,579804023,10934735342
2014-04-28,LG4,Non-HKUST,26,162,355614,6783151466,679024324,7462175790
2014-04-28,LG4,Total,1971,12157,16060938,351410992422,75886535592,427297528014
2014-04-28,All-Floors,Staff,322,2546,2727911,22749719566,3173100213,25922819779
2014-04-28,All-Floors,TPG,626,13571,16882506,380049467630,117327137432,497376605062
2014-04-28,All-Floors,RPG,389,3391,4463540,99511519449,71324964096,170836483545
2014-04-28,All-Floors,UG,3928,44332,44545360,790535993219,148196198643,938732191862
2014-04-28,All-Floors,Alumni,23,396,521158,12715109837,5779620990,18494730827
2014-04-28,All-Floors,Others(HKUST),31,464,508403,20083684914,1143304976,21226989890
2014-04-28,All-Floors,Non-HKUST,64,381,601305,9579502641,1041416241,10620918882
2014-04-28,All-Floors,Total,5383,65081,70250183,1335224997256,347985742591,1683210739847
2014-04-29,1,Staff,65,565,1097856,41480373007,2179900525,43660273532
2014-04-29,1,TPG,62,731,1153460,38846965167,7321515377,46168480544
2014-04-29,1,RPG,9,97,188803,2890982297,708181270,3599163567
2014-04-29,1,UG,535,3435,5094820,88899385725,16880470698,105779856423
2014-04-29,1,Alumni,3,14,15719,96322483,8743543,105066026
2014-04-29,1,Others(HKUST),2,17,11120,32635358,30636470,63271828
2014-04-29,1,Non-HKUST,11,59,109849,3403063454,285144619,3688208073
2014-04-29,1,Total,687,4918,7671627,175649727491,27414592502,203064319993
2014-04-29,G,Staff,128,735,581751,4574804951,383824317,4958629268
2014-04-29,G,TPG,316,1992,1546280,47659965563,7546684212,55206649775
2014-04-29,G,RPG,139,583,509719,8372122830,2333548357,10705671187
2014-04-29,G,UG,1542,7671,5202100,136738898552,20075396459,156814295011
2014-04-29,G,Alumni,9,65,44170,716560420,80900912,797461332
2014-04-29,G,Others(HKUST),10,37,125419,200716962,33410933,234127895
2014-04-29,G,Non-HKUST,16,68,30833,1115975233,87447343,1203422576
2014-04-29,G,Total,2160,11151,8040272,199379044511,30541212533,229920257044
2014-04-29,LG1,Staff,111,569,496142,4974061493,309957980,5284019473
2014-04-29,LG1,TPG,425,5197,6346612,105552486841,26134634223,131687121064
2014-04-29,LG1,RPG,192,1313,1625129,31115435717,4404185825,35519621542
2014-04-29,LG1,UG,2276,18212,20477184,279124006992,69155958062,348279965054
2014-04-29,LG1,Alumni,12,73,80631,764694938,141094939,905789877
2014-04-29,LG1,Others(HKUST),12,189,140442,975161735,138795678,1113957413
2014-04-29,LG1,Non-HKUST,34,97,144983,5814481489,1257852454,7072333943
2014-04-29,LG1,Total,3062,25650,29311123,428320329205,101542479161,529862808366
2014-04-29,LG3,Staff,119,275,189589,5715077219,353557188,6068634407
2014-04-29,LG3,TPG,237,1137,1482736,26977305811,47323717562,74301023373
2014-04-29,LG3,RPG,183,694,1014971,11548422584,3710816171,15259238755
2014-04-29,LG3,UG,1522,4734,4308158,93972039058,14013696108,107985735166
2014-04-29,LG3,Alumni,7,57,26260,157262612,26995690,184258302
2014-04-29,LG3,Others(HKUST),13,16,7066,90315,78165,168480
2014-04-29,LG3,Non-HKUST,18,65,79808,813524075,110247047,923771122
2014-04-29,LG3,Total,2099,6978,7108588,139183721674,65539107931,204722829605
2014-04-29,LG4,Staff,96,318,319201,2396985307,213959838,2610945145
2014-04-29,LG4,TPG,294,3119,5476726,124092172171,20958224123,145050396294
2014-04-29,LG4,RPG,160,780,1020371,12090997088,3461219580,15552216668
2014-04-29,LG4,UG,1377,6640,7674321,228075599546,51577784867,279653384413
2014-04-29,LG4,Alumni,11,119,205466,1257386959,86263775,1343650734
2014-04-29,LG4,Others(HKUST),6,86,115847,4427279570,228105136,4655384706
2014-04-29,LG4,Non-HKUST,24,192,344352,9519780347,3498412023,13018192370
2014-04-29,LG4,Total,1968,11254,15156284,381860200988,80023969342,461884170330
2014-04-29,All-Floors,Staff,326,2462,2684539,59141301977,3441199848,62582501825
2014-04-29,All-Floors,TPG,612,12176,16005814,343128895553,109284775497,452413671050
2014-04-29,All-Floors,RPG,414,3467,4358993,66017960516,14617951203,80635911719
2014-04-29,All-Floors,UG,4007,40692,42756583,826809929873,171703306194,998513236067
2014-04-29,All-Floors,Alumni,21,328,372246,2992227412,343998859,3336226271
2014-04-29,All-Floors,Others(HKUST),32,345,399894,5635883940,431026382,6066910322
2014-04-29,All-Floors,Non-HKUST,68,481,709825,20666824598,5239103486,25905928084
2014-04-29,All-Floors,Total,5480,59951,67287894,1324393023869,305061361469,1629454385338
2014-04-30,1,Staff,61,639,1078444,7580763718,616024642,8196788360
2014-04-30,1,TPG,61,767,1193924,31907598153,11134375923,43041974076
2014-04-30,1,RPG,15,56,86158,391779996,72246669,464026665
2014-04-30,1,UG,411,2527,3792175,105772335233,25545643318,131317978551
2014-04-30,1,Alumni,2,4,1175,46107258,5632139,51739397
2014-04-30,1,Others(HKUST),3,12,19805,644664859,31385348,676050207
2014-04-30,1,Non-HKUST,7,13,14144,619128704,59576259,678704963
2014-04-30,1,Total,560,4018,6185825,146962377921,37464884298,184427262219
2014-04-30,G,Staff,113,599,570501,2847931529,693447828,3541379357
2014-04-30,G,TPG,311,1765,1518090,26123010838,8582190401,34705201239
2014-04-30,G,RPG,126,624,636677,5597640968,2686611428,8284252396
2014-04-30,G,UG,1368,6489,4559795,94633076133,12446712085,107079788218
2014-04-30,G,Alumni,6,12,25050,216079,198209,414288
2014-04-30,G,Others(HKUST),7,30,145470,397501083,216849121,614350204
2014-04-30,G,Non-HKUST,28,111,64419,504250670,631304420,1135555090
2014-04-30,G,Total,1959,9630,7520002,130103627300,25257313492,155360940792
2014-04-30,LG1,Staff,111,545,419283,6924169901,740690254,7664860155
2014-04-30,LG1,TPG,437,5555,7428411,100979446002,41262558843,142242004845
2014-04-30,LG1,RPG,146,1102,1292569,21383293024,3607497450,24990790474
2014-04-30,LG1,UG,2032,15727,18419275,213390196028,53975180249,267365376277
2014-04-30,LG1,Alumni,12,51,94529,109066361,30470011,139536372
2014-04-30,LG1,Others(HKUST),8,128,164908,390764991,87451276,478216267
2014-04-30,LG1,Non-HKUST,32,86,137754,1690622504,190688194,1881310698
2014-04-30,LG1,Total,2778,23194,27956729,344867558811,99894536277,444762095088
2014-04-30,LG3,Staff,134,291,196263,3744155242,234852370,3979007612
2014-04-30,LG3,TPG,252,1240,1635045,58274749219,48251893733,106526642952
2014-04-30,LG3,RPG,140,483,569620,10729163637,2061857351,12791020988
2014-04-30,LG3,UG,1379,4294,3564641,73503879948,16907532030,90411411978
2014-04-30,LG3,Alumni,9,39,14201,79584736,9996280,89581016
2014-04-30,LG3,Others(HKUST),9,59,54020,243880456,152768424,396648880
2014-04-30,LG3,Non-HKUST,14,118,196963,1282925065,153154799,1436079864
2014-04-30,LG3,Total,1937,6524,6230753,147858338303,67772054987,215630393290
2014-04-30,LG4,Staff,99,389,401379,11342439192,1412670082,12755109274
2014-04-30,LG4,TPG,292,3455,5744116,165291886325,33991357080,199283243405
2014-04-30,LG4,RPG,136,677,997846,23097836085,2898729727,25996565812
2014-04-30,LG4,UG,1321,5461,5795099,127910472853,17799715079,145710187932
2014-04-30,LG4,Alumni,9,174,210332,3073640882,1340163736,4413804618
2014-04-30,LG4,Others(HKUST),8,86,159806,10089702241,375899981,10465602222
2014-04-30,LG4,Non-HKUST,23,151,206226,1889037825,1120029965,3009067790
2014-04-30,LG4,Total,1888,10393,13514804,342695015403,58938565650,401633581053
2014-04-30,All-Floors,Staff,322,2463,2665870,32439459582,3697685176,36137144758
2014-04-30,All-Floors,TPG,612,12782,17519586,382576690537,143222375980,525799066517
2014-04-30,All-Floors,RPG,357,2942,3582870,61199713710,11326942625,72526656335
2014-04-30,All-Floors,UG,3763,34498,36130985,615209960195,126674782761,741884742956
2014-04-30,All-Floors,Alumni,20,280,345287,3308615316,1386460375,4695075691
2014-04-30,All-Floors,Others(HKUST),23,315,544009,11766513630,864354150,12630867780
2014-04-30,All-Floors,Non-HKUST,64,479,619506,5985964768,2154753637,8140718405
2014-04-30,All-Floors,Total,5161,53759,61408113,1112486917738,289327354704,1401814272442