Date,Floor,User-Group,User-Count,WiFi-Conn,Duration-Sec,Traffic-In-Byte,Traffic-Out-Byte,Traffic-Both-Byte
2014-09-01,1,Staff,70,764,951541,7654824488,672825349,8327649837
2014-09-01,1,TPG,112,436,454862,19242433514,1661963030,20904396544
2014-09-01,1,RPG,46,243,435777,7695448066,674318322,8369766388
2014-09-01,1,UG,436,1821,1836567,87221964034,9945866258,97167830292
2014-09-01,1,Alumni,4,68,62334,690502511,98610399,789112910
2014-09-01,1,Others(HKUST),2,108,302969,877696402,47118710,924815112
2014-09-01,1,Non-HKUST,13,55,91519,3893321140,502778699,4396099839
2014-09-01,1,Total,683,3495,4135569,127276190155,13603480767,140879670922
2014-09-01,G,Staff,152,859,560059,1054813352,333385330,1388198682
2014-09-01,G,TPG,497,2943,1808826,23953361039,4937752642,28891113681
2014-09-01,G,RPG,246,1070,684975,1696480810,295302730,1991783540
2014-09-01,G,UG,2018,8843,4006628,31044281119,3296339715,34340620834
2014-09-01,G,Alumni,8,53,21564,74327109,9002336,83329445
2014-09-01,G,Others(HKUST),22,248,199055,508766807,80641522,589408329
2014-09-01,G,Non-HKUST,50,279,248753,762078369,94545459,856623828
2014-09-01,G,Total,2993,14295,7529860,59094108605,9046969734,68141078339
2014-09-01,LG1,Staff,292,886,526490,415062668,71495027,486557695
2014-09-01,LG1,TPG,694,5119,3812377,9947023863,5489308901,15436332764
2014-09-01,LG1,RPG,413,2520,2374934,13088780967,19376656989,32465437956
2014-09-01,LG1,UG,3567,16775,10337973,40679827909,3391433786,44071261695
2014-09-01,LG1,Alumni,19,136,160271,1346295194,359950727,1706245921
2014-09-01,LG1,Others(HKUST),41,423,520502,71896549,20936154,92832703
2014-09-01,LG1,Non-HKUST,75,343,226720,56942096,11490577,68432673
2014-09-01,LG1,Total,5101,26202,17959267,65605829246,28721272161,94327101407
2014-09-01,LG3,Staff,235,484,221901,6573045902,1155717610,7728763512
2014-09-01,LG3,TPG,494,2300,1851321,52761415818,6433253456,59194669274
2014-09-01,LG3,RPG,417,1334,1142178,30337991928,10356673161,40694665089
2014-09-01,LG3,UG,2861,6941,2910233,109268427667,8528655382,117797083049
2014-09-01,LG3,Alumni,9,42,60018,1432903085,395869332,1828772417
2014-09-01,LG3,Others(HKUST),22,89,23279,93890810,102543910,196434720
2014-09-01,LG3,Non-HKUST,59,150,155340,3916650875,806452064,4723102939
2014-09-01,LG3,Total,4097,11340,6364270,204384326085,27779164915,232163491000
2014-09-01,LG4,Staff,169,476,497339,12305627361,1423766517,13729393878
2014-09-01,LG4,TPG,378,1916,1724596,65790555386,23033252536,88823807922
2014-09-01,LG4,RPG,329,1170,1247570,30524698941,32883413087,63408112028
2014-09-01,LG4,UG,2497,6277,3743995,97827470108,14531467888,112358937996
2014-09-01,LG4,Alumni,14,104,213531,3399673335,461412067,3861085402
2014-09-01,LG4,Others(HKUST),20,228,261281,62654402475,19792984243,82447386718
2014-09-01,LG4,Non-HKUST,41,138,134688,24306343828,4266471988,28572815816
2014-09-01,LG4,Total,3448,10309,7823000,296808771434,96392768326,393201539760
2014-09-01,All-Floors,Staff,564,3469,2757330,28003373771,3657189833,31660563604
2014-09-01,All-Floors,TPG,897,12714,9651982,171694789620,41555530565,213250320185
2014-09-01,All-Floors,RPG,818,6337,5885434,83343400712,63586364289,146929765001
2014-09-01,All-Floors,UG,5561,40657,22835396,366041970837,39693763029,405735733866
2014-09-01,All-Floors,Alumni,27,403,517718,6943701234,1324844861,8268546095
2014-09-01,All-Floors,Others(HKUST),60,1096,1307086,64206653043,20044224539,84250877582
2014-09-01,All-Floors,Non-HKUST,138,965,857020,32935336308,5681738787,38617075095
2014-09-01,All-Floors,Total,8065,65641,43811966,753169225525,175543655903,928712881428
2014-09-02,1,Staff,70,776,947959,8310344928,803029220,9113374148
2014-09-02,1,TPG,105,495,662932,15341304405,1832873597,17174178002
2014-09-02,1,RPG,52,290,461049,17742016711,1493292660,19235309371
2014-09-02,1,UG,433,1840,1920231,63818884821,6355608800,70174493621
2014-09-02,1,Alumni,4,38,52672,739123301,71252980,810376281
2014-09-02,1,Others(HKUST),7,83,209072,1215534487,101467293,1317001780
2014-09-02,1,Non-HKUST,16,59,85512,5365383208,238618985,5604002193
2014-09-02,1,Total,687,3581,4339427,112532591861,10896143535,123428735396
2014-09-02,G,Staff,159,819,553797,836909468,323918532,1160828000
2014-09-02,G,TPG,470,2525,1542603,8813223342,2209924155,11023147497
2014-09-02,G,RPG,251,1150,873215,81956884848,5552123295,87509008143
2014-09-02,G,UG,1965,8404,4301814,29879779414,3159459193,33039238607
2014-09-02,G,Alumni,15,49,53160,338795237,23449326,362244563
2014-09-02,G,Others(HKUST),22,186,212388,4041707677,658529929,4700237606
2014-09-02,G,Non-HKUST,45,232,194733,314069172,60007369,374076541
2014-09-02,G,Total,2927,13365,7731710,126181369158,11987411799,138168780957
2014-09-02,LG1,Staff,299,1038,632632,2961806703,853107506,3814914209
2014-09-02,LG1,TPG,665,4655,3776458,12050811767,3448885798,15499697565
2014-09-02,LG1,RPG,380,2118,2276461,7579743587,889716568,8469460155
2014-09-02,LG1,UG,3497,15311,10036280,19552735500,5297004632,24849740132
2014-09-02,LG1,Alumni,15,150,226203,464629826,62241554,526871380
2014-09-02,LG1,Others(HKUST),39,230,541729,22057168,10809273,32866441
2014-09-02,LG1,Non-HKUST,66,227,199868,317247400,9640373,326887773
2014-09-02,LG1,Total,4961,23729,17689631,42949031951,10571405704,53520437655
2014-09-02,LG3,Staff,232,453,135718,2639212349,616326026,3255538375
2014-09-02,LG3,TPG,481,2442,2446973,55312485578,18159456451,73471942029
2014-09-02,LG3,RPG,349,1127,1077363,58456209777,5014955661,63471165438
2014-09-02,LG3,UG,2506,5400,2528325,86082878027,8247393727,94330271754
2014-09-02,LG3,Alumni,10,19,16831,381458746,15719603,397178349
2014-09-02,LG3,Others(HKUST),17,90,20082,67119578,20929682,88049260
2014-09-02,LG3,Non-HKUST,45,104,117412,2239400352,269513936,2508914288
2014-09-02,LG3,Total,3640,9635,6342704,205178764407,32344295086,237523059493
2014-09-02,LG4,Staff,172,573,545915,11111340405,2065814014,13177154419
2014-09-02,LG4,TPG,390,2308,2430001,98482941131,18222885143,116705826274
2014-09-02,LG4,RPG,302,1185,1281312,47527740677,10922799671,58450540348
2014-09-02,LG4,UG,2266,5414,3224460,78812606514,16990261260,95802867774
2014-09-02,LG4,Alumni,15,146,266847,3055701834,204595622,3260297456
2014-09-02,LG4,Others(HKUST),16,255,249967,11858101849,4265237183,16123339032
2014-09-02,LG4,Non-HKUST,37,146,162260,3138634021,330078798,3468712819
2014-09-02,LG4,Total,3198,10027,8160762,253987066431,53001671691,306988738122
2014-09-02,All-Floors,Staff,586,3659,2816021,25859613853,4662195298,30521809151
2014-09-02,All-Floors,TPG,890,12425,10858967,190000766223,43874025144,233874791367
2014-09-02,All-Floors,RPG,744,5870,5969400,213262595600,23872887855,237135483455
2014-09-02,All-Floors,UG,5483,36369,22011110,278146884276,40049727612,318196611888
2014-09-02,All-Floors,Alumni,28,402,615713,4979708944,377259085,5356968029
2014-09-02,All-Floors,Others(HKUST),47,844,1233238,17204520759,5056973360,22261494119
2014-09-02,All-Floors,Non-HKUST,120,768,759785,11374734153,907859461,12282593614
2014-09-02,All-Floors,Total,7898,60337,44264234,740828823808,118800927815,859629751623
2014-09-03,1,Staff,73,670,942743,16673739847,755104516,17428844363
2014-09-03,1,TPG,86,445,537054,17229493548,2713011623,19942505171
2014-09-03,1,RPG,56,304,462202,13691933935,1099690642,14791624577
2014-09-03,1,UG,403,1765,2411909,83476567925,8971975857,92448543782
2014-09-03,1,Alumni,4,15,40470,417123645,38497026,455620671
2014-09-03,1,Others(HKUST),10,81,174136,224845402,43033207,267878609
2014-09-03,1,Non-HKUST,7,25,65033,365753692,80290471,446044163
2014-09-03,1,Total,639,3305,4633547,132079457994,13701603342,145781061336
2014-09-03,G,Staff,126,689,478625,1450223328,182804832,1633028160
2014-09-03,G,TPG,448,2387,1499450,8984253482,2071673814,11055927296
2014-09-03,G,RPG,247,1038,744394,5148132822,371530536,5519663358
2014-09-03,G,UG,1908,8082,4501803,40422755059,4826902646,45249657705
2014-09-03,G,Alumni,11,40,17609,252179090,11705011,263884101
2014-09-03,G,Others(HKUST),18,185,219889,877088416,55553277,932641693
2014-09-03,G,Non-HKUST,43,160,107963,788222054,123191293,911413347
2014-09-03,G,Total,2801,12581,7569733,57922854251,7643361409,65566215660
2014-09-03,LG1,Staff,267,750,577633,1323892425,225195753,1549088178
2014-09-03,LG1,TPG,615,4451,3876108,17572575005,2349711821,19922286826
2014-09-03,LG1,RPG,422,2410,2756927,13370278135,1960527490,15330805625
2014-09-03,LG1,UG,3362,15838,11886877,26422577789,5497998404,31920576193
2014-09-03,LG1,Alumni,17,101,171803,31200571,2115000,33315571
2014-09-03,LG1,Others(HKUST),38,345,651637,127963334,28720148,156683482
2014-09-03,LG1,Non-HKUST,60,172,188391,37817993,4500110,42318103
2014-09-03,LG1,Total,4781,24067,20109376,58886305252,10068768726,68955073978
2014-09-03,LG3,Staff,191,445,258029,3319539846,988411711,4307951557
2014-09-03,LG3,TPG,426,2335,2374224,63970367015,11722899816,75693266831
2014-09-03,LG3,RPG,324,1003,1023262,49932175289,7391963413,57324138702
2014-09-03,LG3,UG,2156,5018,2966203,80490372927,7533462735,88023835662
2014-09-03,LG3,Alumni,9,45,88365,1684789954,108550821,1793340775
2014-09-03,LG3,Others(HKUST),22,133,96771,599587293,61922932,661510225
2014-09-03,LG3,Non-HKUST,38,79,40415,475702192,43680819,519383011
2014-09-03,LG3,Total,3166,9058,6847269,200472534516,27850892247,228323426763
2014-09-03,LG4,Staff,154,435,465479,8573381730,1090835688,9664217418
2014-09-03,LG4,TPG,344,1975,2553138,82827341687,15266824065,98094165752
2014-09-03,LG4,RPG,260,1133,1342600,56222000048,6476968082,62698968130
2014-09-03,LG4,UG,1905,5109,4023762,93377203066,10776621516,104153824582
2014-09-03,LG4,Alumni,11,140,224039,2282909180,1046656961,3329566141
2014-09-03,LG4,Others(HKUST),21,231,366064,22030731543,17203557577,39234289120
2014-09-03,LG4,Non-HKUST,25,148,230254,2763840720,469569404,3233410124
2014-09-03,LG4,Total,2720,9171,9205336,268077407974,52331033293,320408441267
2014-09-03,All-Floors,Staff,534,2989,2722509,31340777176,3242352500,34583129676
2014-09-03,All-Floors,TPG,846,11593,10839974,190584030737,34124121139,224708151876
2014-09-03,All-Floors,RPG,770,5888,6329385,138364520229,17300680163,155665200392
2014-09-03,All-Floors,UG,5178,35812,25790554,324189476766,37606961158,361796437924
2014-09-03,All-Floors,Alumni,25,341,542286,4668202440,1207524819,5875727259
2014-09-03,All-Floors,Others(HKUST),51,975,1508497,23860215988,17392787141,41253003129
2014-09-03,All-Floors,Non-HKUST,112,584,632056,4431336651,721232097,5152568748
2014-09-03,All-Floors,Total,7516,58182,48365261,717438559987,111595659017,829034219004
2014-09-04,1,Staff,74,690,943471,1192094697,302563915,1494658612
2014-09-04,1,TPG,105,671,941559,37294710796,5588026817,42882737613
2014-09-04,1,RPG,50,195,279033,3300808009,358036366,3658844375
2014-09-04,1,UG,418,1876,2415331,86514671613,11712342214,98227013827
2014-09-04,1,Alumni,0,0,0,0,0,0
2014-09-04,1,Others(HKUST),4,83,179303,380088043,50142575,430230618
2014-09-04,1,Non-HKUST,10,22,52909,823018719,69723350,892742069
2014-09-04,1,Total,661,3537,4811606,129505391877,18080835237,147586227114
2014-09-04,G,Staff,129,771,591895,2092761632,464545837,2557307469
2014-09-04,G,TPG,485,2725,1627084,18001817428,1902523428,19904340856
2014-09-04,G,RPG,252,1117,874189,20043686019,2018035622,22061721641
2014-09-04,G,UG,1841,8126,4077436,27711792301,2696016253,30407808554
2014-09-04,G,Alumni,10,28,7151,757456,338253,1095709
2014-09-04,G,Others(HKUST),18,102,117239,149629009,22198143,171827152
2014-09-04,G,Non-HKUST,38,124,70170,184740874,56422022,241162896
2014-09-04,G,Total,2773,12993,7365164,68185184719,7160079558,75345264277
2014-09-04,LG1,Staff,256,811,519523,816546971,97412979,913959950
2014-09-04,LG1,TPG,715,4372,3409428,17895741297,1854210017,19749951314
2014-09-04,LG1,RPG,427,2530,2521937,5370628484,928535940,6299164424
2014-09-04,LG1,UG,3486,16442,11751352,37153637662,9635034270,46788671932
2014-09-04,LG1,Alumni,14,96,143103,206256225,15919759,222175984
2014-09-04,LG1,Others(HKUST),35,265,501133,19153215,6523409,25676624
2014-09-04,LG1,Non-HKUST,53,170,160518,1554868549,345959908,1900828457
2014-09-04,LG1,Total,4986,24686,19006994,63016832403,12883596282,75900428685
2014-09-04,LG3,Staff,201,478,282099,3890002011,301365405,4191367416
2014-09-04,LG3,TPG,464,2293,2371354,88836976111,10554158754,99391134865
2014-09-04,LG3,RPG,309,1027,958350,22358980459,3004008510,25362988969
2014-09-04,LG3,UG,2062,4983,3056882,87045242709,7232125160,94277367869
2014-09-04,LG3,Alumni,10,46,59655,913297794,66173203,979470997
2014-09-04,LG3,Others(HKUST),20,134,88818,1223438097,206831839,1430269936
2014-09-04,LG3,Non-HKUST,39,108,74770,555559707,85657851,641217558
2014-09-04,LG3,Total,3105,9069,6891928,204823496888,21450320722,226273817610
2014-09-04,LG4,Staff,151,495,475972,17860495241,1501186279,19361681520
2014-09-04,LG4,TPG,371,2337,3042290,73323820624,16190770753,89514591377
2014-09-04,LG4,RPG,291,1361,1622371,40791611926,5458847038,46250458964
2014-09-04,LG4,UG,1722,4973,4088779,101155821956,12957507292,114113329248
2014-09-04,LG4,Alumni,12,103,178680,5441719655,932346524,6374066179
2014-09-04,LG4,Others(HKUST),22,215,359117,42601618096,18408605022,61010223118
2014-09-04,LG4,Non-HKUST,37,173,160299,3929947852,274271216,4204219068
2014-09-04,LG4,Total,2606,9657,9927508,285105035350,55723534124,340828569474
2014-09-04,All-Floors,Staff,520,3245,2812960,25851900552,2667074415,28518974967
2014-09-04,All-Floors,TPG,941,12398,11391715,235353066256,36089689769,271442756025
2014-09-04,All-Floors,RPG,729,6230,6255880,91865714897,11767463476,103633178373
2014-09-04,All-Floors,UG,5110,36400,25389780,339581166241,44233025189,383814191430
2014-09-04,All-Floors,Alumni,26,273,388589,6562031130,1014777739,7576808869
2014-09-04,All-Floors,Others(HKUST),51,799,1245610,44373926460,18694300988,63068227448
2014-09-04,All-Floors,Non-HKUST,105,597,518666,7048135701,832034347,7880170048
2014-09-04,All-Floors,Total,7482,59942,48003200,750635941237,115298365923,865934307160
2014-09-05,1,Staff,81,713,912535,4050693223,604818875,4655512098
2014-09-05,1,TPG,106,756,1403253,52303779587,7530668040,59834447627
2014-09-05,1,RPG,35,174,264295,4419068697,659144909,5078213606
2014-09-05,1,UG,361,1552,2240329,68248155063,7500093195,75748248258
2014-09-05,1,Alumni,6,15,27925,133068647,23814052,156882699
2014-09-05,1,Others(HKUST),6,64,100550,69874280,107319789,177194069
2014-09-05,1,Non-HKUST,6,14,36006,3601265985,168574460,3769840445
2014-09-05,1,Total,601,3288,4984893,132825905482,16594433320,149420338802
2014-09-05,G,Staff,141,746,533109,1902632561,405610143,2308242704
2014-09-05,G,TPG,429,2389,1592021,17194778719,1860728416,19055507135
2014-09-05,G,RPG,186,814,625743,3825444224,2462478384,6287922608
2014-09-05,G,UG,1795,7198,3695293,25287584536,2571711623,27859296159
2014-09-05,G,Alumni,11,44,18320,91377171,29919710,121296881
2014-09-05,G,Others(HKUST),16,129,201445,617677757,393688560,1011366317
2014-09-05,G,Non-HKUST,33,76,64859,164874255,12371397,177245652
2014-09-05,G,Total,2611,11396,6730790,49084369223,7736508233,56820877456
2014-09-05,LG1,Staff,248,970,746971,1082920301,72756993,1155677294
2014-09-05,LG1,TPG,568,4555,4125650,18194772724,2717655866,20912428590
2014-09-05,LG1,RPG,359,1727,2191501,2880538904,1008879034,3889417938
2014-09-05,LG1,UG,3262,14730,11206236,30857956024,4441112050,35299068074
2014-09-05,LG1,Alumni,17,97,151506,6680,1842,8522
2014-09-05,LG1,Others(HKUST),31,285,556294,203287904,30676845,233964749
2014-09-05,LG1,Non-HKUST,59,192,174599,1736568561,368941766,2105510327
2014-09-05,LG1,Total,4544,22556,19152757,54956051098,8640024396,63596075494
2014-09-05,LG3,Staff,185,353,251867,2736024836,240644828,2976669664
2014-09-05,LG3,TPG,378,2017,2543776,94990149020,12836270042,107826419062
2014-09-05,LG3,RPG,232,833,787595,16535185410,8539122864,25074308274
2014-09-05,LG3,UG,1820,4038,2621545,47123417491,7441024580,54564442071
2014-09-05,LG3,Alumni,8,15,32172,1435766925,137001560,1572768485
2014-09-05,LG3,Others(HKUST),17,69,140001,2542722735,169605474,2712328209
2014-09-05,LG3,Non-HKUST,25,43,40262,111280374,18641674,129922048
2014-09-05,LG3,Total,2665,7368,6417218,165474546791,29382311022,194856857813
2014-09-05,LG4,Staff,111,373,356912,8355402424,528032678,8883435102
2014-09-05,LG4,TPG,307,2170,3205735,87187208531,17728673041,104915881572
2014-09-05,LG4,RPG,201,876,1067534,58593995461,5059428934,63653424395
2014-09-05,LG4,UG,1377,3901,3704068,89243772417,8789799990,98033572407
2014-09-05,LG4,Alumni,13,111,219518,6963819173,534585859,7498405032
2014-09-05,LG4,Others(HKUST),17,162,224181,5270315219,2642437333,7912752552
2014-09-05,LG4,Non-HKUST,28,155,170479,44805867668,1519534198,46325401866
2014-09-05,LG4,Total,2054,7748,8948427,300420380893,36802492033,337222872926
2014-09-05,All-Floors,Staff,485,3155,2801394,18127673345,1851863517,19979536862
2014-09-05,All-Floors,TPG,783,11887,12870435,269870688581,42673995405,312544683986
2014-09-05,All-Floors,RPG,635,4424,4936668,86254232696,17729054125,103983286821
2014-09-05,All-Floors,UG,4702,31419,23467471,260760885531,30743741438,291504626969
2014-09-05,All-Floors,Alumni,25,282,449441,8624038596,725323023,9349361619
2014-09-05,All-Floors,Others(HKUST),44,709,1222471,8703877895,3343728001,12047605896
2014-09-05,All-Floors,Non-HKUST,101,480,486205,50419856843,2088063495,52507920338
2014-09-05,All-Floors,Total,6775,52356,46234085,702761253487,99155769004,801917022491
2014-09-06,1,Staff,13,114,41888,663017979,190373124,853391103
2014-09-06,1,TPG,64,452,611263,16450071639,5037922614,21487994253
2014-09-06,1,RPG,32,135,272234,44919288370,725916673,45645205043
2014-09-06,1,UG,58,398,749395,36851435401,5596787531,42448222932
2014-09-06,1,Alumni,3,9,31306,924049776,35809683,959859459
2014-09-06,1,Others(HKUST),2,84,80416,84223047,14576726,98799773
2014-09-06,1,Non-HKUST,6,14,21843,3061645721,148588908,3210234629
2014-09-06,1,Total,178,1206,1808345,102953731933,11749975259,114703707192
2014-09-06,G,Staff,37,215,241673,1167684299,1029281009,2196965308
2014-09-06,G,TPG,314,1121,1005844,10214731070,1115894005,11330625075
2014-09-06,G,RPG,136,536,580705,4917351137,520735650,5438086787
2014-09-06,G,UG,375,1088,852798,5192746004,1337828641,6530574645
2014-09-06,G,Alumni,18,36,26308,1873179,560211,2433390
2014-09-06,G,Others(HKUST),12,54,147936,114758882,41859843,156618725
2014-09-06,G,Non-HKUST,25,57,53652,77799063,14647522,92446585
2014-09-06,G,Total,917,3107,2908916,21686943634,4060806881,25747750515
2014-09-06,LG1,Staff,79,230,303643,1256306520,103613479,1359919999
2014-09-06,LG1,TPG,488,3178,3739614,10084023321,2112503321,12196526642
2014-09-06,LG1,RPG,239,1663,2324314,4849173591,1753510965,6602684556
2014-09-06,LG1,UG,825,4902,6503659,35875717137,8644266644,44519983781
2014-09-06,LG1,Alumni,27,147,289430,205941403,37698512,243639915
2014-09-06,LG1,Others(HKUST),19,251,691750,417650062,45782274,463432336
2014-09-06,LG1,Non-HKUST,35,136,177583,37907769,3117027,41024796
2014-09-06,LG1,Total,1712,10507,14029993,52726719803,12700492222,65427212025
2014-09-06,LG3,Staff,50,81,17556,77158048,13345420,90503468
2014-09-06,LG3,TPG,256,1058,1293985,55642265030,8208604845,63850869875
2014-09-06,LG3,RPG,163,491,581566,17831248193,1402590435,19233838628
2014-09-06,LG3,UG,497,1179,1026198,15980473615,2425630199,18406103814
2014-09-06,LG3,Alumni,18,76,133329,2173996397,197226393,2371222790
2014-09-06,LG3,Others(HKUST),9,47,82425,65922214,16941375,82863589
2014-09-06,LG3,Non-HKUST,20,45,53083,4194412976,154355928,4348768904
2014-09-06,LG3,Total,1013,2977,3188142,95965476473,12418694595,108384171068
2014-09-06,LG4,Staff,31,99,144656,3460288229,318190478,3778478707
2014-09-06,LG4,TPG,176,947,1299384,30164570177,2925544974,33090115151
2014-09-06,LG4,RPG,104,521,797360,32461425282,2405566427,34866991709
2014-09-06,LG4,UG,288,1040,1484398,89281551833,19534717718,108816269551
2014-09-06,LG4,Alumni,22,205,389357,6641153108,354412866,6995565974
2014-09-06,LG4,Others(HKUST),9,186,370263,23400342409,7026955411,30427297820
2014-09-06,LG4,Non-HKUST,13,99,144527,2744851618,817050247,3561901865
2014-09-06,LG4,Total,643,3097,4629945,188154182656,33382438121,221536620777
2014-09-06,All-Floors,Staff,148,739,749416,6624455075,1654803510,8279258585
2014-09-06,All-Floors,TPG,664,6756,7950090,122555661237,19400469759,141956130996
2014-09-06,All-Floors,RPG,384,3346,4556179,104978486573,6808320150,111786806723
2014-09-06,All-Floors,UG,1311,8607,10616448,183181923990,37539230733,220721154723
2014-09-06,All-Floors,Alumni,47,473,869730,9947013863,625707665,10572721528
2014-09-06,All-Floors,Others(HKUST),28,622,1372790,24082896614,7146115629,31229012243
2014-09-06,All-Floors,Non-HKUST,61,351,450688,10116617147,1137759632,11254376779
2014-09-06,All-Floors,Total,2643,20894,26565341,461487054499,74312407078,535799461577
2014-09-07,1,Staff,11,124,86255,302808694,36200866,339009560
2014-09-07,1,TPG,61,572,1039071,39022331551,13752714496,52775046047
2014-09-07,1,RPG,28,126,248107,2396962950,212444116,2609407066
2014-09-07,1,UG,65,321,494957,40715803105,1679610537,42395413642
2014-09-07,1,Alumni,3,29,71725,779055251,56557864,835613115
2014-09-07,1,Others(HKUST),4,90,108720,555523855,169249594,724773449
2014-09-07,1,Non-HKUST,3,5,8763,21723435,4780832,26504267
2014-09-07,1,Total,175,1267,2057598,83794208841,15911558305,99705767146
2014-09-07,G,Staff,33,98,108380,321651880,33396002,355047882
2014-09-07,G,TPG,206,1292,1200017,3438331865,604913653,4043245518
2014-09-07,G,RPG,113,420,349672,2309318254,466753467,2776071721
2014-09-07,G,UG,446,1930,1748351,9867157706,1491910347,11359068053
2014-09-07,G,Alumni,17,54,80867,784827395,146593066,931420461
2014-09-07,G,Others(HKUST),10,99,221410,1671312902,178161612,1849474514
2014-09-07,G,Non-HKUST,22,76,48499,41426230,54699798,96126028
2014-09-07,G,Total,847,3969,3757196,18434026232,2976427945,21410454177
2014-09-07,LG1,Staff,65,260,339034,5306843261,264952576,5571795837
2014-09-07,LG1,TPG,291,3371,3766104,5702576761,1254655853,6957232614
2014-09-07,LG1,RPG,237,1886,2372130,3683078741,472492233,4155570974
2014-09-07,LG1,UG,793,6758,8249774,34920859848,1880953461,36801813309
2014-09-07,LG1,Alumni,27,199,298441,529669844,237408647,767078491
2014-09-07,LG1,Others(HKUST),14,175,616086,217925214,31621957,249547171
2014-09-07,LG1,Non-HKUST,36,178,170049,159335067,7416484,166751551
2014-09-07,LG1,Total,1463,12827,15811618,50520288736,4149501211,54669789947
2014-09-07,LG3,Staff,46,86,46869,6037233325,257080057,6294313382
2014-09-07,LG3,TPG,189,1322,1334377,70959797148,20100500128,91060297276
2014-09-07,LG3,RPG,170,667,734834,28304464557,11729160985,40033625542
2014-09-07,LG3,UG,503,1452,1340082,31836192193,3016520250,34852712443
2014-09-07,LG3,Alumni,18,71,66030,5874195340,443501158,6317696498
2014-09-07,LG3,Others(HKUST),10,100,135639,430621482,78928453,509549935
2014-09-07,LG3,Non-HKUST,16,61,122386,2373063297,151881709,2524945006
2014-09-07,LG3,Total,952,3759,3780217,145815567342,35777572740,181593140082
2014-09-07,LG4,Staff,33,109,161772,2817233327,282035712,3099269039
2014-09-07,LG4,TPG,139,1192,1785988,72475616853,40317513040,112793129893
2014-09-07,LG4,RPG,126,586,694095,52635600082,4918959330,57554559412
2014-09-07,LG4,UG,313,1079,1133580,26668937926,3781117243,30450055169
2014-09-07,LG4,Alumni,17,226,357885,14380058527,1116377660,15496436187
2014-09-07,LG4,Others(HKUST),11,108,251723,6059494043,1707033569,7766527612
2014-09-07,LG4,Non-HKUST,14,169,274033,1940703377,191097231,2131800608
2014-09-07,LG4,Total,653,3469,4659076,176977644135,52314133785,229291777920
2014-09-07,All-Floors,Staff,115,677,742310,14785770487,873665213,15659435700
2014-09-07,All-Floors,TPG,381,7749,9125557,191598654178,76030297170,267628951348
2014-09-07,All-Floors,RPG,379,3685,4398838,89329424584,17799810131,107129234715
2014-09-07,All-Floors,UG,1253,11540,12966744,144008950778,11850111838,155859062616
2014-09-07,All-Floors,Alumni,44,579,874948,22347806357,2000438395,24348244752
2014-09-07,All-Floors,Others(HKUST),20,572,1333578,8934877496,2164995185,11099872681
2014-09-07,All-Floors,Non-HKUST,53,489,623730,4536251406,409876054,4946127460
2014-09-07,All-Floors,Total,2245,25291,30065705,475541735286,111129193986,586670929272
2014-09-08,1,Staff,58,534,672407,3258960734,506350681,3765311415
2014-09-08,1,TPG,63,383,466196,14329806193,2041941149,16371747342
2014-09-08,1,RPG,38,183,287041,5252727722,932714682,6185442404
2014-09-08,1,UG,332,1298,1507785,37348641900,4445798432,41794440332
2014-09-08,1,Alumni,2,29,33152,366541704,41190131,407731835
2014-09-08,1,Others(HKUST),7,108,106532,611770263,67455828,679226091
2014-09-08,1,Non-HKUST,8,33,39783,265553929,350030806,615584735
2014-09-08,1,Total,508,2568,3112896,61434002445,8385481709,69819484154
2014-09-08,G,Staff,108,585,428225,498153908,291291456,789445364
2014-09-08,G,TPG,284,1352,807958,5414531460,440155774,5854687234
2014-09-08,G,RPG,161,636,456810,3469393597,577497583,4046891180
2014-09-08,G,UG,1466,6004,2784634,22016199066,1353222759,23369421825
2014-09-08,G,Alumni,5,13,5984,349525503,11030095,360555598
2014-09-08,G,Others(HKUST),19,130,168071,136923856,24477344,161401200
2014-09-08,G,Non-HKUST,30,124,81775,717468808,50846637,768315445
2014-09-08,G,Total,2073,8844,4733457,32602196198,2748521648,35350717846
2014-09-08,LG1,Staff,263,824,554957,1181806465,125569499,1307375964
2014-09-08,LG1,TPG,526,4456,4291295,5097107338,1758482182,6855589520
2014-09-08,LG1,RPG,350,2167,2309111,3948682327,685144506,4633826833
2014-09-08,LG1,UG,3254,14503,9871701,34442505847,2270241021,36712746868
2014-09-08,LG1,Alumni,14,128,224881,39146789,4155225,43302014
2014-09-08,LG1,Others(HKUST),32,356,657901,16105179,8111611,24216790
2014-09-08,LG1,Non-HKUST,51,178,101957,5669748,1729162,7398910
2014-09-08,LG1,Total,4490,22612,18011803,44731023693,4853433206,49584456899
2014-09-08,LG3,Staff,155,250,64378,348663491,39884824,388548315
2014-09-08,LG3,TPG,248,1308,1262146,79154345585,6493526762,85647872347
2014-09-08,LG3,RPG,226,641,613890,13696790856,5562150348,19258941204
2014-09-08,LG3,UG,1587,3513,1861750,53036561738,3969919531,57006481269
2014-09-08,LG3,Alumni,6,24,7041,198779,179236,378015
2014-09-08,LG3,Others(HKUST),15,164,86299,726564745,84890219,811454964
2014-09-08,LG3,Non-HKUST,27,67,24238,796489096,49833728,846322824
2014-09-08,LG3,Total,2264,5967,3919742,147759614290,16200384648,163959998938
2014-09-08,LG4,Staff,109,354,348986,1926758775,619786923,2546545698
2014-09-08,LG4,TPG,181,982,1187978,38897392685,3497922319,42395315004
2014-09-08,LG4,RPG,180,634,682491,15586977785,2394928290,17981906075
2014-09-08,LG4,UG,1203,3184,2208905,65987885877,6424053599,72411939476
2014-09-08,LG4,Alumni,5,45,62690,1356868906,73606367,1430475273
2014-09-08,LG4,Others(HKUST),14,169,213527,29569351618,10199042521,39768394139
2014-09-08,LG4,Non-HKUST,24,125,144570,4630496847,264455610,4894952457
2014-09-08,LG4,Total,1716,5493,4849147,157955732493,23473795629,181429528122
2014-09-08,All-Floors,Staff,485,2547,2068953,7214343373,1582883383,8797226756
2014-09-08,All-Floors,TPG,652,8481,8015573,142893183261,14232028186,157125211447
2014-09-08,All-Floors,RPG,574,4261,4349343,41954572287,10152435409,52107007696
2014-09-08,All-Floors,UG,4588,28502,18234775,212831794428,18463235342,231295029770
2014-09-08,All-Floors,Alumni,20,239,333748,2112281681,130161054,2242442735
2014-09-08,All-Floors,Others(HKUST),41,927,1232330,31060715661,10383977523,41444693184
2014-09-08,All-Floors,Non-HKUST,87,527,392323,6415678428,716895943,7132574371
2014-09-08,All-Floors,Total,6447,45484,34627045,444482569119,55661616840,500144185959
2014-09-09,1,Staff,7,34,73247,1901924,1100870,3002794
2014-09-09,1,TPG,1,1,240,25874,24532,50406
2014-09-09,1,RPG,10,15,27482,89669445,354189310,443858755
2014-09-09,1,UG,13,14,2159,1089092,619393,1708485
2014-09-09,1,Alumni,0,0,0,0,0,0
2014-09-09,1,Others(HKUST),3,83,92512,5133626,3860288,8993914
2014-09-09,1,Non-HKUST,1,1,120,1832027,141781,1973808
2014-09-09,1,Total,35,148,195760,99651988,359936174,459588162
2014-09-09,G,Staff,6,10,1441,303198,219766,522964
2014-09-09,G,TPG,15,15,7326,5151856,1732891,6884747
2014-09-09,G,RPG,15,20,17883,169701682,27819707,197521389
2014-09-09,G,UG,52,58,10313,2965500,1307782,4273282
2014-09-09,G,Alumni,0,0,0,0,0,0
2014-09-09,G,Others(HKUST),2,3,86518,1048412,967231,2015643
2014-09-09,G,Non-HKUST,2,2,240,17345,12856,30201
2014-09-09,G,Total,92,108,123721,179187993,32060233,211248226
2014-09-09,LG1,Staff,34,239,316360,38831525,61909395,100740920
2014-09-09,LG1,TPG,288,5190,7242599,6293444225,2898749412,9192193637
2014-09-09,LG1,RPG,156,1852,2723819,961953081,723355231,1685308312
2014-09-09,LG1,UG,658,6906,8917309,15124228684,1984711548,17108940232
2014-09-09,LG1,Alumni,13,152,279923,491319519,16602719,507922238
2014-09-09,LG1,Others(HKUST),6,214,498886,7020782,6185595,13206377
2014-09-09,LG1,Non-HKUST,32,205,357784,1115548,817145,1932693
2014-09-09,LG1,Total,1187,14758,20336680,22917913364,5692331045,28610244409
2014-09-09,LG3,Staff,24,33,16444,50850933,8649305,59500238
2014-09-09,LG3,TPG,85,131,83160,1094294522,125125490,1219420012
2014-09-09,LG3,RPG,107,137,38815,32183846,14551871,46735717
2014-09-09,LG3,UG,278,365,118242,467656419,34226681,501883100
2014-09-09,LG3,Alumni,6,6,3001,1378970,804148,2183118
2014-09-09,LG3,Others(HKUST),6,145,26568,3659098,2142591,5801689
2014-09-09,LG3,Non-HKUST,7,7,2399,111752628,139098820,250851448
2014-09-09,LG3,Total,513,824,288629,1761776416,324598906,2086375322
2014-09-09,LG4,Staff,20,28,6960,89682012,13031406,102713418
2014-09-09,LG4,TPG,43,52,10306,14760300,15234856,29995156
2014-09-09,LG4,RPG,77,87,37858,27835049,5418263,33253312
2014-09-09,LG4,UG,191,249,64910,679890055,40542752,720432807
2014-09-09,LG4,Alumni,0,0,0,0,0,0
2014-09-09,LG4,Others(HKUST),4,71,148293,21455765372,6932660488,28388425860
2014-09-09,LG4,Non-HKUST,6,7,720,76174,63200,139374
2014-09-09,LG4,Total,341,494,269047,22268008962,7006950965,29274959927
2014-09-09,All-Floors,Staff,66,344,414452,181569592,84910742,266480334
2014-09-09,All-Floors,TPG,316,5389,7343631,7407676777,3040867181,10448543958
2014-09-09,All-Floors,RPG,289,2111,2845857,1281343103,1125334382,2406677485
2014-09-09,All-Floors,UG,891,7592,9112933,16275829750,2061408156,18337237906
2014-09-09,All-Floors,Alumni,15,158,282924,492698489,17406867,510105356
2014-09-09,All-Floors,Others(HKUST),13,516,852777,21472627290,6945816193,28418443483
2014-09-09,All-Floors,Non-HKUST,34,222,361263,114793722,140133802,254927524
2014-09-09,All-Floors,Total,1624,16332,21213837,47226538723,13415877323,60642416046
2014-09-10,1,Staff,71,620,977061,6454775947,617884034,7072659981
2014-09-10,1,TPG,140,937,1416423,60173667008,19529258375,79702925383
2014-09-10,1,RPG,58,377,657225,9832954985,2528030900,12360985885
2014-09-10,1,UG,434,2220,2763486,62083834375,7801741001,69885575376
2014-09-10,1,Alumni,3,25,76731,1551406390,475511406,2026917796
2014-09-10,1,Others(HKUST),6,92,111653,284426882,40631357,325058239
2014-09-10,1,Non-HKUST,11,24,60119,191940898,15683370,207624268
2014-09-10,1,Total,723,4295,6062698,140573006485,31008740443,171581746928
2014-09-10,G,Staff,129,765,558858,1755131371,297784736,2052916107
2014-09-10,G,TPG,476,2727,1762477,7566113866,1013963892,8580077758
2014-09-10,G,RPG,223,972,835834,4706763766,3889627455,8596391221
2014-09-10,G,UG,1848,8251,4867732,43543468222,4533663890,48077132112
2014-09-10,G,Alumni,7,13,3292,8204248,12179100,20383348
2014-09-10,G,Others(HKUST),18,110,150066,216205032,20893850,237098882
2014-09-10,G,Non-HKUST,32,110,81342,417979896,16635043,434614939
2014-09-10,G,Total,2733,12948,8259601,58213866401,9784747966,67998614367
2014-09-10,LG1,Staff,123,550,373085,1440436012,488684937,1929120949
2014-09-10,LG1,TPG,599,4730,3946288,12746901315,1682233419,14429134734
2014-09-10,LG1,RPG,266,1897,2202329,2156693990,1146742061,3303436051
2014-09-10,LG1,UG,2245,15343,13611230,39610014412,4174357080,43784371492
2014-09-10,LG1,Alumni,11,100,169870,421875287,108573738,530449025
2014-09-10,LG1,Others(HKUST),25,297,562842,419422185,192431517,611853702
2014-09-10,LG1,Non-HKUST,37,138,136929,884790374,13866512,898656886
2014-09-10,LG1,Total,3306,23055,21002573,57680133575,7806889264,65487022839
2014-09-10,LG3,Staff,191,400,152664,2870513308,2051883841,4922397149
2014-09-10,LG3,TPG,464,2570,2969041,87592543471,16693113509,104285656980
2014-09-10,LG3,RPG,310,1092,1010799,35440897750,2945749706,38386647456
2014-09-10,LG3,UG,2000,5074,3041411,63442215464,13412836438,76855051902
2014-09-10,LG3,Alumni,4,37,63153,2276092523,132781121,2408873644
2014-09-10,LG3,Others(HKUST),28,138,56303,211017622,100043573,311061195
2014-09-10,LG3,Non-HKUST,28,59,71005,202530230,28065634,230595864
2014-09-10,LG3,Total,3025,9370,7364376,192035810368,35364473822,227400284190
2014-09-10,LG4,Staff,148,546,442084,14915592566,1069278982,15984871548
2014-09-10,LG4,TPG,368,2694,3555485,111497264640,30307488605,141804753245
2014-09-10,LG4,RPG,230,1099,1478644,75878237381,7075237817,82953475198
2014-09-10,LG4,UG,1584,5490,5344623,166738176243,16264285863,183002462106
2014-09-10,LG4,Alumni,6,54,135255,8970957381,391685347,9362642728
2014-09-10,LG4,Others(HKUST),21,174,266911,24639204174,8923758812,33562962986
2014-09-10,LG4,Non-HKUST,22,165,162183,1855872847,411639196,2267512043
2014-09-10,LG4,Total,2379,10222,11385185,404495305232,64443374622,468938679854
2014-09-10,All-Floors,Staff,395,2881,2503752,27436449204,4525516530,31961965734
2014-09-10,All-Floors,TPG,885,13658,13649714,279576490300,69226057800,348802548100
2014-09-10,All-Floors,RPG,613,5437,6184831,128015547872,17585387939,145600935811
2014-09-10,All-Floors,UG,4325,36378,29628482,375417708716,46186884272,421604592988
2014-09-10,All-Floors,Alumni,21,229,448301,13228535829,1120730712,14349266541
2014-09-10,All-Floors,Others(HKUST),47,811,1147775,25770275895,9277759109,35048035004
2014-09-10,All-Floors,Non-HKUST,77,496,511578,3553114245,485889755,4039004000
2014-09-10,All-Floors,Total,6363,59890,54074433,852998122061,148408226117,1001406348178
2014-09-11,1,Staff,64,506,716511,3761142807,1953851800,5714994607
2014-09-11,1,TPG,109,806,1317698,38858005583,11382002639,50240008222
2014-09-11,1,RPG,48,209,355293,4045755486,430157197,4475912683
2014-09-11,1,UG,445,2144,2886112,91673554719,8650635871,100324190590
2014-09-11,1,Alumni,6,115,132068,12622319521,627249793,13249569314
2014-09-11,1,Others(HKUST),8,84,92830,73120672,20277201,93397873
2014-09-11,1,Non-HKUST,8,56,95559,5405052236,373535620,5778587856
2014-09-11,1,Total,688,3920,5596071,156438951024,23437710121,179876661145
2014-09-11,G,Staff,132,687,474770,1353414666,189609051,1543023717
2014-09-11,G,TPG,451,2373,1605576,9261177048,1197644463,10458821511
2014-09-11,G,RPG,220,866,667211,1022275113,97914412,1120189525
2014-09-11,G,UG,1844,7625,4513263,23544773905,3530835855,27075609760
2014-09-11,G,Alumni,8,23,13444,133673163,99698844,233372007
2014-09-11,G,Others(HKUST),19,119,170431,237410887,48818167,286229054
2014-09-11,G,Non-HKUST,40,122,60555,230993623,51332340,282325963
2014-09-11,G,Total,2714,11815,7505250,35783718405,5215853132,40999571537
2014-09-11,LG1,Staff,116,636,636839,238498907,25440509,263939416
2014-09-11,LG1,TPG,548,4311,4166450,10674168221,2075980630,12750148851
2014-09-11,LG1,RPG,248,2279,2538131,6592470286,1053363793,7645834079
2014-09-11,LG1,UG,2441,15740,13131808,34186034287,12505388946,46691423233
2014-09-11,LG1,Alumni,10,74,98118,7953094,5075411,13028505
2014-09-11,LG1,Others(HKUST),22,223,441371,110269972,24721677,134991649
2014-09-11,LG1,Non-HKUST,43,162,187719,546651163,39721805,586372968
2014-09-11,LG1,Total,3428,23425,21200436,52356045930,15729692771,68085738701
2014-09-11,LG3,Staff,184,375,279753,9338385891,977113022,10315498913
2014-09-11,LG3,TPG,419,2318,3112798,85213683341,21179400155,106393083496
2014-09-11,LG3,RPG,303,1028,955279,33737407036,6002650208,39740057244
2014-09-11,LG3,UG,2096,5232,3614405,107370983919,9315749402,116686733321
2014-09-11,LG3,Alumni,8,48,70884,1240534884,99445418,1339980302
2014-09-11,LG3,Others(HKUST),22,104,44308,55123211,28040513,83163724
2014-09-11,LG3,Non-HKUST,21,57,22674,369269245,100724055,469993300
2014-09-11,LG3,Total,3053,9162,8100101,237325387527,37703122773,275028510300
2014-09-11,LG4,Staff,122,328,330904,2971854620,364555425,3336410045
2014-09-11,LG4,TPG,339,2773,4197764,104043229746,14980143009,119023372755
2014-09-11,LG4,RPG,263,1399,1964462,49730965285,5279075402,55010040687
2014-09-11,LG4,UG,1582,5408,5134917,116100403247,10775076079,126875479326
2014-09-11,LG4,Alumni,13,55,131645,3623749686,286409518,3910159204
2014-09-11,LG4,Others(HKUST),16,142,254918,11404398468,3097649672,14502048140
2014-09-11,LG4,Non-HKUST,20,116,162058,6193556747,302475595,6496032342
2014-09-11,LG4,Total,2355,10221,12176668,294068157799,35085384700,329153542499
2014-09-11,All-Floors,Staff,405,2532,2438777,17663296891,3510569807,21173866698
2014-09-11,All-Floors,TPG,804,12581,14400286,248050263939,50815170896,298865434835
2014-09-11,All-Floors,RPG,591,5781,6480376,95128873206,12863161012,107992034218
2014-09-11,All-Floors,UG,4520,36149,29280505,372875750077,44777686153,417653436230
2014-09-11,All-Floors,Alumni,23,315,446159,17628230348,1117878984,18746109332
2014-09-11,All-Floors,Others(HKUST),39,672,1003858,11880323210,3219507230,15099830440
2014-09-11,All-Floors,Non-HKUST,89,513,528565,12745523014,867789415,13613312429
2014-09-11,All-Floors,Total,6471,58543,54578526,775972260685,117171763497,893144024182
2014-09-12,1,Staff,74,771,930690,9114955534,1858445005,10973400539
2014-09-12,1,TPG,112,917,1481562,43329080249,59803349107,103132429356
2014-09-12,1,RPG,42,307,474846,6197465088,864357022,7061822110
2014-09-12,1,UG,474,2426,2982712,81170198273,8639405920,89809604193
2014-09-12,1,Alumni,3,42,51128,996746756,369867214,1366613970
2014-09-12,1,Others(HKUST),5,55,87312,481536524,20197176,501733700
2014-09-12,1,Non-HKUST,9,33,64980,418029955,46901418,464931373
2014-09-12,1,Total,719,4551,6073230,141708012379,71602522862,213310535241
2014-09-12,G,Staff,132,826,613433,1416898820,172429016,1589327836
2014-09-12,G,TPG,386,2160,1463925,3480462320,678565556,4159027876
2014-09-12,G,RPG,186,842,856626,3286348302,507763171,3794111473
2014-09-12,G,UG,1672,6994,4172748,16970759028,1525925275,18496684303
2014-09-12,G,Alumni,6,21,2654,56157673,2531488,58689161
2014-09-12,G,Others(HKUST),16,117,155161,903460627,77960527,981421154
2014-09-12,G,Non-HKUST,28,81,30980,53978496,9581416,63559912
2014-09-12,G,Total,2426,11041,7295527,26168065266,2974756449,29142821715
2014-09-12,LG1,Staff,121,695,591568,3688396490,182149729,3870546219
2014-09-12,LG1,TPG,539,4683,4470498,8324017734,6688376877,15012394611
2014-09-12,LG1,RPG,268,2254,2469860,5851076942,4072348371,9923425313
2014-09-12,LG1,UG,2211,14978,13232712,33422490224,5865472567,39287962791
2014-09-12,LG1,Alumni,14,160,160307,3414541075,150708162,3565249237
2014-09-12,LG1,Others(HKUST),17,285,575464,92904891,26683062,119587953
2014-09-12,LG1,Non-HKUST,32,125,130694,976533615,43764921,1020298536
2014-09-12,LG1,Total,3202,23180,21631103,55769960971,17029503689,72799464660
2014-09-12,LG3,Staff,184,421,226303,8410814237,6995284109,15406098346
2014-09-12,LG3,TPG,411,2418,3074432,89811509069,10166911924,99978420993
2014-09-12,LG3,RPG,288,772,620597,18492259561,1344571913,19836831474
2014-09-12,LG3,UG,1955,5087,3313307,70091890592,15701864132,85793754724
2014-09-12,LG3,Alumni,12,67,84871,2003463871,440010340,2443474211
2014-09-12,LG3,Others(HKUST),19,232,165840,1740959754,232313013,1973272767
2014-09-12,LG3,Non-HKUST,34,59,44045,1871466289,106034558,1977500847
2014-09-12,LG3,Total,2903,9056,7529395,192422363373,34986989989,227409353362
2014-09-12,LG4,Staff,145,408,413239,23280708549,1406421755,24687130304
2014-09-12,LG4,TPG,359,3361,5056280,101480545831,22281922412,123762468243
2014-09-12,LG4,RPG,254,1187,1546331,74630010980,5788020204,80418031184
2014-09-12,LG4,UG,1606,5150,4946785,120283439183,14506725426,134790164609
2014-09-12,LG4,Alumni,11,80,109182,4606831489,372154233,4978985722
2014-09-12,LG4,Others(HKUST),15,248,364073,56571720769,15852197806,72423918575
2014-09-12,LG4,Non-HKUST,24,134,144862,2243989945,225848509,2469838454
2014-09-12,LG4,Total,2414,10568,12580752,383097246746,60433290345,443530537091
2014-09-12,All-Floors,Staff,408,3121,2775233,45911773630,10614729614,56526503244
2014-09-12,All-Floors,TPG,736,13539,15546697,246425615203,99619125876,346044741079
2014-09-12,All-Floors,RPG,582,5362,5968260,108457160873,12577060681,121034221554
2014-09-12,All-Floors,UG,4225,34635,28648264,321938777300,46239393320,368178170620
2014-09-12,All-Floors,Alumni,21,370,408142,11077740864,1335271437,12413012301
2014-09-12,All-Floors,Others(HKUST),34,937,1347850,59790582565,16209351584,75999934149
2014-09-12,All-Floors,Non-HKUST,84,432,415561,5563998300,432130822,5996129122
2014-09-12,All-Floors,Total,6090,58396,55110007,799165648735,187027063334,986192712069
2014-09-13,1,Staff,9,42,90028,264672478,40221117,304893595
2014-09-13,1,TPG,39,148,290700,11155873972,1627922051,12783796023
2014-09-13,1,RPG,21,75,133951,10618167938,633526816,11251694754
2014-09-13,1,UG,30,114,173161,29101247680,3492213625,32593461305
2014-09-13,1,Alumni,4,40,69320,2644995678,223932770,2868928448
2014-09-13,1,Others(HKUST),3,41,56871,20835544,8549809,29385353
2014-09-13,1,Non-HKUST,3,5,23985,2187262501,95174385,2282436886
2014-09-13,1,Total,109,465,838016,55993055791,6121540573,62114596364
2014-09-13,G,Staff,13,52,67110,911627777,36082445,947710222
2014-09-13,G,TPG,132,451,425526,1155835966,462069795,1617905761
2014-09-13,G,RPG,57,169,174896,1128482185,760710073,1889192258
2014-09-13,G,UG,145,440,459131,774440948,353277536,1127718484
2014-09-13,G,Alumni,8,11,1922,816013,729269,1545282
2014-09-13,G,Others(HKUST),5,82,138889,41415266,72387071,113802337
2014-09-13,G,Non-HKUST,10,29,19919,342863,294618,637481
2014-09-13,G,Total,370,1234,1287393,4012961018,1685550807,5698511825
2014-09-13,LG1,Staff,28,158,236666,4442167977,101917786,4544085763
2014-09-13,LG1,TPG,291,2486,3321362,6226972428,1768551851,7995524279
2014-09-13,LG1,RPG,132,784,1131753,927131533,823532387,1750663920
2014-09-13,LG1,UG,520,3821,5163178,29549838570,14138351318,43688189888
2014-09-13,LG1,Alumni,17,114,166789,221894842,11113151,233007993
2014-09-13,LG1,Others(HKUST),12,207,612783,43508145,31533148,75041293
2014-09-13,LG1,Non-HKUST,28,132,181349,534563805,45932761,580496566
2014-09-13,LG1,Total,1028,7702,10813880,41946077300,16920932402,58867009702
2014-09-13,LG3,Staff,20,39,44446,706301062,59731261,766032323
2014-09-13,LG3,TPG,178,514,475152,30078694328,2754667863,32833362191
2014-09-13,LG3,RPG,113,275,233475,8684909321,3669776690,12354686011
2014-09-13,LG3,UG,293,544,365963,11793405339,1598441796,13391847135
2014-09-13,LG3,Alumni,15,29,28900,981679065,94864775,1076543840
2014-09-13,LG3,Others(HKUST),8,40,9711,423919247,75489006,499408253
2014-09-13,LG3,Non-HKUST,10,30,34779,723688500,59322042,783010542
2014-09-13,LG3,Total,637,1471,1192426,53392596862,8312293433,61704890295
2014-09-13,LG4,Staff,19,60,75885,415433336,65262939,480696275
2014-09-13,LG4,TPG,139,652,809490,25220514994,4314481248,29534996242
2014-09-13,LG4,RPG,96,334,456482,24005105447,4939805203,28944910650
2014-09-13,LG4,UG,237,760,983651,22975700800,2483562129,25459262929
2014-09-13,LG4,Alumni,17,56,113527,8963134905,590043606,9553178511
2014-09-13,LG4,Others(HKUST),8,106,274567,48358531667,12394584250,60753115917
2014-09-13,LG4,Non-HKUST,11,25,34617,442539623,157778059,600317682
2014-09-13,LG4,Total,527,1993,2748219,130380960772,24945517434,155326478206
2014-09-13,All-Floors,Staff,66,351,514135,6740202630,303215548,7043418178
2014-09-13,All-Floors,TPG,432,4251,5322230,73837891688,10927692808,84765584496
2014-09-13,All-Floors,RPG,279,1637,2130557,45363796424,10827351169,56191147593
2014-09-13,All-Floors,UG,828,5679,7145084,94194633337,22065846404,116260479741
2014-09-13,All-Floors,Alumni,39,250,380458,12812520503,920683571,13733204074
2014-09-13,All-Floors,Others(HKUST),16,476,1092821,48888209869,12582543284,61470753153
2014-09-13,All-Floors,Non-HKUST,46,221,294649,3888397292,358501865,4246899157
2014-09-13,All-Floors,Total,1706,12865,16879934,285725651743,57985834649,343711486392
2014-09-14,1,Staff,9,75,137337,2479960013,64080966,2544040979
2014-09-14,1,TPG,69,578,926997,62736676028,8769991949,71506667977
2014-09-14,1,RPG,34,223,334532,7801347001,777931606,8579278607
2014-09-14,1,UG,80,577,1062136,59975018810,13664231245,73639250055
2014-09-14,1,Alumni,10,51,92492,6454403400,329021025,6783424425
2014-09-14,1,Others(HKUST),2,105,156833,1339445531,276848344,1616293875
2014-09-14,1,Non-HKUST,10,48,101393,11201888853,655205758,11857094611
2014-09-14,1,Total,214,1657,2811720,151988739636,24537310893,176526050529
2014-09-14,G,Staff,24,128,130963,129135308,12212157,141347465
2014-09-14,G,TPG,235,1462,1447293,2534329789,776986143,3311315932
2014-09-14,G,RPG,127,519,568540,5342454295,811408669,6153862964
2014-09-14,G,UG,376,2044,2155874,9493066106,1817540747,11310606853
2014-09-14,G,Alumni,20,109,69583,56511655,11435220,67946875
2014-09-14,G,Others(HKUST),8,73,104376,35999296,6876804,42876100
2014-09-14,G,Non-HKUST,24,72,63500,4862362,825711,5688073
2014-09-14,G,Total,814,4407,4540129,17596358811,3437285451,21033644262
2014-09-14,LG1,Staff,41,210,428222,1322198645,159943161,1482141806
2014-09-14,LG1,TPG,377,4397,5502871,10432848292,2456476972,12889325264
2014-09-14,LG1,RPG,211,1797,2282120,7870617716,3249091938,11119709654
2014-09-14,LG1,UG,760,8185,10511694,28240490882,4648760734,32889251616
2014-09-14,LG1,Alumni,31,211,305445,1003809449,80069012,1083878461
2014-09-14,LG1,Others(HKUST),9,405,727783,149033097,39424081,188457178
2014-09-14,LG1,Non-HKUST,38,230,263743,1194995332,170223076,1365218408
2014-09-14,LG1,Total,1467,15435,20021878,50213993413,10803988974,61017982387
2014-09-14,LG3,Staff,31,102,44936,2626092754,481967552,3108060306
2014-09-14,LG3,TPG,241,1328,1553727,55609466181,5124119716,60733585897
2014-09-14,LG3,RPG,196,626,751738,21384038572,6222378433,27606417005
2014-09-14,LG3,UG,506,1660,1556354,30454936868,2557069303,33012006171
2014-09-14,LG3,Alumni,22,87,123082,2624579158,157496580,2782075738
2014-09-14,LG3,Others(HKUST),8,84,80774,2104359223,2026827131,4131186354
2014-09-14,LG3,Non-HKUST,32,147,168500,3080483195,412371417,3492854612
2014-09-14,LG3,Total,1036,4034,4279111,117883955951,16982230132,134866186083
2014-09-14,LG4,Staff,27,130,199067,2361744857,149544970,2511289827
2014-09-14,LG4,TPG,205,2049,2895199,60028877994,71877232073,131906110067
2014-09-14,LG4,RPG,150,879,1199366,93704743870,4816963800,98521707670
2014-09-14,LG4,UG,402,1839,2181121,65649287209,12083080324,77732367533
2014-09-14,LG4,Alumni,25,208,350955,3634048525,322697293,3956745818
2014-09-14,LG4,Others(HKUST),9,182,277577,33947430830,11436225768,45383656598
2014-09-14,LG4,Non-HKUST,31,207,393887,9111904312,830367834,9942272146
2014-09-14,LG4,Total,849,5494,7497172,268438037597,101516112062,369954149659
2014-09-14,All-Floors,Staff,84,645,940525,8919131577,867748806,9786880383
2014-09-14,All-Floors,TPG,489,9814,12326087,191342198284,89004806853,280347005137
2014-09-14,All-Floors,RPG,395,4044,5136296,136103201454,15877774446,151980975900
2014-09-14,All-Floors,UG,1165,14305,17467179,193812799875,34770682353,228583482228
2014-09-14,All-Floors,Alumni,53,666,941557,13773352187,900719130,14674071317
2014-09-14,All-Floors,Others(HKUST),15,849,1347343,37576267977,13786202128,51362470105
2014-09-14,All-Floors,Non-HKUST,73,704,991023,24594134054,2068993796,26663127850
2014-09-14,All-Floors,Total,2274,31027,39150010,606121085408,157276927512,763398012920
2014-09-15,1,Staff,75,571,797318,11589749473,1413569569,13003319042
2014-09-15,1,TPG,118,831,1162781,70954712842,10976277330,81930990172
2014-09-15,1,RPG,45,212,351663,3643781117,2421082612,6064863729
2014-09-15,1,UG,530,2630,3227513,71472641879,10224759601,81697401480
2014-09-15,1,Alumni,3,51,81396,3231918566,1464903720,4696822286
2014-09-15,1,Others(HKUST),4,87,95371,158156194,25588479,183744673
2014-09-15,1,Non-HKUST,12,58,83593,4326249801,572621723,4898871524
2014-09-15,1,Total,787,4440,5799635,165377209872,27098803034,192476012906
2014-09-15,G,Staff,137,801,517899,556836499,328230115,885066614
2014-09-15,G,TPG,374,2145,1353334,6742018451,1190325787,7932344238
2014-09-15,G,RPG,231,1032,671189,775995991,272282913,1048278904
2014-09-15,G,UG,1770,7937,4291178,12144150770,3906903818,16051054588
2014-09-15,G,Alumni,8,35,7296,51543881,184965992,236509873
2014-09-15,G,Others(HKUST),17,142,154071,34840724,7749260,42589984
2014-09-15,G,Non-HKUST,34,128,65996,30844782,18700025,49544807
2014-09-15,G,Total,2571,12220,7060963,20336231098,5909157910,26245389008
2014-09-15,LG1,Staff,119,578,474498,2733349371,144103140,2877452511
2014-09-15,LG1,TPG,531,4967,4034761,8013417291,704920088,8718337379
2014-09-15,LG1,RPG,251,1732,1640601,11693440392,1471861753,13165302145
2014-09-15,LG1,UG,2386,17742,13469940,57092432693,5685203632,62777636325
2014-09-15,LG1,Alumni,14,107,85498,557530,399786,957316
2014-09-15,LG1,Others(HKUST),21,323,692092,253475493,107491549,360967042
2014-09-15,LG1,Non-HKUST,57,300,265554,193903271,23457135,217360406
2014-09-15,LG1,Total,3379,25749,20662944,79980576041,8137437083,88118013124
2014-09-15,LG3,Staff,209,437,238503,3043730822,224195054,3267925876
2014-09-15,LG3,TPG,433,2278,2322390,52056873516,7758435172,59815308688
2014-09-15,LG3,RPG,313,947,730489,14432827473,1897455251,16330282724
2014-09-15,LG3,UG,2314,6107,4081374,97960361537,18883218380,116843579917
2014-09-15,LG3,Alumni,7,47,64202,1890231472,144204841,2034436313
2014-09-15,LG3,Others(HKUST),21,112,79127,934283486,94090958,1028374444
2014-09-15,LG3,Non-HKUST,42,102,52820,419972168,53618734,473590902
2014-09-15,LG3,Total,3339,10030,7568905,170738280474,29055218390,199793498864
2014-09-15,LG4,Staff,185,528,412550,5005146565,1068001019,6073147584
2014-09-15,LG4,TPG,396,3646,4142317,100056325342,12141281095,112197606437
2014-09-15,LG4,RPG,294,1581,1928480,68974491364,8469372315,77443863679
2014-09-15,LG4,UG,2059,7293,5715702,118698248782,15182298918,133880547700
2014-09-15,LG4,Alumni,11,80,198716,10323482514,815272948,11138755462
2014-09-15,LG4,Others(HKUST),20,264,318691,51174718668,26816164217,77990882885
2014-09-15,LG4,Non-HKUST,37,158,185893,1362255829,139092895,1501348724
2014-09-15,LG4,Total,3002,13550,12902349,355594669064,64631483407,420226152471
2014-09-15,All-Floors,Staff,434,2915,2440768,22928812730,3178098897,26106911627
2014-09-15,All-Floors,TPG,781,13867,13015583,237823347442,32771239472,270594586914
2014-09-15,All-Floors,RPG,620,5504,5322422,99520536337,14532054844,114052591181
2014-09-15,All-Floors,UG,4676,41709,30785707,357367835661,53882384349,411250220010
2014-09-15,All-Floors,Alumni,22,320,437108,15497733963,2609747287,18107481250
2014-09-15,All-Floors,Others(HKUST),36,928,1339352,52555474565,27051084463,79606559028
2014-09-15,All-Floors,Non-HKUST,113,746,653856,6333225851,807490512,7140716363
2014-09-15,All-Floors,Total,6682,65989,53994796,792026966549,134832099824,926859066373
2014-09-16,1,Staff,60,490,506074,5351341689,433116693,5784458382
2014-09-16,1,TPG,106,789,1147484,17180728760,2874252910,20054981670
2014-09-16,1,RPG,37,246,301001,2595737419,391817890,2987555309
2014-09-16,1,UG,277,1682,2209836,53567963797,6674408669,60242372466
2014-09-16,1,Alumni,2,71,49438,8396998907,436391005,8833389912
2014-09-16,1,Others(HKUST),8,116,152916,594493018,70033743,664526761
2014-09-16,1,Non-HKUST,7,24,74773,784092862,109144086,893236948
2014-09-16,1,Total,497,3418,4441522,88471356452,10989164996,99460521448
2014-09-16,G,Staff,101,598,336369,2640325093,194763539,2835088632
2014-09-16,G,TPG,296,1443,1023512,2421374934,692267983,3113642917
2014-09-16,G,RPG,154,701,543017,1096161601,184719767,1280881368
2014-09-16,G,UG,1049,4691,3305668,10876102723,1566482409,12442585132
2014-09-16,G,Alumni,8,33,4457,6093971,930716,7024687
2014-09-16,G,Others(HKUST),15,91,163328,18272661,4040451,22313112
2014-09-16,G,Non-HKUST,22,65,80356,8061410,1118341,9179751
2014-09-16,G,Total,1645,7622,5456707,17066392393,2644323206,19710715599
2014-09-16,LG1,Staff,102,492,351049,317417606,62271062,379688668
2014-09-16,LG1,TPG,421,2951,3038682,11291792841,3160518587,14452311428
2014-09-16,LG1,RPG,174,1355,1541997,3716280046,1333794811,5050074857
2014-09-16,LG1,UG,1689,12142,11815542,30688295834,3850255430,34538551264
2014-09-16,LG1,Alumni,12,61,109479,780125371,116734267,896859638
2014-09-16,LG1,Others(HKUST),14,170,506147,28498444,25566927,54065371
2014-09-16,LG1,Non-HKUST,32,125,141421,302049668,14005318,316054986
2014-09-16,LG1,Total,2444,17296,17504317,47124459810,8563146402,55687606212
2014-09-16,LG3,Staff,159,320,221743,5409343729,405116444,5814460173
2014-09-16,LG3,TPG,342,1853,2144796,47735626943,7622737944,55358364887
2014-09-16,LG3,RPG,300,791,690376,13746395584,4426272921,18172668505
2014-09-16,LG3,UG,1623,4275,2745791,48574774207,11098783673,59673557880
2014-09-16,LG3,Alumni,7,17,8130,52924300,7801894,60726194
2014-09-16,LG3,Others(HKUST),19,71,47603,286161709,45932806,332094515
2014-09-16,LG3,Non-HKUST,30,68,46327,2295591911,107795464,2403387375
2014-09-16,LG3,Total,2480,7395,5904766,118100818383,23714441146,141815259529
2014-09-16,LG4,Staff,120,316,307255,13524294899,1054605168,14578900067
2014-09-16,LG4,TPG,324,2441,3084977,62544828447,14971421468,77516249915
2014-09-16,LG4,RPG,270,1031,1147563,35611354735,6394073579,42005428314
2014-09-16,LG4,UG,1301,4466,4480219,71849454074,6484050513,78333504587
2014-09-16,LG4,Alumni,6,31,44375,308565851,46238748,354804599
2014-09-16,LG4,Others(HKUST),17,163,203005,13125269724,4201058303,17326328027
2014-09-16,LG4,Non-HKUST,22,98,200005,872943982,140892155,1013836137
2014-09-16,LG4,Total,2060,8546,9467399,197836711712,33292339934,231129051646
2014-09-16,All-Floors,Staff,320,2216,1722490,27242723016,2149872906,29392595922
2014-09-16,All-Floors,TPG,651,9477,10439451,141174351925,29321198892,170495550817
2014-09-16,All-Floors,RPG,548,4124,4223954,56765929385,12730678968,69496608353
2014-09-16,All-Floors,UG,3175,27256,24557056,215556590635,29673980694,245230571329
2014-09-16,All-Floors,Alumni,13,213,215879,9544708400,608096630,10152805030
2014-09-16,All-Floors,Others(HKUST),32,611,1072999,14052695556,4346632230,18399327786
2014-09-16,All-Floors,Non-HKUST,78,380,542882,4262739833,372955364,4635695197
2014-09-16,All-Floors,Total,4817,44277,42774711,468599738750,79203415684,547803154434
2014-09-17,1,Staff,69,579,712639,9164369489,876560513,10040930002
2014-09-17,1,TPG,115,877,1193728,33967027550,3749856589,37716884139
2014-09-17,1,RPG,47,346,427106,8030679724,744462189,8775141913
2014-09-17,1,UG,532,2961,3470046,158347807935,19877238057,178225045992
2014-09-17,1,Alumni,4,68,106319,46673006206,2663566823,49336573029
2014-09-17,1,Others(HKUST),9,97,149732,1087234537,61982247,1149216784
2014-09-17,1,Non-HKUST,8,42,56103,231856914,62327666,294184580
2014-09-17,1,Total,784,4970,6115673,257501982355,28035994084,285537976439
2014-09-17,G,Staff,134,737,464798,1078161354,111509584,1189670938
2014-09-17,G,TPG,424,2083,1385123,5273111647,7397959839,12671071486
2014-09-17,G,RPG,235,1083,816227,1400440729,363471818,1763912547
2014-09-17,G,UG,1704,7260,4741800,16557733711,2744918064,19302651775
2014-09-17,G,Alumni,8,17,7940,47019207,1735570,48754777
2014-09-17,G,Others(HKUST),14,88,130672,50347295,9813637,60160932
2014-09-17,G,Non-HKUST,30,123,56558,293861836,14506028,308367864
2014-09-17,G,Total,2549,11391,7603118,24700675779,10643914540,35344590319
2014-09-17,LG1,Staff,113,604,488030,2234146806,128448692,2362595498
2014-09-17,LG1,TPG,532,4002,3788531,6961941500,1145422033,8107363533
2014-09-17,LG1,RPG,257,1944,2244401,7489795837,369956784,7859752621
2014-09-17,LG1,UG,2496,17954,16144662,37522605731,10828814010,48351419741
2014-09-17,LG1,Alumni,14,117,129188,176634246,15773028,192407274
2014-09-17,LG1,Others(HKUST),16,254,626308,474791907,83539731,558331638
2014-09-17,LG1,Non-HKUST,49,223,215375,3686356,1179885,4866241
2014-09-17,LG1,Total,3477,25098,23636495,54863602383,12573134163,67436736546
2014-09-17,LG3,Staff,201,439,279213,7913686935,458295589,8371982524
2014-09-17,LG3,TPG,470,2559,2900813,105963567917,14903527595,120867095512
2014-09-17,LG3,RPG,339,1117,1086829,12010990039,1283919775,13294909814
2014-09-17,LG3,UG,2292,6282,4438581,116423974171,16583642390,133007616561
2014-09-17,LG3,Alumni,10,58,85934,573788408,104862084,678650492
2014-09-17,LG3,Others(HKUST),20,136,59572,950733243,60884901,1011618144
2014-09-17,LG3,Non-HKUST,24,52,28334,356969226,47395694,404364920
2014-09-17,LG3,Total,3356,10643,8879276,244193709939,33442528028,277636237967
2014-09-17,LG4,Staff,141,552,636136,12644063491,1237628957,13881692448
2014-09-17,LG4,TPG,434,3472,4335071,125904819117,18719906975,144624726092
2014-09-17,LG4,RPG,290,1622,2083468,81363501487,7279410900,88642912387
2014-09-17,LG4,UG,2004,7556,6944505,152639674095,22212626354,174852300449
2014-09-17,LG4,Alumni,7,39,77615,2332595347,116831566,2449426913
2014-09-17,LG4,Others(HKUST),16,214,236575,6488922151,2943209735,9432131886
2014-09-17,LG4,Non-HKUST,35,143,236608,2782803294,312429576,3095232870
2014-09-17,LG4,Total,2927,13598,14549978,384156378982,52822044063,436978423045
2014-09-17,All-Floors,Staff,386,2911,2580816,33034428075,2812443335,35846871410
2014-09-17,All-Floors,TPG,838,12993,13603266,278070467731,45916673031,323987140762
2014-09-17,All-Floors,RPG,639,6112,6658031,110295407816,10041221466,120336629282
2014-09-17,All-Floors,UG,4626,42013,35739594,481491795643,72247238875,553739034518
2014-09-17,All-Floors,Alumni,20,299,406996,49803043414,2902769071,52705812485
2014-09-17,All-Floors,Others(HKUST),33,789,1202859,9052029133,3159430251,12211459384
2014-09-17,All-Floors,Non-HKUST,92,583,592978,3669177626,437838849,4107016475
2014-09-17,All-Floors,Total,6634,65700,60784540,965416349438,137517614878,1102933964316
2014-09-18,1,Staff,75,576,797524,10154760470,666123460,10820883930
2014-09-18,1,TPG,119,1056,1536069,58883967550,6412590772,65296558322
2014-09-18,1,RPG,45,257,359660,15549852417,892612328,16442464745
2014-09-18,1,UG,524,2732,3573628,106960744220,17953734944,124914479164
2014-09-18,1,Alumni,4,39,164585,9852497996,641435453,10493933449
2014-09-18,1,Others(HKUST),4,48,207025,746695945,74120183,820816128
2014-09-18,1,Non-HKUST,8,19,60015,1762361498,107537774,1869899272
2014-09-18,1,Total,779,4727,6698506,203910880096,26748154914,230659035010
2014-09-18,G,Staff,121,665,565483,10857157039,675530241,11532687280
2014-09-18,G,TPG,419,2225,1612230,7546292770,842460693,8388753463
2014-09-18,G,RPG,203,851,579138,4980874611,304403413,5285278024
2014-09-18,G,UG,1734,7360,4561384,16013662587,2670982015,18684644602
2014-09-18,G,Alumni,9,36,6265,12392571,2478362,14870933
2014-09-18,G,Others(HKUST),16,63,116710,24802704,8299709,33102413
2014-09-18,G,Non-HKUST,38,122,170128,3248396608,160132989,3408529597
2014-09-18,G,Total,2540,11322,7611338,42683578890,4664287422,47347866312
2014-09-18,LG1,Staff,121,601,518741,924069846,103859993,1027929839
2014-09-18,LG1,TPG,563,4493,3927604,19345599328,1989362479,21334961807
2014-09-18,LG1,RPG,284,2215,2503388,6588835143,746762642,7335597785
2014-09-18,LG1,UG,2464,18779,16285707,47967810781,5967943749,53935754530
2014-09-18,LG1,Alumni,14,80,54236,276614,165652,442266
2014-09-18,LG1,Others(HKUST),19,192,657884,4084692495,209293531,4293986026
2014-09-18,LG1,Non-HKUST,51,210,205261,364367769,37432480,401800249
2014-09-18,LG1,Total,3516,26570,24152821,79275651976,9054820526,88330472502
2014-09-18,LG3,Staff,189,372,311882,2567822527,816473621,3384296148
2014-09-18,LG3,TPG,479,2479,3024638,76641089759,8053418000,84694507759
2014-09-18,LG3,RPG,324,921,845037,8796772358,942974275,9739746633
2014-09-18,LG3,UG,2205,5569,3778919,140172338231,10120619048,150292957279
2014-09-18,LG3,Alumni,12,41,66664,1298471753,208995304,1507467057
2014-09-18,LG3,Others(HKUST),17,142,30564,134152396,11703023,145855419
2014-09-18,LG3,Non-HKUST,34,84,29756,326833958,132574526,459408484
2014-09-18,LG3,Total,3260,9608,8087460,229937480982,20286757797,250224238779
2014-09-18,LG4,Staff,148,437,520671,10014245754,1952307398,11966553152
2014-09-18,LG4,TPG,428,3338,4591654,125205036231,25703746090,150908782321
2014-09-18,LG4,RPG,273,1252,1675430,78406992718,4666432771,83073425489
2014-09-18,LG4,UG,1986,6572,6379523,117442476676,14020457126,131462933802
2014-09-18,LG4,Alumni,16,152,227251,6237716934,307484809,6545201743
2014-09-18,LG4,Others(HKUST),18,163,229364,27992672890,18142997034,46135669924
2014-09-18,LG4,Non-HKUST,30,128,119119,601679701,72703384,674383085
2014-09-18,LG4,Total,2899,12042,13743012,365900820904,64866128612,430766949516
2014-09-18,All-Floors,Staff,420,2651,2714301,34518055636,4214294713,38732350349
2014-09-18,All-Floors,TPG,852,13591,14692195,287621985638,43001578034,330623563672
2014-09-18,All-Floors,RPG,644,5496,5962653,114323327247,7553185429,121876512676
2014-09-18,All-Floors,UG,4624,41012,34579161,428557032495,50733736882,479290769377
2014-09-18,All-Floors,Alumni,24,348,519001,17401355868,1160559580,18561915448
2014-09-18,All-Floors,Others(HKUST),34,608,1241547,32983016430,18446413480,51429429910
2014-09-18,All-Floors,Non-HKUST,97,563,584279,6303639534,510381153,6814020687
2014-09-18,All-Floors,Total,6695,64269,60293137,921708412848,125620149271,1047328562119
2014-09-19,1,Staff,63,485,884539,6661782646,660343723,7322126369
2014-09-19,1,TPG,118,852,1240309,45301655117,3145549804,48447204921
2014-09-19,1,RPG,36,237,275554,14351519324,851027845,15202547169
2014-09-19,1,UG,484,2498,3103986,100392328490,13246034795,113638363285
2014-09-19,1,Alumni,5,67,136179,32643939626,1317966464,33961906090
2014-09-19,1,Others(HKUST),4,48,170507,1280379524,56297712,1336677236
2014-09-19,1,Non-HKUST,9,23,86406,425026385,58526547,483552932
2014-09-19,1,Total,719,4210,5897480,201056631112,19335746890,220392378002
2014-09-19,G,Staff,117,684,412010,1581073218,534890675,2115963893
2014-09-19,G,TPG,402,2241,1586555,5175141803,553785948,5728927751
2014-09-19,G,RPG,177,822,683491,3794610330,178999746,3973610076
2014-09-19,G,UG,1551,6361,3896461,15630810280,2587815052,18218625332
2014-09-19,G,Alumni,9,47,11256,4424814,893573,5318387
2014-09-19,G,Others(HKUST),11,99,123624,100087834,109794196,209882030
2014-09-19,G,Non-HKUST,27,86,34993,5986805431,94667585,6081473016
2014-09-19,G,Total,2294,10340,6748390,32272953710,4060846775,36333800485
2014-09-19,LG1,Staff,123,707,525685,707873106,191822220,899695326
2014-09-19,LG1,TPG,513,4215,4288202,12900857062,2100637484,15001494546
2014-09-19,LG1,RPG,237,1527,1722519,9929986463,1769317237,11699303700
2014-09-19,LG1,UG,2242,15315,13420033,55707440528,8810991343,64518431871
2014-09-19,LG1,Alumni,16,122,121905,21420825,1426800,22847625
2014-09-19,LG1,Others(HKUST),20,241,582087,408555896,163901980,572457876
2014-09-19,LG1,Non-HKUST,55,273,252366,71149191,6659392,77808583
2014-09-19,LG1,Total,3206,22400,20912797,79747283071,13044756456,92792039527
2014-09-19,LG3,Staff,186,405,309304,26169421681,3034925254,29204346935
2014-09-19,LG3,TPG,413,2110,2645745,75045128956,10482238605,85527367561
2014-09-19,LG3,RPG,289,912,919420,24387101940,1715178730,26102280670
2014-09-19,LG3,UG,1857,4538,3051409,83037772034,16903002003,99940774037
2014-09-19,LG3,Alumni,10,51,87009,2997579523,218672038,3216251561
2014-09-19,LG3,Others(HKUST),19,163,47556,764448382,49485060,813933442
2014-09-19,LG3,Non-HKUST,42,110,84639,1642156092,264605655,1906761747
2014-09-19,LG3,Total,2816,8289,7145082,214043608608,32668107345,246711715953
2014-09-19,LG4,Staff,145,317,188246,5446468173,346884988,5793353161
2014-09-19,LG4,TPG,407,3995,5208863,109188912382,16783181109,125972093491
2014-09-19,LG4,RPG,268,1252,1649141,25902200020,3102775051,29004975071
2014-09-19,LG4,UG,1681,5901,5568734,195669673531,19307038152,214976711683
2014-09-19,LG4,Alumni,9,75,159330,625793387,73548734,699342121
2014-09-19,LG4,Others(HKUST),18,292,311751,23570733553,8017943814,31588677367
2014-09-19,LG4,Non-HKUST,40,199,204525,2463072732,121193929,2584266661
2014-09-19,LG4,Total,2568,12031,13290590,362866853778,47752565777,410619419555
2014-09-19,All-Floors,Staff,393,2598,2319784,40566618824,4768866860,45335485684
2014-09-19,All-Floors,TPG,761,13413,14969674,247611695320,33065392950,280677088270
2014-09-19,All-Floors,RPG,584,4750,5250125,78365418077,7617298609,85982716686
2014-09-19,All-Floors,UG,4194,34613,29040623,450438024863,60854881345,511292906208
2014-09-19,All-Floors,Alumni,23,362,515679,36293158175,1612507609,37905665784
2014-09-19,All-Floors,Others(HKUST),35,843,1235525,26124205189,8397422762,34521627951
2014-09-19,All-Floors,Non-HKUST,94,691,662929,10588209831,545653108,11133862939
2014-09-19,All-Floors,Total,6084,57270,53994339,889987330279,116862023243,1006849353522
2014-09-20,1,Staff,13,93,162509,876368226,40556808,916925034
2014-09-20,1,TPG,71,443,836346,30281186775,4557839415,34839026190
2014-09-20,1,RPG,28,169,381181,12976638980,1167621711,14144260691
2014-09-20,1,UG,84,511,1026587,23137771715,4625384763,27763156478
2014-09-20,1,Alumni,6,84,185818,13165095546,740822088,13905917634
2014-09-20,1,Others(HKUST),3,43,111848,1681533005,143903960,1825436965
2014-09-20,1,Non-HKUST,3,3,959,17791,2667,20458
2014-09-20,1,Total,208,1346,2705248,82118612038,11276131412,93394743450
2014-09-20,G,Staff,42,267,153033,259077429,56843900,315921329
2014-09-20,G,TPG,270,1087,959262,2673647452,219533481,2893180933
2014-09-20,G,RPG,113,490,522763,1954845222,394815494,2349660716
2014-09-20,G,UG,326,1092,871078,3979352443,835558432,4814910875
2014-09-20,G,Alumni,25,71,65104,42739637,4683302,47422939
2014-09-20,G,Others(HKUST),9,78,81163,57115733,8839818,65955551
2014-09-20,G,Non-HKUST,16,43,30094,127247899,5410662,132658561
2014-09-20,G,Total,801,3128,2682497,9094025815,1525685089,10619710904
2014-09-20,LG1,Staff,43,260,318072,2171166511,162847809,2334014320
2014-09-20,LG1,TPG,446,4584,6264727,14581689453,2112690340,16694379793
2014-09-20,LG1,RPG,167,1381,1920353,8712764625,1189080264,9901844889
2014-09-20,LG1,UG,710,7175,9336184,39457997494,4484710838,43942708332
2014-09-20,LG1,Alumni,24,148,152414,25371740,17632787,43004527
2014-09-20,LG1,Others(HKUST),8,167,624974,321622552,80026350,401648902
2014-09-20,LG1,Non-HKUST,29,165,198107,749017079,126705175,875722254
2014-09-20,LG1,Total,1427,13880,18814831,66019629454,8173693563,74193323017
2014-09-20,LG3,Staff,55,150,132162,640126291,95762409,735888700
2014-09-20,LG3,TPG,285,1346,1864620,60626349522,8988384608,69614734130
2014-09-20,LG3,RPG,169,504,429744,14609298723,882942836,15492241559
2014-09-20,LG3,UG,517,1299,1212745,36638760699,4102671989,40741432688
2014-09-20,LG3,Alumni,21,65,122168,78615898324,10120054380,88735952704
2014-09-20,LG3,Others(HKUST),10,88,21987,17797243,1690602,19487845
2014-09-20,LG3,Non-HKUST,17,36,35054,1179075481,62668665,1241744146
2014-09-20,LG3,Total,1074,3488,3818480,192327306283,24254175489,216581481772
2014-09-20,LG4,Staff,41,90,78768,1393072666,269023102,1662095768
2014-09-20,LG4,TPG,241,1484,2111576,37116578232,4537278350,41653856582
2014-09-20,LG4,RPG,137,659,1006957,31661653872,4774381169,36436035041
2014-09-20,LG4,UG,437,1490,2170224,56382817129,8478214458,64861031587
2014-09-20,LG4,Alumni,21,157,242311,3413496752,203169861,3616666613
2014-09-20,LG4,Others(HKUST),6,168,353097,27055745712,8161550074,35217295786
2014-09-20,LG4,Non-HKUST,19,61,89525,1446121935,130664012,1576785947
2014-09-20,LG4,Total,902,4109,6052458,158469486298,26554281026,185023767324
2014-09-20,All-Floors,Staff,125,860,844544,5339811123,625034028,5964845151
2014-09-20,All-Floors,TPG,626,8944,12036531,145279451434,20415726194,165695177628
2014-09-20,All-Floors,RPG,359,3203,4260998,69915201422,8408841474,78324042896
2014-09-20,All-Floors,UG,1178,11567,14616818,159596699480,22526540480,182123239960
2014-09-20,All-Floors,Alumni,47,525,767815,95262601999,11086362418,106348964417
2014-09-20,All-Floors,Others(HKUST),17,544,1193069,29133814245,8396010804,37529825049
2014-09-20,All-Floors,Non-HKUST,54,308,353739,3501480185,325451181,3826931366
2014-09-20,All-Floors,Total,2406,25951,34073514,508029059888,71783966579,579813026467
2014-09-21,1,Staff,12,134,181290,2689082663,842294061,3531376724
2014-09-21,1,TPG,91,612,1080204,44034495706,7018615320,51053111026
2014-09-21,1,RPG,32,130,323275,10834139425,575768615,11409908040
2014-09-21,1,UG,117,1021,1740401,124284972917,16407171742,140692144659
2014-09-21,1,Alumni,9,97,203234,7109349378,837788418,7947137796
2014-09-21,1,Others(HKUST),3,74,132118,2604070452,283637936,2887708388
2014-09-21,1,Non-HKUST,9,40,72110,1489369996,71925571,1561295567
2014-09-21,1,Total,273,2108,3732632,193045480537,26037201663,219082682200
2014-09-21,G,Staff,33,170,94775,2624423,4958238,7582661
2014-09-21,G,TPG,236,1493,1432046,9204948670,824116442,10029065112
2014-09-21,G,RPG,108,557,524989,649280656,124905458,774186114
2014-09-21,G,UG,379,2036,1931260,5253215480,539010378,5792225858
2014-09-21,G,Alumni,26,85,32741,259179131,10726998,269906129
2014-09-21,G,Others(HKUST),7,45,17651,16193383,832807,17026190
2014-09-21,G,Non-HKUST,20,55,52803,3762157,1955723,5717880
2014-09-21,G,Total,809,4441,4086265,15389203900,1506506044,16895709944
2014-09-21,LG1,Staff,41,291,257431,735496374,39636303,775132677
2014-09-21,LG1,TPG,413,5527,6698371,13292020627,2031994923,15324015550
2014-09-21,LG1,RPG,198,1733,2324857,12554081871,1017446377,13571528248
2014-09-21,LG1,UG,829,9883,12062615,52274777091,11233442967,63508220058
2014-09-21,LG1,Alumni,35,231,274822,161029814,59376831,220406645
2014-09-21,LG1,Others(HKUST),12,220,661497,120920203,92936526,213856729
2014-09-21,LG1,Non-HKUST,36,227,295486,548743802,23171332,571915134
2014-09-21,LG1,Total,1564,18112,22575079,79687069782,14498005259,94185075041
2014-09-21,LG3,Staff,42,101,64581,2654990121,306654925,2961645046
2014-09-21,LG3,TPG,277,1672,2133244,90116867108,6535449215,96652316323
2014-09-21,LG3,RPG,190,743,783463,25014190824,1847507090,26861697914
2014-09-21,LG3,UG,594,2224,2049661,33172497847,4708272383,37880770230
2014-09-21,LG3,Alumni,28,137,136289,10612462194,358038373,10970500567
2014-09-21,LG3,Others(HKUST),8,187,114004,336841934,183107588,519949522
2014-09-21,LG3,Non-HKUST,21,90,102079,1325806566,2983856723,4309663289
2014-09-21,LG3,Total,1160,5154,5383321,163233656594,16922886297,180156542891
2014-09-21,LG4,Staff,36,173,159123,8450177074,618307090,9068484164
2014-09-21,LG4,TPG,235,2316,3263608,56379690606,12624093623,69003784229
2014-09-21,LG4,RPG,157,895,1194826,39417402543,3482833108,42900235651
2014-09-21,LG4,UG,491,2470,3165082,55046059137,7502675242,62548734379
2014-09-21,LG4,Alumni,31,293,618378,55552945074,36015174378,91568119452
2014-09-21,LG4,Others(HKUST),9,136,290857,24454041962,8036513733,32490555695
2014-09-21,LG4,Non-HKUST,26,186,270602,8690831354,632375596,9323206950
2014-09-21,LG4,Total,985,6469,8962476,247991147750,68911972770,316903120520
2014-09-21,All-Floors,Staff,99,869,757200,14532370655,1811850617,16344221272
2014-09-21,All-Floors,TPG,524,11620,14607473,213028022717,29034269523,242062292240
2014-09-21,All-Floors,RPG,378,4058,5151410,88469095319,7048460648,95517555967
2014-09-21,All-Floors,UG,1271,17634,20949019,270031522472,40390572712,310422095184
2014-09-21,All-Floors,Alumni,56,843,1265464,73694965591,37281104998,110976070589
2014-09-21,All-Floors,Others(HKUST),18,662,1216127,27532067934,8597028590,36129096524
2014-09-21,All-Floors,Non-HKUST,65,598,793080,12058513875,3713284945,15771798820
2014-09-21,All-Floors,Total,2411,36284,44739773,699346558563,127876572033,827223130596
2014-09-22,1,Staff,68,563,867084,3958796321,450994702,4409791023
2014-09-22,1,TPG,144,1215,1500913,81745324096,8463720067,90209044163
2014-09-22,1,RPG,50,244,394386,16096930132,2201662919,18298593051
2014-09-22,1,UG,556,3372,4181193,136248604999,18636795878,154885400877
2014-09-22,1,Alumni,2,8,3822,27133311,2469522,29602833
2014-09-22,1,Others(HKUST),7,78,86991,1226794656,43861295,1270655951
2014-09-22,1,Non-HKUST,7,14,24007,72924653,13499780,86424433
2014-09-22,1,Total,834,5494,7058396,239376508168,29813004163,269189512331
2014-09-22,G,Staff,139,764,533731,2385389185,235889429,2621278614
2014-09-22,G,TPG,461,2525,1459252,5466336773,1486480409,6952817182
2014-09-22,G,RPG,233,1063,792457,2283238418,555430445,2838668863
2014-09-22,G,UG,1714,7976,5143756,31200473135,3426561640,34627034775
2014-09-22,G,Alumni,10,49,24419,534737693,14599532,549337225
2014-09-22,G,Others(HKUST),16,98,38092,1630715,534711,2165426
2014-09-22,G,Non-HKUST,29,105,56870,996356543,468737448,1465093991
2014-09-22,G,Total,2602,12580,8048577,42868162462,6188233614,49056396076
2014-09-22,LG1,Staff,120,641,545483,524572961,77541699,602114660
2014-09-22,LG1,TPG,619,5449,4473703,7752504656,4248856371,12001361027
2014-09-22,LG1,RPG,244,1875,2043969,4062795546,2141621943,6204417489
2014-09-22,LG1,UG,2624,21074,17796480,73054136540,11175982578,84230119118
2014-09-22,LG1,Alumni,16,153,142427,660275223,51780399,712055622
2014-09-22,LG1,Others(HKUST),19,391,686036,298993012,182435335,481428347
2014-09-22,LG1,Non-HKUST,46,150,150213,1933357343,131209686,2064567029
2014-09-22,LG1,Total,3688,29733,25838311,88286635281,18009428011,106296063292
2014-09-22,LG3,Staff,195,470,237891,2023554501,1789165562,3812720063
2014-09-22,LG3,TPG,488,3133,3396454,94555528135,10104472981,104660001116
2014-09-22,LG3,RPG,301,979,941276,15723098136,4040175550,19763273686
2014-09-22,LG3,UG,2187,6237,4237798,90216090827,16179088134,106395178961
2014-09-22,LG3,Alumni,6,19,25585,760739506,49089592,809829098
2014-09-22,LG3,Others(HKUST),20,170,71638,220668659,66292483,286961142
2014-09-22,LG3,Non-HKUST,32,124,80846,2126247432,662593061,2788840493
2014-09-22,LG3,Total,3229,11132,8991488,205625927196,32890877363,238516804559
2014-09-22,LG4,Staff,158,565,549663,11302519537,1212722124,12515241661
2014-09-22,LG4,TPG,479,5257,6380240,109752572391,24834760681,134587333072
2014-09-22,LG4,RPG,263,1440,1818761,65193679729,3839768876,69033448605
2014-09-22,LG4,UG,1978,8140,7703937,182265571070,33554772076,215820343146
2014-09-22,LG4,Alumni,11,152,175355,5781420789,391753583,6173174372
2014-09-22,LG4,Others(HKUST),19,303,349335,23375034311,7969646999,31344681310
2014-09-22,LG4,Non-HKUST,36,169,239070,5293200821,1237339196,6530540017
2014-09-22,LG4,Total,2944,16026,17216361,402963998648,73040763535,476004762183
2014-09-22,All-Floors,Staff,428,3003,2733852,20194832505,3766313516,23961146021
2014-09-22,All-Floors,TPG,871,17579,17210562,299272266051,49138290509,348410556560
2014-09-22,All-Floors,RPG,610,5601,5990849,103359741961,12778659733,116138401694
2014-09-22,All-Floors,UG,4643,46799,39063164,512984876571,82973200306,595958076877
2014-09-22,All-Floors,Alumni,24,381,371608,7764306522,509692628,8273999150
2014-09-22,All-Floors,Others(HKUST),32,1040,1232092,25123121353,8262770823,33385892176
2014-09-22,All-Floors,Non-HKUST,91,562,551006,10422086792,2513379171,12935465963
2014-09-22,All-Floors,Total,6699,74965,67153133,979121231755,159942306686,1139063538441
2014-09-23,1,Staff,67,657,914471,9112554142,1920676430,11033230572
2014-09-23,1,TPG,144,1730,1895576,105061896538,6728991127,111790887665
2014-09-23,1,RPG,51,272,312906,26570510117,3747090975,30317601092
2014-09-23,1,UG,606,3480,4082357,109710148268,12018279295,121728427563
2014-09-23,1,Alumni,5,25,16177,43955678,7189365,51145043
2014-09-23,1,Others(HKUST),10,104,167285,3604036611,285776134,3889812745
2014-09-23,1,Non-HKUST,11,55,137865,437196943,43811457,481008400
2014-09-23,1,Total,894,6323,7526637,254540298297,24751814783,279292113080
2014-09-23,G,Staff,116,618,497760,2549676548,366974811,2916651359
2014-09-23,G,TPG,456,2511,1466499,3377845529,919505584,4297351113
2014-09-23,G,RPG,209,983,810986,1537611996,97648355,1635260351
2014-09-23,G,UG,1872,8094,4760450,17622792362,3114588464,20737380826
2014-09-23,G,Alumni,15,63,58268,245757251,28181477,273938728
2014-09-23,G,Others(HKUST),19,64,66130,7662293,1297922,8960215
2014-09-23,G,Non-HKUST,30,84,98785,5881808,6728361,12610169
2014-09-23,G,Total,2717,12417,7758878,25347227787,4534924974,29882152761
2014-09-23,LG1,Staff,105,630,536553,876942859,72753504,949696363
2014-09-23,LG1,TPG,614,4828,4086196,10553834491,1783399388,12337233879
2014-09-23,LG1,RPG,282,1987,2206136,12383568510,3416269724,15799838234
2014-09-23,LG1,UG,2736,20985,18275185,49753071708,8518777345,58271849053
2014-09-23,LG1,Alumni,18,128,132372,10302360,2242549,12544909
2014-09-23,LG1,Others(HKUST),19,230,538364,287318508,132110627,419429135
2014-09-23,LG1,Non-HKUST,46,187,206535,924294,150189,1074483
2014-09-23,LG1,Total,3820,28975,25981341,73865962730,13925703326,87791666056
2014-09-23,LG3,Staff,182,496,371956,25901017697,8991419415,34892437112
2014-09-23,LG3,TPG,499,3297,3497998,97110295384,21424236560,118534531944
2014-09-23,LG3,RPG,321,1142,1114080,25319339340,2531828795,27851168135
2014-09-23,LG3,UG,2299,6485,4153518,106289369423,9164689634,115454059057
2014-09-23,LG3,Alumni,9,56,104818,2203149382,141062133,2344211515
2014-09-23,LG3,Others(HKUST),23,182,84153,342339277,234125890,576465167
2014-09-23,LG3,Non-HKUST,29,75,37113,212801504,13796782,226598286
2014-09-23,LG3,Total,3362,11733,9363636,257378312007,42501159209,299879471216
2014-09-23,LG4,Staff,153,515,474367,8609516134,1611788491,10221304625
2014-09-23,LG4,TPG,468,5093,6719344,123848133138,18987515165,142835648303
2014-09-23,LG4,RPG,279,1543,1767250,27476651498,3267935824,30744587322
2014-09-23,LG4,UG,2265,8497,7289553,158086570214,18131848570,176218418784
2014-09-23,LG4,Alumni,12,88,169881,3577762162,249975618,3827737780
2014-09-23,LG4,Others(HKUST),25,250,329021,23756442252,9948213954,33704656206
2014-09-23,LG4,Non-HKUST,33,140,142423,1849517313,581831140,2431348453
2014-09-23,LG4,Total,3235,16126,16891839,347204592711,52779108762,399983701473
2014-09-23,All-Floors,Staff,382,2916,2795107,47049707380,12963612651,60013320031
2014-09-23,All-Floors,TPG,866,17459,17665613,339952005080,49843647824,389795652904
2014-09-23,All-Floors,RPG,639,5927,6211358,93287681461,13060773673,106348455134
2014-09-23,All-Floors,UG,4919,47541,38561063,441461951975,50948183308,492410135283
2014-09-23,All-Floors,Alumni,28,360,481516,6080926833,428651142,6509577975
2014-09-23,All-Floors,Others(HKUST),41,830,1184953,27997798941,10601524527,38599323468
2014-09-23,All-Floors,Non-HKUST,85,541,622721,2506321862,646317929,3152639791
2014-09-23,All-Floors,Total,6960,75574,67522331,958336393532,138492711054,1096829104586
2014-09-24,1,Staff,71,591,833560,17150296182,790666031,17940962213
2014-09-24,1,TPG,135,950,1755062,40392517179,12272931855,52665449034
2014-09-24,1,RPG,43,306,504812,15794849883,999790470,16794640353
2014-09-24,1,UG,559,3266,4397807,129568788389,15870501844,145439290233
2014-09-24,1,Alumni,3,32,51109,62127814,19191756,81319570
2014-09-24,1,Others(HKUST),6,70,176265,4914938431,616290431,5531228862
2014-09-24,1,Non-HKUST,5,15,22907,47167745,3934525,51102270
2014-09-24,1,Total,822,5230,7741522,207930685623,30573306912,238503992535
2014-09-24,G,Staff,125,563,463836,957513742,100796665,1058310407
2014-09-24,G,TPG,435,2184,1669059,4203078710,484102649,4687181359
2014-09-24,G,RPG,194,1004,910418,1366872782,225084887,1591957669
2014-09-24,G,UG,1795,7377,4737220,16203022704,1973495503,18176518207
2014-09-24,G,Alumni,7,33,6502,99547,21480,121027
2014-09-24,G,Others(HKUST),15,112,105006,47890313,23406816,71297129
2014-09-24,G,Non-HKUST,31,114,53612,15564798,1057033,16621831
2014-09-24,G,Total,2602,11387,7945653,22794042596,2807965033,25602007629
2014-09-24,LG1,Staff,111,523,401335,394438221,51406905,445845126
2014-09-24,LG1,TPG,546,4604,4154475,11086965763,1090019101,12176984864
2014-09-24,LG1,RPG,244,1616,1738462,3076519660,332946472,3409466132
2014-09-24,LG1,UG,2773,21028,19485448,62268173078,8599098043,70867271121
2014-09-24,LG1,Alumni,14,113,151960,50797469,23259333,74056802
2014-09-24,LG1,Others(HKUST),20,221,616665,51800009,56780068,108580077
2014-09-24,LG1,Non-HKUST,50,154,175203,55295667,9354028,64649695
2014-09-24,LG1,Total,3758,28259,26723548,76983989867,10162863950,87146853817
2014-09-24,LG3,Staff,190,355,252989,2670761782,299361603,2970123385
2014-09-24,LG3,TPG,449,2541,2979206,126608713987,27870443990,154479157977
2014-09-24,LG3,RPG,286,1021,1197952,49982510332,3513079846,53495590178
2014-09-24,LG3,UG,2087,5922,4178352,70217424643,7920402268,78137826911
2014-09-24,LG3,Alumni,10,45,108699,2605032185,166712322,2771744507
2014-09-24,LG3,Others(HKUST),23,190,127021,1107646383,984254293,2091900676
2014-09-24,LG3,Non-HKUST,37,153,144170,5531177005,403523766,5934700771
2014-09-24,LG3,Total,3082,10227,8988389,258723266317,41157778088,299881044405
2014-09-24,LG4,Staff,131,458,515228,10711042441,5469028713,16180071154
2014-09-24,LG4,TPG,428,4087,5823836,115414994625,34799007943,150214002568
2014-09-24,LG4,RPG,272,1369,1877685,57894862912,5305663361,63200526273
2014-09-24,LG4,UG,2159,8250,8616640,151610042089,16402744780,168012786869
2014-09-24,LG4,Alumni,12,116,204167,4770364841,356755547,5127120388
2014-09-24,LG4,Others(HKUST),21,238,305540,6829446167,2936091802,9765537969
2014-09-24,LG4,Non-HKUST,39,147,187625,3204223455,4689076107,7893299562
2014-09-24,LG4,Total,3062,14665,17530721,350434976530,69958368253,420393344783
2014-09-24,All-Floors,Staff,396,2490,2466948,31884052368,6711259917,38595312285
2014-09-24,All-Floors,TPG,845,14366,16381638,297706270264,76516505538,374222775802
2014-09-24,All-Floors,RPG,593,5316,6229329,128115615569,10376565036,138492180605
2014-09-24,All-Floors,UG,4822,45843,41415467,429867450903,50766242438,480633693341
2014-09-24,All-Floors,Alumni,25,339,522437,7488421856,565940438,8054362294
2014-09-24,All-Floors,Others(HKUST),38,831,1330497,12951721303,4616823410,17568544713
2014-09-24,All-Floors,Non-HKUST,89,583,583517,8853428670,5106945459,13960374129
2014-09-24,All-Floors,Total,6808,69768,68929833,916866960933,154660282236,1071527243169
2014-09-25,1,Staff,63,599,769529,67143891413,4177449178,71321340591
2014-09-25,1,TPG,122,1010,1620298,31224845033,9835013585,41059858618
2014-09-25,1,RPG,39,224,397440,5361268517,867360926,6228629443
2014-09-25,1,UG,613,3147,4301938,111249947334,12705335971,123955283305
2014-09-25,1,Alumni,2,15,13441,105863381,8419153,114282534
2014-09-25,1,Others(HKUST),6,94,192298,3474914522,291194266,3766108788
2014-09-25,1,Non-HKUST,8,35,62618,12451370,27638000,40089370
2014-09-25,1,Total,853,5124,7357562,218573181570,27912411079,246485592649
2014-09-25,G,Staff,110,688,580429,6299255357,1181268609,7480523966
2014-09-25,G,TPG,407,2140,1555910,6782362175,806306990,7588669165
2014-09-25,G,RPG,198,992,908717,2691419595,1101428591,3792848186
2014-09-25,G,UG,1771,7860,4940057,23879084615,2520894363,26399978978
2014-09-25,G,Alumni,8,12,4923,45699178,6182848,51882026
2014-09-25,G,Others(HKUST),16,148,126625,34159888,17043196,51203084
2014-09-25,G,Non-HKUST,22,78,87889,1366842023,31321406,1398163429
2014-09-25,G,Total,2532,11918,8204550,41098822831,5664446003,46763268834
2014-09-25,LG1,Staff,140,715,506276,454604541,317244276,771848817
2014-09-25,LG1,TPG,559,4261,3721203,9188839580,1836350635,11025190215
2014-09-25,LG1,RPG,286,1649,1913826,5522309750,1710522599,7232832349
2014-09-25,LG1,UG,2822,20735,18775306,65750876277,12928386161,78679262438
2014-09-25,LG1,Alumni,15,153,133700,7258936,571505,7830441
2014-09-25,LG1,Others(HKUST),19,208,578366,328414771,51275147,379689918
2014-09-25,LG1,Non-HKUST,48,137,128160,47578276,13016699,60594975
2014-09-25,LG1,Total,3889,27858,25756837,81299882131,16857367022,98157249153
2014-09-25,LG3,Staff,205,401,145774,4711779517,691221811,5403001328
2014-09-25,LG3,TPG,396,2285,2748179,82906781880,9319254071,92226035951
2014-09-25,LG3,RPG,297,924,883170,12599967893,6823678887,19423646780
2014-09-25,LG3,UG,2219,6086,4083295,144632181442,12755438681,157387620123
2014-09-25,LG3,Alumni,10,43,47129,3890580480,145766452,4036346932
2014-09-25,LG3,Others(HKUST),18,111,42124,1264725681,70021392,1334747073
2014-09-25,LG3,Non-HKUST,19,55,46835,357834629,30895692,388730321
2014-09-25,LG3,Total,3164,9905,7996506,250363851522,29836276986,280200128508
2014-09-25,LG4,Staff,162,582,466891,19227314559,3379186313,22606500872
2014-09-25,LG4,TPG,414,3909,5477528,94016082552,30573493924,124589576476
2014-09-25,LG4,RPG,272,1629,2283741,74617047375,4644892510,79261939885
2014-09-25,LG4,UG,2082,7836,7852546,163264799582,16700609072,179965408654
2014-09-25,LG4,Alumni,11,90,126325,790206160,123417139,913623299
2014-09-25,LG4,Others(HKUST),18,218,324075,11418402325,4132060793,15550463118
2014-09-25,LG4,Non-HKUST,30,113,184287,1036309495,82258906,1118568401
2014-09-25,LG4,Total,2989,14377,16715393,364370162048,59635918657,424006080705
2014-09-25,All-Floors,Staff,435,2985,2468899,97836845387,9746370187,107583215574
2014-09-25,All-Floors,TPG,807,13605,15123118,224118911220,52370419205,276489330425
2014-09-25,All-Floors,RPG,632,5418,6386894,100792013130,15147883513,115939896643
2014-09-25,All-Floors,UG,4894,45664,39953142,508776889250,57610664248,566387553498
2014-09-25,All-Floors,Alumni,24,313,325518,4839608135,284357097,5123965232
2014-09-25,All-Floors,Others(HKUST),31,779,1263488,16520617187,4561594794,21082211981
2014-09-25,All-Floors,Non-HKUST,80,418,509789,2821015793,185130703,3006146496
2014-09-25,All-Floors,Total,6903,69182,66030848,955705900102,139906419747,1095612319849
2014-09-26,1,Staff,62,539,623438,3626786760,343208604,3969995364
2014-09-26,1,TPG,127,1075,1774244,44238909203,7777668029,52016577232
2014-09-26,1,RPG,49,232,478901,15298314589,1564337188,16862651777
2014-09-26,1,UG,495,2725,3790155,117396714484,11535623570,128932338054
2014-09-26,1,Alumni,4,45,48994,443574406,81622795,525197201
2014-09-26,1,Others(HKUST),5,62,143374,8807453331,1258160148,10065613479
2014-09-26,1,Non-HKUST,5,20,65388,359176266,62518346,421694612
2014-09-26,1,Total,747,4698,6924494,190170929039,22623138680,212794067719
2014-09-26,G,Staff,129,771,579299,3380371952,373424679,3753796631
2014-09-26,G,TPG,389,2230,1746409,6238708929,403794304,6642503233
2014-09-26,G,RPG,193,910,692994,1098818758,214897143,1313715901
2014-09-26,G,UG,1622,6713,4534731,18017698739,1456610450,19474309189
2014-09-26,G,Alumni,4,7,608,36258,19158,55416
2014-09-26,G,Others(HKUST),11,79,100498,266103710,18957479,285061189
2014-09-26,G,Non-HKUST,23,70,78366,147458344,9279674,156738018
2014-09-26,G,Total,2371,10780,7732905,29149196690,2476982887,31626179577
2014-09-26,LG1,Staff,112,566,551124,883664508,50396262,934060770
2014-09-26,LG1,TPG,537,4359,4315862,19472284286,3951598054,23423882340
2014-09-26,LG1,RPG,251,1583,1671341,4876362306,2709270439,7585632745
2014-09-26,LG1,UG,2495,17487,16582884,65689918579,8689185009,74379103588
2014-09-26,LG1,Alumni,10,84,93442,3943786,1621968,5565754
2014-09-26,LG1,Others(HKUST),21,226,601530,263719769,147741308,411461077
2014-09-26,LG1,Non-HKUST,46,212,318466,976703560,57784233,1034487793
2014-09-26,LG1,Total,3472,24517,24134649,92166596794,15607597273,107774194067
2014-09-26,LG3,Staff,173,327,159014,3871866429,134879130,4006745559
2014-09-26,LG3,TPG,432,2473,3177883,78922763280,13540007132,92462770412
2014-09-26,LG3,RPG,268,787,893337,14802683239,1745487827,16548171066
2014-09-26,LG3,UG,1932,5089,3632394,113152209486,12043903342,125196112828
2014-09-26,LG3,Alumni,8,44,80187,1046024419,87112803,1133137222
2014-09-26,LG3,Others(HKUST),13,123,70669,858795646,64402977,923198623
2014-09-26,LG3,Non-HKUST,31,145,96514,15222185667,332955200,15555140867
2014-09-26,LG3,Total,2857,8988,8109998,227876528166,27948748411,255825276577
2014-09-26,LG4,Staff,126,274,213777,6060487380,375720975,6436208355
2014-09-26,LG4,TPG,392,4223,6232402,143335882359,19253618570,162589500929
2014-09-26,LG4,RPG,235,1086,1471388,36278519930,4606418643,40884938573
2014-09-26,LG4,UG,1824,6563,6768111,133998105259,12155435564,146153540823
2014-09-26,LG4,Alumni,7,45,66524,1789835028,89411951,1879246979
2014-09-26,LG4,Others(HKUST),19,259,360812,37012137890,16109269742,53121407632
2014-09-26,LG4,Non-HKUST,20,83,81066,116710726,36287268,152997994
2014-09-26,LG4,Total,2623,12533,15194080,358591678572,52626162713,411217841285
2014-09-26,All-Floors,Staff,386,2477,2126652,17823177029,1277629650,19100806679
2014-09-26,All-Floors,TPG,764,14360,17246800,292208548057,44926686089,337135234146
2014-09-26,All-Floors,RPG,572,4598,5207961,72354698822,10840411240,83195110062
2014-09-26,All-Floors,UG,4427,38577,35308275,448254646547,45880757935,494135404482
2014-09-26,All-Floors,Alumni,19,225,289755,3283413897,259788675,3543202572
2014-09-26,All-Floors,Others(HKUST),35,749,1276883,47208210346,17598531654,64806742000
2014-09-26,All-Floors,Non-HKUST,82,530,639800,16822234563,498824721,17321059284
2014-09-26,All-Floors,Total,6285,61516,62096126,897954929261,121282629964,1019237559225
2014-09-27,1,Staff,18,179,153546,6498314575,1086965836,7585280411
2014-09-27,1,TPG,59,412,861355,31815281468,4949593777,36764875245
2014-09-27,1,RPG,25,144,309109,24353869407,1581654508,25935523915
2014-09-27,1,UG,95,483,939364,32545364708,5663861813,38209226521
2014-09-27,1,Alumni,6,81,130943,4069621728,543557229,4613178957
2014-09-27,1,Others(HKUST),5,66,189450,6194300959,798618778,6992919737
2014-09-27,1,Non-HKUST,6,9,20038,324363792,21387332,345751124
2014-09-27,1,Total,214,1374,2603805,105801116637,14645639273,120446755910
2014-09-27,G,Staff,40,238,182586,3744150069,424280761,4168430830
2014-09-27,G,TPG,251,1225,1037299,12511019791,3201903869,15712923660
2014-09-27,G,RPG,92,412,538231,616433856,102394270,718828126
2014-09-27,G,UG,430,1437,1166443,1431755868,867321993,2299077861
2014-09-27,G,Alumni,18,66,28265,1682635837,289776020,1972411857
2014-09-27,G,Others(HKUST),9,102,128862,44733785,3651529,48385314
2014-09-27,G,Non-HKUST,16,57,22582,538901,152981,691882
2014-09-27,G,Total,856,3537,3104268,20031268107,4889481423,24920749530
2014-09-27,LG1,Staff,43,230,405799,37066812,6708817,43775629
2014-09-27,LG1,TPG,443,4379,5730774,5564024401,964969889,6528994290
2014-09-27,LG1,RPG,173,1269,1689937,2826015211,1883803970,4709819181
2014-09-27,LG1,UG,881,8049,10805236,20884405741,2093398473,22977804214
2014-09-27,LG1,Alumni,23,212,343750,51152721,6643546,57796267
2014-09-27,LG1,Others(HKUST),9,220,660710,105036171,36088273,141124444
2014-09-27,LG1,Non-HKUST,37,149,242917,124854321,3028392,127882713
2014-09-27,LG1,Total,1609,14508,19879123,29592555378,4994641360,34587196738
2014-09-27,LG3,Staff,61,109,89001,5453905990,1443085228,6896991218
2014-09-27,LG3,TPG,281,1277,1505962,32700369691,9777931883,42478301574
2014-09-27,LG3,RPG,155,530,632430,10579938088,4636024577,15215962665
2014-09-27,LG3,UG,709,1772,1449499,36516747809,15534928891,52051676700
2014-09-27,LG3,Alumni,13,38,20694,518454965,50286992,568741957
2014-09-27,LG3,Others(HKUST),13,140,59210,8558788116,358014387,8916802503
2014-09-27,LG3,Non-HKUST,26,89,103796,3190353275,521516026,3711869301
2014-09-27,LG3,Total,1258,3955,3860592,97518557934,32321787984,129840345918
2014-09-27,LG4,Staff,44,87,94120,1902135126,329485588,2231620714
2014-09-27,LG4,TPG,246,1664,2524499,41043607332,10285267966,51328875298
2014-09-27,LG4,RPG,130,478,792060,12469636581,1042406498,13512043079
2014-09-27,LG4,UG,606,1967,2324376,48168868506,4878757758,53047626264
2014-09-27,LG4,Alumni,21,176,250601,4702913712,215888589,4918802301
2014-09-27,LG4,Others(HKUST),12,168,359917,16642857180,5048688607,21691545787
2014-09-27,LG4,Non-HKUST,23,50,87401,1924985597,143609725,2068595322
2014-09-27,LG4,Total,1082,4590,6432974,126855004034,21944104731,148799108765
2014-09-27,All-Floors,Staff,129,843,925052,17635572572,3290526230,20926098802
2014-09-27,All-Floors,TPG,620,8957,11659889,123634302683,29179667384,152813970067
2014-09-27,All-Floors,RPG,350,2833,3961767,50845893143,9246283823,60092176966
2014-09-27,All-Floors,UG,1557,13708,16684918,139547142632,29038268928,168585411560
2014-09-27,All-Floors,Alumni,45,573,774253,11024778963,1106152376,12130931339
2014-09-27,All-Floors,Others(HKUST),24,696,1398149,31545716211,6245061574,37790777785
2014-09-27,All-Floors,Non-HKUST,70,354,476734,5565095886,689694456,6254790342
2014-09-27,All-Floors,Total,2795,27964,35880762,379798502090,78795654771,458594156861
2014-09-28,1,Staff,10,126,99811,6672185349,934782480,7606967829
2014-09-28,1,TPG,80,592,1170797,26680717465,4628118861,31308836326
2014-09-28,1,RPG,27,157,293280,8112421437,561543391,8673964828
2014-09-28,1,UG,96,791,1477729,50207757133,16195156636,66402913769
2014-09-28,1,Alumni,6,35,133079,4763766176,2724243185,7488009361
2014-09-28,1,Others(HKUST),4,55,195006,1678914871,112755550,1791670421
2014-09-28,1,Non-HKUST,5,16,31083,68241814,12598988,80840802
2014-09-28,1,Total,228,1772,3400785,98184004245,25169199091,123353203336
2014-09-28,G,Staff,30,157,168305,14664617,3266508,17931125
2014-09-28,G,TPG,273,1824,1540519,12711363253,3851104174,16562467427
2014-09-28,G,RPG,122,560,534132,474085769,116378755,590464524
2014-09-28,G,UG,371,1638,1622146,4324253694,599890832,4924144526
2014-09-28,G,Alumni,30,127,140414,1950125603,72458196,2022583799
2014-09-28,G,Others(HKUST),6,62,114789,516761295,24866338,541627633
2014-09-28,G,Non-HKUST,22,119,122156,3499943,915055,4414998
2014-09-28,G,Total,854,4487,4242461,19994754174,4668879858,24663634032
2014-09-28,LG1,Staff,32,271,396775,7305478,1619867,8925345
2014-09-28,LG1,TPG,433,5688,6389088,12043232199,1369532131,13412764330
2014-09-28,LG1,RPG,179,1505,1968663,3726101573,583526988,4309628561
2014-09-28,LG1,UG,942,11925,14266957,27891541714,3732211460,31623753174
2014-09-28,LG1,Alumni,23,185,150764,195584043,25435627,221019670
2014-09-28,LG1,Others(HKUST),8,222,671629,288287355,152963732,441251087
2014-09-28,LG1,Non-HKUST,39,201,207066,249116972,102185654,351302626
2014-09-28,LG1,Total,1656,19997,24050942,44401169334,5967475459,50368644793
2014-09-28,LG3,Staff,58,97,80564,5317465179,1412907370,6730372549
2014-09-28,LG3,TPG,286,1835,2332979,93802762137,44382506790,138185268927
2014-09-28,LG3,RPG,189,707,857225,27232058079,2195430425,29427488504
2014-09-28,LG3,UG,607,2556,2245156,47057822248,8252257810,55310080058
2014-09-28,LG3,Alumni,24,62,48617,205772139,28353089,234125228
2014-09-28,LG3,Others(HKUST),9,130,44502,108791703,7265133,116056836
2014-09-28,LG3,Non-HKUST,18,62,67130,4407435302,196814928,4604250230
2014-09-28,LG3,Total,1191,5449,5676173,178132106787,56475535545,234607642332
2014-09-28,LG4,Staff,24,125,163158,631600503,64997784,696598287
2014-09-28,LG4,TPG,240,2937,4076744,93244774448,24250897918,117495672366
2014-09-28,LG4,RPG,141,796,1100151,54573560298,4246559205,58820119503
2014-09-28,LG4,UG,510,3126,4164172,124848275529,14228858471,139077134000
2014-09-28,LG4,Alumni,27,201,356932,8187600697,749177806,8936778503
2014-09-28,LG4,Others(HKUST),7,133,331013,18832732306,5153474824,23986207130
2014-09-28,LG4,Non-HKUST,23,201,446858,27742998081,1958676890,29701674971
2014-09-28,LG4,Total,972,7519,10639028,328061541862,50652642898,378714184760
2014-09-28,All-Floors,Staff,104,776,908613,12643221126,2417574009,15060795135
2014-09-28,All-Floors,TPG,524,12876,15510127,238482849502,78482159874,316965009376
2014-09-28,All-Floors,RPG,353,3725,4753451,94118227156,7703438764,101821665920
2014-09-28,All-Floors,UG,1321,20036,23776160,254329650318,43008375209,297338025527
2014-09-28,All-Floors,Alumni,56,610,829806,15302848658,3599667903,18902516561
2014-09-28,All-Floors,Others(HKUST),13,602,1356939,21425487530,5451325577,26876813107
2014-09-28,All-Floors,Non-HKUST,56,599,874293,32471292112,2271191515,34742483627
2014-09-28,All-Floors,Total,2427,39224,48009389,668773576402,142933732851,811707309253
2014-09-29,1,Staff,62,699,802355,5048802029,2427030358,7475832387
2014-09-29,1,TPG,123,1061,1608465,38186235929,4484643165,42670879094
2014-09-29,1,RPG,48,264,398146,13039299937,1866922795,14906222732
2014-09-29,1,UG,478,2848,3816294,114539382586,18463388558,133002771144
2014-09-29,1,Alumni,2,13,9361,34745357,8292233,43037590
2014-09-29,1,Others(HKUST),7,85,169853,1318249140,144037198,1462286338
2014-09-29,1,Non-HKUST,8,29,55800,1144513684,850756580,1995270264
2014-09-29,1,Total,728,4999,6860274,173311228662,28245070887,201556299549
2014-09-29,G,Staff,127,765,595206,745425012,702378181,1447803193
2014-09-29,G,TPG,411,2484,1588803,7400661993,1124291841,8524953834
2014-09-29,G,RPG,201,957,818871,33623679786,1264269639,34887949425
2014-09-29,G,UG,1570,7800,4962314,9565118413,1391512090,10956630503
2014-09-29,G,Alumni,9,26,6958,0,0,0
2014-09-29,G,Others(HKUST),17,91,122774,208085907,86113515,294199422
2014-09-29,G,Non-HKUST,32,141,109622,299125579,23466987,322592566
2014-09-29,G,Total,2367,12264,8204548,51842096690,4592032253,56434128943
2014-09-29,LG1,Staff,123,693,554501,935553125,64096843,999649968
2014-09-29,LG1,TPG,539,5139,4561081,14548209019,3135115248,17683324267
2014-09-29,LG1,RPG,255,1694,1841913,2243558475,531511641,2775070116
2014-09-29,LG1,UG,2324,21565,19108911,55504785431,10876915678,66381701109
2014-09-29,LG1,Alumni,14,78,68131,4432062824,244287692,4676350516
2014-09-29,LG1,Others(HKUST),19,290,632635,269377546,149674376,419051922
2014-09-29,LG1,Non-HKUST,69,350,336230,552677570,87896292,640573862
2014-09-29,LG1,Total,3343,29809,27103402,78486223990,15089497770,93575721760
2014-09-29,LG3,Staff,210,457,259118,5355873360,459760043,5815633403
2014-09-29,LG3,TPG,435,2525,2673211,84431261489,16099378312,100530639801
2014-09-29,LG3,RPG,270,978,956066,22093987741,1867099092,23961086833
2014-09-29,LG3,UG,1760,5650,4215973,82659757669,9705984731,92365742400
2014-09-29,LG3,Alumni,10,31,74172,520306666,45158325,565464991
2014-09-29,LG3,Others(HKUST),16,140,75258,222927514,47521518,270449032
2014-09-29,LG3,Non-HKUST,34,73,81715,721047415,142476977,863524392
2014-09-29,LG3,Total,2735,9854,8335513,196005161854,28367378998,224372540852
2014-09-29,LG4,Staff,145,341,245153,14646863894,560436970,15207300864
2014-09-29,LG4,TPG,398,3939,5708665,135655332853,22155238262,157810571115
2014-09-29,LG4,RPG,228,1471,1849432,58724041484,4454779521,63178821005
2014-09-29,LG4,UG,1533,6578,7162381,161303433954,16434753262,177738187216
2014-09-29,LG4,Alumni,8,118,185253,4676515672,322544645,4999060317
2014-09-29,LG4,Others(HKUST),19,269,300650,21392113204,6545336085,27937449289
2014-09-29,LG4,Non-HKUST,19,131,200342,1459498494,323987456,1783485950
2014-09-29,LG4,Total,2350,12847,15651876,397857799555,50797076201,448654875756
2014-09-29,All-Floors,Staff,432,2955,2456333,26732517420,4213702395,30946219815
2014-09-29,All-Floors,TPG,797,15148,16140225,280221701283,46998666828,327220368111
2014-09-29,All-Floors,RPG,570,5364,5864428,129724567423,9984582688,139709150111
2014-09-29,All-Floors,UG,3860,44441,39265873,423572478053,56872554319,480445032372
2014-09-29,All-Floors,Alumni,19,266,343875,9663630519,620282895,10283913414
2014-09-29,All-Floors,Others(HKUST),33,875,1301170,23410753311,6972682692,30383436003
2014-09-29,All-Floors,Non-HKUST,95,724,783709,4176862742,1428584292,5605447034
2014-09-29,All-Floors,Total,5806,69773,66155613,897502510751,127091056109,1024593566860
2014-09-30,1,Staff,62,594,740626,11794083188,1487748877,13281832065
2014-09-30,1,TPG,123,1144,1704216,46977670633,4556284753,51533955386
2014-09-30,1,RPG,43,170,315184,9008227165,1363426424,10371653589
2014-09-30,1,UG,388,2186,2649118,106934245750,12006104215,118940349965
2014-09-30,1,Alumni,2,18,9815,36236431,6267765,42504196
2014-09-30,1,Others(HKUST),6,82,111274,32249856778,1405358746,33655215524
2014-09-30,1,Non-HKUST,6,15,38283,997423566,56566499,1053990065
2014-09-30,1,Total,630,4209,5568516,207997743511,20881757279,228879500790
2014-09-30,G,Staff,122,713,651451,2612587434,216015635,2828603069
2014-09-30,G,TPG,385,2397,1402565,6430197298,1412977511,7843174809
2014-09-30,G,RPG,163,711,595402,1142724877,109153392,1251878269
2014-09-30,G,UG,1349,6250,3990752,10087716375,776468478,10864184853
2014-09-30,G,Alumni,7,36,17592,100323979,9756129,110080108
2014-09-30,G,Others(HKUST),14,109,115436,238864993,27654669,266519662
2014-09-30,G,Non-HKUST,19,60,52316,655709045,51051821,706760866
2014-09-30,G,Total,2059,10276,6825514,21268124001,2603077635,23871201636
2014-09-30,LG1,Staff,124,565,510164,492414910,49977952,542392862
2014-09-30,LG1,TPG,501,3967,3723448,7441176261,1556372386,8997548647
2014-09-30,LG1,RPG,226,1576,1619101,13431277587,1745082910,15176360497
2014-09-30,LG1,UG,2057,16301,14565458,36076235378,8788720470,44864955848
2014-09-30,LG1,Alumni,15,105,105791,10264950956,317353320,10582304276
2014-09-30,LG1,Others(HKUST),16,199,572052,573271612,99621753,672893365
2014-09-30,LG1,Non-HKUST,38,151,134406,21733595,6768630,28502225
2014-09-30,LG1,Total,2977,22864,21230420,68301060299,12563897421,80864957720
2014-09-30,LG3,Staff,216,493,213110,3101272563,346511941,3447784504
2014-09-30,LG3,TPG,404,2034,2390198,46248483477,7605978923,53854462400
2014-09-30,LG3,RPG,241,916,802122,35307743653,2917581718,38225325371
2014-09-30,LG3,UG,1678,4610,3116509,80336945257,11443109926,91780055183
2014-09-30,LG3,Alumni,7,56,73343,2093005737,142354786,2235360523
2014-09-30,LG3,Others(HKUST),16,147,58219,739722874,42414339,782137213
2014-09-30,LG3,Non-HKUST,25,59,78850,1372623431,215400864,1588024295
2014-09-30,LG3,Total,2587,8315,6732351,169199796992,22713352497,191913149489
2014-09-30,LG4,Staff,147,388,269089,3771395935,327206116,4098602051
2014-09-30,LG4,TPG,374,3575,4542948,100609643669,11367188546,111976832215
2014-09-30,LG4,RPG,216,1029,1422560,36825937633,3614291660,40440229293
2014-09-30,LG4,UG,1410,5331,5346612,141937580876,13598239099,155535819975
2014-09-30,LG4,Alumni,7,28,51883,2267575105,186872491,2454447596
2014-09-30,LG4,Others(HKUST),14,252,339966,10403830518,2022637935,12426468453
2014-09-30,LG4,Non-HKUST,21,87,153452,711745257,42981685,754726942
2014-09-30,LG4,Total,2189,10690,12126510,296527708993,31159417532,327687126525
2014-09-30,All-Floors,Staff,405,2753,2384440,21771754030,2427460521,24199214551
2014-09-30,All-Floors,TPG,759,13117,13763375,207707171338,26498802119,234205973457
2014-09-30,All-Floors,RPG,502,4402,4754369,95715910915,9749536104,105465447019
2014-09-30,All-Floors,UG,3600,34678,29668449,375372723636,46612642188,421985365824
2014-09-30,All-Floors,Alumni,21,243,258424,14762092208,662604491,15424696699
2014-09-30,All-Floors,Others(HKUST),32,789,1196947,44205546775,3597687442,47803234217
2014-09-30,All-Floors,Non-HKUST,66,372,457307,3759234894,372769499,4132004393
2014-09-30,All-Floors,Total,5385,56354,52483311,763294433796,89921502364,853215936160