Date,Floor,User-Group,User-Count,WiFi-Conn,Duration-Sec,Traffic-In-Byte,Traffic-Out-Byte,Traffic-Both-Byte
2015-08-01,1,Staff,17,107,327360,12340806457,2213405205,14554211662
2015-08-01,1,TPG,15,170,278186,16583780565,863592152,17447372717
2015-08-01,1,RPG,23,156,238617,12428646805,1594927089,14023573894
2015-08-01,1,UG,33,190,294060,18544735965,1762177431,20306913396
2015-08-01,1,Alumni,3,28,98833,30605437650,1206966418,31812404068
2015-08-01,1,Others(HKUST),8,107,176435,697726878,55052861,752779739
2015-08-01,1,Non-HKUST,1,1,837,49777,25785,75562
2015-08-01,1,Total,100,759,1414328,91201184097,7696146941,98897331038
2015-08-01,G,Staff,42,235,237008,14374451571,1375341603,15749793174
2015-08-01,G,TPG,74,369,276078,30513629403,2140972682,32654602085
2015-08-01,G,RPG,93,604,611252,37504004399,4495140158,41999144557
2015-08-01,G,UG,193,872,789319,23144811941,3583201708,26728013649
2015-08-01,G,Alumni,33,129,135833,18817548936,1303137462,20120686398
2015-08-01,G,Others(HKUST),24,124,228421,2945839325,308262877,3254102202
2015-08-01,G,Non-HKUST,18,71,43619,936488152,193094298,1129582450
2015-08-01,G,Total,477,2404,2321530,128236773727,13399150788,141635924515
2015-08-01,LG1,Staff,32,239,198421,6203626965,562468404,6766095369
2015-08-01,LG1,TPG,76,743,652038,114062591972,16174233754,130236825726
2015-08-01,LG1,RPG,92,1038,937914,89025254621,8970589400,97995844021
2015-08-01,LG1,UG,204,2158,2093098,113326368961,18697492333,132023861294
2015-08-01,LG1,Alumni,26,202,192427,18980252338,1077204330,20057456668
2015-08-01,LG1,Others(HKUST),12,107,491362,7465684872,967010010,8432694882
2015-08-01,LG1,Non-HKUST,15,94,112666,7781230341,864857455,8646087796
2015-08-01,LG1,Total,457,4581,4677926,356845010070,47313855686,404158865756
2015-08-01,LG3,Staff,36,145,139101,1797987510,148902208,1946889718
2015-08-01,LG3,TPG,40,192,211344,11969445099,1050650807,13020095906
2015-08-01,LG3,RPG,60,382,425749,24108417972,1694561786,25802979758
2015-08-01,LG3,UG,140,437,469193,53401197233,3806553399,57207750632
2015-08-01,LG3,Alumni,21,138,186457,12993779995,12218973823,25212753818
2015-08-01,LG3,Others(HKUST),12,96,134605,3223288793,139721949,3363010742
2015-08-01,LG3,Non-HKUST,16,134,199693,20459339424,2374749567,22834088991
2015-08-01,LG3,Total,325,1524,1766142,127953456026,21434113539,149387569565
2015-08-01,LG4,Staff,33,167,147407,4016499966,343313646,4359813612
2015-08-01,LG4,TPG,30,104,65592,4037869029,515455190,4553324219
2015-08-01,LG4,RPG,94,579,599238,42765171323,6538726187,49303897510
2015-08-01,LG4,UG,176,588,547574,28166671148,2638920257,30805591405
2015-08-01,LG4,Alumni,21,387,412885,55260459920,68368382920,123628842840
2015-08-01,LG4,Others(HKUST),17,209,380308,26511223147,2398217269,28909440416
2015-08-01,LG4,Non-HKUST,13,124,106853,23262980516,1146525710,24409506226
2015-08-01,LG4,Total,384,2158,2259857,184020875049,81949541179,265970416228
2015-08-01,All-Floors,Staff,101,893,1049297,38733372469,4643431066,43376803535
2015-08-01,All-Floors,TPG,129,1578,1483238,177167316068,20744904585,197912220653
2015-08-01,All-Floors,RPG,214,2759,2812770,205831495120,23293944620,229125439740
2015-08-01,All-Floors,UG,467,4245,4193244,236583785248,30488345128,267072130376
2015-08-01,All-Floors,Alumni,50,884,1026435,136657478839,84174664953,220832143792
2015-08-01,All-Floors,Others(HKUST),35,643,1411131,40843763015,3868264966,44712027981
2015-08-01,All-Floors,Non-HKUST,35,424,463668,52440088210,4579252815,57019341025
2015-08-01,All-Floors,Total,1031,11426,12439783,888257298969,171792808133,1060050107102
2015-08-02,1,Staff,10,67,210001,3745444817,777955064,4523399881
2015-08-02,1,TPG,12,103,169332,4199545755,916899686,5116445441
2015-08-02,1,RPG,12,52,76102,3697240564,348405342,4045645906
2015-08-02,1,UG,27,102,266243,14618977896,1559996624,16178974520
2015-08-02,1,Alumni,6,34,55451,5013698941,238906329,5252605270
2015-08-02,1,Others(HKUST),4,118,155128,441755592,52125334,493880926
2015-08-02,1,Non-HKUST,6,11,22818,2032035508,162282487,2194317995
2015-08-02,1,Total,77,487,955075,33748699073,4056570866,37805269939
2015-08-02,G,Staff,28,146,182056,4817448507,1072939137,5890387644
2015-08-02,G,TPG,61,346,368956,27840415216,2088245699,29928660915
2015-08-02,G,RPG,73,369,357199,10685583128,772571997,11458155125
2015-08-02,G,UG,155,762,618074,28511469418,6359154384,34870623802
2015-08-02,G,Alumni,34,131,90930,15702775681,877069047,16579844728
2015-08-02,G,Others(HKUST),8,108,226903,4917168695,477982297,5395150992
2015-08-02,G,Non-HKUST,9,25,14450,2893033221,129724763,3022757984
2015-08-02,G,Total,368,1887,1858568,95367893866,11777687324,107145581190
2015-08-02,LG1,Staff,27,112,92118,2078696361,227622262,2306318623
2015-08-02,LG1,TPG,48,541,648255,133062524716,8029616549,141092141265
2015-08-02,LG1,RPG,56,423,525161,62101517531,3596489599,65698007130
2015-08-02,LG1,UG,161,1297,1525299,95207954322,26135109543,121343063865
2015-08-02,LG1,Alumni,28,234,312585,12516357007,4338545804,16854902811
2015-08-02,LG1,Others(HKUST),8,122,525689,10754492619,766283849,11520776468
2015-08-02,LG1,Non-HKUST,5,30,6357,203586308,36436602,240022910
2015-08-02,LG1,Total,333,2759,3635464,315925128864,43130104208,359055233072
2015-08-02,LG3,Staff,27,52,126348,1448972869,73693563,1522666432
2015-08-02,LG3,TPG,26,79,52506,6527757927,371532722,6899290649
2015-08-02,LG3,RPG,49,219,315661,25375026518,1614401289,26989427807
2015-08-02,LG3,UG,133,360,310061,27130660237,2429231664,29559891901
2015-08-02,LG3,Alumni,22,151,156239,9473991338,1964846887,11438838225
2015-08-02,LG3,Others(HKUST),6,58,118115,193542459,43445275,236987734
2015-08-02,LG3,Non-HKUST,8,70,24814,299491337,45327582,344818919
2015-08-02,LG3,Total,271,989,1103744,70449442685,6542478982,76991921667
2015-08-02,LG4,Staff,30,123,136119,8489915163,559207656,9049122819
2015-08-02,LG4,TPG,24,70,15443,1194222106,297927047,1492149153
2015-08-02,LG4,RPG,83,325,277599,11835395569,1178521889,13013917458
2015-08-02,LG4,UG,167,671,615936,48033629363,9510684892,57544314255
2015-08-02,LG4,Alumni,24,227,302719,40164329977,4190688525,44355018502
2015-08-02,LG4,Others(HKUST),11,92,193888,27714665705,1993511649,29708177354
2015-08-02,LG4,Non-HKUST,8,26,26714,2086070025,92899742,2178969767
2015-08-02,LG4,Total,347,1534,1568418,139518227908,17823441400,157341669308
2015-08-02,All-Floors,Staff,85,500,746642,20580477717,2711417682,23291895399
2015-08-02,All-Floors,TPG,100,1139,1254492,172824465720,11704221703,184528687423
2015-08-02,All-Floors,RPG,176,1388,1551722,113694763310,7510390116,121205153426
2015-08-02,All-Floors,UG,390,3192,3335613,213502691236,45994177107,259496868343
2015-08-02,All-Floors,Alumni,59,777,917924,82871152944,11610056592,94481209536
2015-08-02,All-Floors,Others(HKUST),20,498,1219723,44021625070,3333348404,47354973474
2015-08-02,All-Floors,Non-HKUST,19,162,95153,7514216399,466671176,7980887575
2015-08-02,All-Floors,Total,849,7656,9121269,655009392396,83330282780,738339675176
2015-08-03,1,Staff,74,596,1050945,8629827481,1805134986,10434962467
2015-08-03,1,TPG,23,233,396161,18697399533,1869653023,20567052556
2015-08-03,1,RPG,39,369,536604,29889618476,2206607677,32096226153
2015-08-03,1,UG,56,456,716015,28999374323,27916843052,56916217375
2015-08-03,1,Alumni,2,34,25660,1320828910,92862296,1413691206
2015-08-03,1,Others(HKUST),7,172,223834,899628266,238735782,1138364048
2015-08-03,1,Non-HKUST,8,24,28820,2653555325,129318351,2782873676
2015-08-03,1,Total,209,1884,2978039,91090232314,34259155167,125349387481
2015-08-03,G,Staff,172,983,826203,22120881472,2563707312,24684588784
2015-08-03,G,TPG,91,701,535865,32381577710,4259730512,36641308222
2015-08-03,G,RPG,166,985,703296,48550869883,5111950235,53662820118
2015-08-03,G,UG,301,1464,1107708,101116548014,6645453216,107762001230
2015-08-03,G,Alumni,11,104,113892,4256903247,8908922311,13165825558
2015-08-03,G,Others(HKUST),19,127,282472,5428905521,505582546,5934488067
2015-08-03,G,Non-HKUST,47,105,65273,2425938398,162751941,2588690339
2015-08-03,G,Total,807,4469,3634709,216281624245,28158098073,244439722318
2015-08-03,LG1,Staff,107,592,419218,20623478289,2153655969,22777134258
2015-08-03,LG1,TPG,71,1040,955862,227840331963,24064065431,251904397394
2015-08-03,LG1,RPG,147,1609,1564465,131416024486,9112529439,140528553925
2015-08-03,LG1,UG,378,3509,3397497,230136509255,22196815909,252333325164
2015-08-03,LG1,Alumni,10,114,97859,2409462016,389955399,2799417415
2015-08-03,LG1,Others(HKUST),11,182,549516,4919709035,891615575,5811324610
2015-08-03,LG1,Non-HKUST,47,197,146340,9781202161,1230000640,11011202801
2015-08-03,LG1,Total,771,7243,7130757,627126717205,60038638362,687165355567
2015-08-03,LG3,Staff,92,289,276499,4774121837,672824427,5446946264
2015-08-03,LG3,TPG,33,167,167628,23749436617,1020686267,24770122884
2015-08-03,LG3,RPG,117,664,831411,40025681429,3694976510,43720657939
2015-08-03,LG3,UG,188,647,553111,26456093333,3501110879,29957204212
2015-08-03,LG3,Alumni,7,41,44878,1230549904,551285047,1781834951
2015-08-03,LG3,Others(HKUST),10,64,106102,1286024660,93792939,1379817599
2015-08-03,LG3,Non-HKUST,27,134,150151,7133500858,1794799961,8928300819
2015-08-03,LG3,Total,474,2006,2129780,104655408638,11329476030,115984884668
2015-08-03,LG4,Staff,146,388,304799,35684706728,1405312862,37090019590
2015-08-03,LG4,TPG,24,150,206611,10987561073,1226469687,12214030760
2015-08-03,LG4,RPG,145,690,614874,67283337160,4886199775,72169536935
2015-08-03,LG4,UG,251,946,927198,43060815564,5616031260,48676846824
2015-08-03,LG4,Alumni,9,93,71319,3629599519,690622085,4320221604
2015-08-03,LG4,Others(HKUST),22,215,210965,11940457878,1001627562,12942085440
2015-08-03,LG4,Non-HKUST,36,120,146978,4819768811,817777453,5637546264
2015-08-03,LG4,Total,633,2602,2482744,177406246733,15644040684,193050287417
2015-08-03,All-Floors,Staff,355,2848,2877664,91833015807,8600635556,100433651363
2015-08-03,All-Floors,TPG,134,2291,2262127,313656306896,32440604920,346096911816
2015-08-03,All-Floors,RPG,344,4317,4250650,317165531434,25012263636,342177795070
2015-08-03,All-Floors,UG,721,7022,6701529,429769340489,65876254316,495645594805
2015-08-03,All-Floors,Alumni,23,386,353608,12847343596,10633647138,23480990734
2015-08-03,All-Floors,Others(HKUST),37,760,1372889,24474725360,2731354404,27206079764
2015-08-03,All-Floors,Non-HKUST,92,580,537562,26813965553,4134648346,30948613899
2015-08-03,All-Floors,Total,1706,18204,18356029,1216560229135,149429408316,1365989637451
2015-08-04,1,Staff,49,200,823294,7291736347,2399874210,9691610557
2015-08-04,1,TPG,12,53,159451,10766057573,993492082,11759549655
2015-08-04,1,RPG,28,115,314921,15174818045,2413081189,17587899234
2015-08-04,1,UG,31,134,284616,16008884926,1006328458,17015213384
2015-08-04,1,Alumni,0,0,0,0,0,0
2015-08-04,1,Others(HKUST),5,63,112659,233406619,12737465,246144084
2015-08-04,1,Non-HKUST,4,5,6594,401270162,21340316,422610478
2015-08-04,1,Total,129,570,1701535,49876173672,6846853720,56723027392
2015-08-04,G,Staff,89,294,633241,11410989077,1026361055,12437350132
2015-08-04,G,TPG,42,157,179341,5005750498,918361890,5924112388
2015-08-04,G,RPG,82,209,335848,19833163019,1916732219,21749895238
2015-08-04,G,UG,158,418,516765,33297549307,3207409888,36504959195
2015-08-04,G,Alumni,3,9,15127,268698688,21998247,290696935
2015-08-04,G,Others(HKUST),14,68,169346,4611902036,1195923133,5807825169
2015-08-04,G,Non-HKUST,15,29,25435,294085358,32315262,326400620
2015-08-04,G,Total,403,1184,1875103,74722137983,8319101694,83041239677
2015-08-04,LG1,Staff,58,161,255963,16394895581,1111171376,17506066957
2015-08-04,LG1,TPG,41,344,563051,96147285734,9120282682,105267568416
2015-08-04,LG1,RPG,100,576,1103807,113116993387,7694090681,120811084068
2015-08-04,LG1,UG,184,812,1432982,103359678401,25907424567,129267102968
2015-08-04,LG1,Alumni,5,30,82844,420648479,64079294,484727773
2015-08-04,LG1,Others(HKUST),16,58,522187,1340302249,484135477,1824437726
2015-08-04,LG1,Non-HKUST,27,87,94016,3803799007,528272615,4332071622
2015-08-04,LG1,Total,431,2068,4054850,334583602838,44909456692,379493059530
2015-08-04,LG3,Staff,52,119,159445,3280111976,160281960,3440393936
2015-08-04,LG3,TPG,11,47,107266,11164276966,654055663,11818332629
2015-08-04,LG3,RPG,59,248,546906,28671585814,11285532312,39957118126
2015-08-04,LG3,UG,78,196,270163,15211718375,1033965621,16245683996
2015-08-04,LG3,Alumni,9,31,55517,1365957825,192067112,1558024937
2015-08-04,LG3,Others(HKUST),11,33,72566,4765757030,265589125,5031346155
2015-08-04,LG3,Non-HKUST,15,52,79479,4385372986,459770680,4845143666
2015-08-04,LG3,Total,235,726,1291342,68844780972,14051262473,82896043445
2015-08-04,LG4,Staff,60,106,137415,5727570135,271683061,5999253196
2015-08-04,LG4,TPG,13,50,103938,5991489058,527926406,6519415464
2015-08-04,LG4,RPG,54,173,256523,26515277820,1533061948,28048339768
2015-08-04,LG4,UG,80,232,307644,19527914851,1952384146,21480298997
2015-08-04,LG4,Alumni,7,36,108843,5982148569,335629685,6317778254
2015-08-04,LG4,Others(HKUST),11,75,134427,35446601022,2498215237,37944816259
2015-08-04,LG4,Non-HKUST,21,64,56708,6068338537,375818505,6444157042
2015-08-04,LG4,Total,246,736,1105498,105259339992,7494718988,112754058980
2015-08-04,All-Floors,Staff,217,880,2009358,44105303116,4969371662,49074674778
2015-08-04,All-Floors,TPG,89,651,1113047,129074859829,12214118723,141288978552
2015-08-04,All-Floors,RPG,241,1321,2558005,203311838085,24842498349,228154336434
2015-08-04,All-Floors,UG,397,1792,2812170,187405745860,33107512680,220513258540
2015-08-04,All-Floors,Alumni,18,106,262331,8037453561,613774338,8651227899
2015-08-04,All-Floors,Others(HKUST),36,297,1011185,46397968956,4456600437,50854569393
2015-08-04,All-Floors,Non-HKUST,57,237,262232,14952866050,1417517378,16370383428
2015-08-04,All-Floors,Total,1055,5284,10028328,633286035457,81621393567,714907429024
2015-08-05,1,Staff,72,596,1050975,16559889465,2628020819,19187910284
2015-08-05,1,TPG,18,308,495940,78444886763,5781232496,84226119259
2015-08-05,1,RPG,32,296,496258,59457383329,42192784448,101650167777
2015-08-05,1,UG,41,231,375943,45659098350,2572078809,48231177159
2015-08-05,1,Alumni,3,4,246,2287810,98310,2386120
2015-08-05,1,Others(HKUST),11,121,212977,11332722436,508691662,11841414098
2015-08-05,1,Non-HKUST,8,21,36625,2165969116,142281755,2308250871
2015-08-05,1,Total,185,1577,2668964,213622237269,53825188299,267447425568
2015-08-05,G,Staff,157,852,822246,23317264448,2625259629,25942524077
2015-08-05,G,TPG,66,480,357842,22008886715,2665825398,24674712113
2015-08-05,G,RPG,156,790,697889,49297791877,10777370217,60075162094
2015-08-05,G,UG,265,1844,1430361,102348293381,15936361979,118284655360
2015-08-05,G,Alumni,14,148,154017,10707778970,3856479205,14564258175
2015-08-05,G,Others(HKUST),33,204,274582,10668548134,1221384135,11889932269
2015-08-05,G,Non-HKUST,48,271,153448,17884599767,1657300311,19541900078
2015-08-05,G,Total,739,4589,3890385,236233163292,38739980874,274973144166
2015-08-05,LG1,Staff,126,773,736724,22772726947,2093421739,24866148686
2015-08-05,LG1,TPG,66,1076,1118166,85750869743,13178138391,98929008134
2015-08-05,LG1,RPG,157,1630,2151647,171322069398,18693926884,190015996282
2015-08-05,LG1,UG,331,2928,3128574,171516575776,18663046495,190179622271
2015-08-05,LG1,Alumni,14,95,118181,6470741519,477876464,6948617983
2015-08-05,LG1,Others(HKUST),23,222,666724,10048300901,3408084297,13456385198
2015-08-05,LG1,Non-HKUST,39,206,120247,11425901912,662658285,12088560197
2015-08-05,LG1,Total,756,6930,8040263,479307186196,57177152555,536484338751
2015-08-05,LG3,Staff,88,301,279221,7802234591,469975389,8272209980
2015-08-05,LG3,TPG,43,225,343133,28115478269,1568583284,29684061553
2015-08-05,LG3,RPG,112,745,852840,55103863652,5471346538,60575210190
2015-08-05,LG3,UG,197,663,587748,32380171042,6881866137,39262037179
2015-08-05,LG3,Alumni,15,123,117145,13398345828,944116415,14342462243
2015-08-05,LG3,Others(HKUST),20,131,201895,7936392786,493891497,8430284283
2015-08-05,LG3,Non-HKUST,29,95,69321,3026149540,272154665,3298304205
2015-08-05,LG3,Total,504,2283,2451303,147762635708,16101933925,163864569633
2015-08-05,LG4,Staff,142,445,267607,12382254402,1349040198,13731294600
2015-08-05,LG4,TPG,28,223,276039,14851372926,1077268471,15928641397
2015-08-05,LG4,RPG,175,727,605575,48226249579,3096996133,51323245712
2015-08-05,LG4,UG,238,1010,966386,116562369959,7848677807,124411047766
2015-08-05,LG4,Alumni,17,284,290066,30539123718,32124302427,62663426145
2015-08-05,LG4,Others(HKUST),32,280,305048,37017720161,2583139576,39600859737
2015-08-05,LG4,Non-HKUST,33,200,154310,6442741509,648552900,7091294409
2015-08-05,LG4,Total,665,3169,2865031,266021832254,48727977512,314749809766
2015-08-05,All-Floors,Staff,351,2967,3156773,82834369853,9165717774,92000087627
2015-08-05,All-Floors,TPG,112,2312,2591120,229171494416,24271048040,253442542456
2015-08-05,All-Floors,RPG,366,4188,4804209,383407357835,80232424220,463639782055
2015-08-05,All-Floors,UG,647,6676,6489012,468466508508,51902031227,520368539735
2015-08-05,All-Floors,Alumni,33,654,679655,61118277845,37402872821,98521150666
2015-08-05,All-Floors,Others(HKUST),63,958,1661226,77003684418,8215191167,85218875585
2015-08-05,All-Floors,Non-HKUST,86,793,533951,40945361844,3382947916,44328309760
2015-08-05,All-Floors,Total,1658,18548,19915946,1342947054719,214572233165,1557519287884
2015-08-06,1,Staff,76,676,1052925,11042896213,3873377680,14916273893
2015-08-06,1,TPG,12,103,148068,16025144017,830246512,16855390529
2015-08-06,1,RPG,30,244,408299,32993146669,3178063835,36171210504
2015-08-06,1,UG,53,386,509090,25617865674,2032976203,27650841877
2015-08-06,1,Alumni,1,37,28295,887666781,111335328,999002109
2015-08-06,1,Others(HKUST),10,82,171241,966188233,238374878,1204563111
2015-08-06,1,Non-HKUST,6,14,41880,3523364327,723311770,4246676097
2015-08-06,1,Total,188,1542,2359798,91056271914,10987686206,102043958120
2015-08-06,G,Staff,146,890,751137,21995056401,3358843272,25353899673
2015-08-06,G,TPG,61,405,309332,13030270945,1212773854,14243044799
2015-08-06,G,RPG,143,971,789255,42676535965,6044882547,48721418512
2015-08-06,G,UG,258,1602,1077854,73266887718,6387175993,79654063711
2015-08-06,G,Alumni,10,33,53851,313956633,32512628,346469261
2015-08-06,G,Others(HKUST),32,243,256518,6452790779,358021284,6810812063
2015-08-06,G,Non-HKUST,43,216,160287,18852488599,1175540503,20028029102
2015-08-06,G,Total,693,4360,3398234,176587987040,18569750081,195157737121
2015-08-06,LG1,Staff,97,869,676990,31353279618,2798316679,34151596297
2015-08-06,LG1,TPG,68,1340,1125669,148274955875,33650326848,181925282723
2015-08-06,LG1,RPG,141,1915,1955858,154176697866,29590774974,183767472840
2015-08-06,LG1,UG,308,2985,2700040,223460897354,17716552364,241177449718
2015-08-06,LG1,Alumni,10,63,48448,815555715,99985858,915541573
2015-08-06,LG1,Others(HKUST),20,221,523834,3837848486,669045788,4506894274
2015-08-06,LG1,Non-HKUST,44,232,159884,11056974208,1365739320,12422713528
2015-08-06,LG1,Total,688,7625,7190723,572976209122,85890741831,658866950953
2015-08-06,LG3,Staff,119,347,209867,2942897143,1158019422,4100916565
2015-08-06,LG3,TPG,34,192,272301,13969924584,1185546714,15155471298
2015-08-06,LG3,RPG,112,734,920278,74153354186,7335379875,81488734061
2015-08-06,LG3,UG,214,907,775427,53363112767,4914463704,58277576471
2015-08-06,LG3,Alumni,6,24,56131,2156253358,297432031,2453685389
2015-08-06,LG3,Others(HKUST),19,136,146098,4300303852,288844606,4589148458
2015-08-06,LG3,Non-HKUST,23,122,92632,3384774210,491158186,3875932396
2015-08-06,LG3,Total,527,2462,2472734,154270620100,15670844538,169941464638
2015-08-06,LG4,Staff,162,517,251078,17905908016,2560811668,20466719684
2015-08-06,LG4,TPG,33,161,171230,24128445260,1433605214,25562050474
2015-08-06,LG4,RPG,172,794,661001,21138057560,3202681764,24340739324
2015-08-06,LG4,UG,247,1045,837122,45989813209,3479297377,49469110586
2015-08-06,LG4,Alumni,14,175,187582,12708689352,1912659278,14621348630
2015-08-06,LG4,Others(HKUST),30,288,254139,26568633123,1598176825,28166809948
2015-08-06,LG4,Non-HKUST,25,149,106004,15463046951,829619013,16292665964
2015-08-06,LG4,Total,683,3129,2468156,163902593471,15016851139,178919444610
2015-08-06,All-Floors,Staff,361,3299,2941997,85240037391,13749368721,98989406112
2015-08-06,All-Floors,TPG,105,2201,2026600,215428740681,38312499142,253741239823
2015-08-06,All-Floors,RPG,361,4658,4734691,325137792246,49351782995,374489575241
2015-08-06,All-Floors,UG,631,6925,5899533,421698576722,34530465641,456229042363
2015-08-06,All-Floors,Alumni,23,332,374307,16882121839,2453925123,19336046962
2015-08-06,All-Floors,Others(HKUST),59,970,1351830,42125764473,3152463381,45278227854
2015-08-06,All-Floors,Non-HKUST,86,733,560687,52280648295,4585368792,56866017087
2015-08-06,All-Floors,Total,1626,19118,17889645,1158793681647,146135873795,1304929555442
2015-08-07,1,Staff,59,514,894294,14661437738,1218644108,15880081846
2015-08-07,1,TPG,12,124,211774,3760047027,914755117,4674802144
2015-08-07,1,RPG,23,130,254945,10001677841,1487019421,11488697262
2015-08-07,1,UG,50,293,496767,15228912385,1210203499,16439115884
2015-08-07,1,Alumni,3,15,19377,28932819,1450764,30383583
2015-08-07,1,Others(HKUST),6,62,96623,174530636,93125458,267656094
2015-08-07,1,Non-HKUST,7,27,19574,2042747215,148930436,2191677651
2015-08-07,1,Total,160,1165,1993354,45898285661,5074128803,50972414464
2015-08-07,G,Staff,169,1008,970955,60860270526,3243437342,64103707868
2015-08-07,G,TPG,66,452,368842,23057638399,2171602135,25229240534
2015-08-07,G,RPG,153,1056,881805,53441505013,5979295226,59420800239
2015-08-07,G,UG,270,1478,1083172,70512857457,6004519819,76517377276
2015-08-07,G,Alumni,10,65,32634,1137392351,80217202,1217609553
2015-08-07,G,Others(HKUST),22,120,184713,26216849355,1262523283,27479372638
2015-08-07,G,Non-HKUST,49,192,84595,9081651064,550365364,9632016428
2015-08-07,G,Total,739,4371,3606716,244308164165,19291960371,263600124536
2015-08-07,LG1,Staff,125,863,875350,95780768304,24903714791,120684483095
2015-08-07,LG1,TPG,71,1021,1042040,137868898572,21886222906,159755121478
2015-08-07,LG1,RPG,128,1250,1444283,72642520761,21501850553,94144371314
2015-08-07,LG1,UG,275,2133,2335171,167715957427,21430384407,189146341834
2015-08-07,LG1,Alumni,15,82,77721,11068466822,472268876,11540735698
2015-08-07,LG1,Others(HKUST),18,207,602331,2595496461,1448752682,4044249143
2015-08-07,LG1,Non-HKUST,39,171,125502,6380729677,550813335,6931543012
2015-08-07,LG1,Total,671,5727,6502398,494052838024,92194007550,586246845574
2015-08-07,LG3,Staff,95,316,196440,2406679838,498969431,2905649269
2015-08-07,LG3,TPG,32,276,316567,16649694997,1632200687,18281895684
2015-08-07,LG3,RPG,104,567,807289,34753723056,3649348224,38403071280
2015-08-07,LG3,UG,198,760,950429,60394854351,4952909204,65347763555
2015-08-07,LG3,Alumni,10,64,60253,769075810,85749434,854825244
2015-08-07,LG3,Others(HKUST),20,79,143237,1264370481,89602896,1353973377
2015-08-07,LG3,Non-HKUST,18,88,103389,4396289182,345056681,4741345863
2015-08-07,LG3,Total,477,2150,2577604,120634687715,11253836557,131888524272
2015-08-07,LG4,Staff,139,361,186273,9452209730,542980555,9995190285
2015-08-07,LG4,TPG,21,209,203185,18446542651,1119627400,19566170051
2015-08-07,LG4,RPG,153,682,638812,42001170990,4869778974,46870949964
2015-08-07,LG4,UG,270,918,708156,27940144909,2090022389,30030167298
2015-08-07,LG4,Alumni,14,144,241099,7777680915,593360433,8371041348
2015-08-07,LG4,Others(HKUST),27,243,268072,15499724959,960590422,16460315381
2015-08-07,LG4,Non-HKUST,36,136,83659,9354650711,490945019,9845595730
2015-08-07,LG4,Total,660,2693,2329256,130472124865,10667305192,141139430057
2015-08-07,All-Floors,Staff,351,3062,3123312,183161366136,30407746227,213569112363
2015-08-07,All-Floors,TPG,113,2082,2142408,199782821646,27724408245,227507229891
2015-08-07,All-Floors,RPG,339,3685,4027134,212840597661,37487292398,250327890059
2015-08-07,All-Floors,UG,648,5582,5573695,341792726529,35688039318,377480765847
2015-08-07,All-Floors,Alumni,26,370,431084,20781548717,1233046709,22014595426
2015-08-07,All-Floors,Others(HKUST),53,711,1294976,45750971892,3854594741,49605566633
2015-08-07,All-Floors,Non-HKUST,93,614,416719,31256067849,2086110835,33342178684
2015-08-07,All-Floors,Total,1623,16106,17009328,1035366100430,138481238473,1173847338903
2015-08-08,1,Staff,18,100,206669,228300080,83231274,311531354
2015-08-08,1,TPG,9,49,158099,7464367102,978369054,8442736156
2015-08-08,1,RPG,22,87,124989,37793057094,1464175348,39257232442
2015-08-08,1,UG,14,32,58699,1438864744,276735783,1715600527
2015-08-08,1,Alumni,2,5,10181,1296145729,597728944,1893874673
2015-08-08,1,Others(HKUST),2,45,78853,83740207,17601458,101341665
2015-08-08,1,Non-HKUST,2,17,24031,845173394,59166130,904339524
2015-08-08,1,Total,69,335,661521,49149648350,3477007991,52626656341
2015-08-08,G,Staff,42,297,241674,9713868558,542149540,10256018098
2015-08-08,G,TPG,77,267,180494,12077589176,1171677647,13249266823
2015-08-08,G,RPG,75,436,352426,62975908683,3410131676,66386040359
2015-08-08,G,UG,159,658,644515,34829117603,4525980199,39355097802
2015-08-08,G,Alumni,26,120,77109,3618104989,4512083927,8130188916
2015-08-08,G,Others(HKUST),10,93,174546,1381705729,243876269,1625581998
2015-08-08,G,Non-HKUST,18,66,66882,1157945517,177979595,1335925112
2015-08-08,G,Total,407,1937,1737646,125754240255,14583878853,140338119108
2015-08-08,LG1,Staff,44,391,333876,7713635201,622353410,8335988611
2015-08-08,LG1,TPG,98,1434,1581523,132306639222,9810562076,142117201298
2015-08-08,LG1,RPG,99,1192,1091544,136138192977,12945099515,149083292492
2015-08-08,LG1,UG,255,2323,2388871,146606110750,21289058759,167895169509
2015-08-08,LG1,Alumni,29,208,206597,12098475685,3416993369,15515469054
2015-08-08,LG1,Others(HKUST),14,266,690312,9542464098,1792281123,11334745221
2015-08-08,LG1,Non-HKUST,25,201,179117,11080811741,593830114,11674641855
2015-08-08,LG1,Total,564,6015,6471840,455486329674,50470178366,505956508040
2015-08-08,LG3,Staff,35,144,133887,2562560222,166348470,2728908692
2015-08-08,LG3,TPG,53,235,329995,19835181342,1820718982,21655900324
2015-08-08,LG3,RPG,68,408,480339,134299600716,7477333036,141776933752
2015-08-08,LG3,UG,170,444,318156,28497152057,8785053739,37282205796
2015-08-08,LG3,Alumni,22,156,215296,14903312830,893699420,15797012250
2015-08-08,LG3,Others(HKUST),10,80,111868,4219213461,202411434,4421624895
2015-08-08,LG3,Non-HKUST,19,88,191999,12401361076,634281780,13035642856
2015-08-08,LG3,Total,377,1555,1781540,216718381704,19979846861,236698228565
2015-08-08,LG4,Staff,40,158,59411,10409504956,1868616325,12278121281
2015-08-08,LG4,TPG,40,252,267817,41157358070,3415630154,44572988224
2015-08-08,LG4,RPG,88,536,559197,38487036665,3625199622,42112236287
2015-08-08,LG4,UG,207,634,566095,24204790614,1772963733,25977754347
2015-08-08,LG4,Alumni,22,235,346668,34306204834,9132241213,43438446047
2015-08-08,LG4,Others(HKUST),9,151,261341,20389232412,2418936537,22808168949
2015-08-08,LG4,Non-HKUST,14,169,118418,17606721945,1071975639,18678697584
2015-08-08,LG4,Total,420,2135,2178947,186560849496,23305563223,209866412719
2015-08-08,All-Floors,Staff,107,1090,975517,30627869017,3282699019,33910568036
2015-08-08,All-Floors,TPG,142,2237,2517928,212841134912,17196957913,230038092825
2015-08-08,All-Floors,RPG,205,2659,2608495,409693796135,28921939197,438615735332
2015-08-08,All-Floors,UG,496,4091,3976336,235576035768,36649792213,272225827981
2015-08-08,All-Floors,Alumni,51,724,855851,66222244067,18552746873,84774990940
2015-08-08,All-Floors,Others(HKUST),24,635,1316920,35616355907,4675106821,40291462728
2015-08-08,All-Floors,Non-HKUST,43,541,580447,43092013673,2537233258,45629246931
2015-08-08,All-Floors,Total,1068,11977,12831494,1033669449479,111816475294,1145485924773
2015-08-09,1,Staff,8,58,167561,19509649,14473275,33982924
2015-08-09,1,TPG,9,48,112363,8132725213,745844031,8878569244
2015-08-09,1,RPG,15,81,110103,7172042538,1151780917,8323823455
2015-08-09,1,UG,21,86,155571,19650955194,943308389,20594263583
2015-08-09,1,Alumni,2,7,13631,819775202,35268564,855043766
2015-08-09,1,Others(HKUST),4,98,143368,12209287592,2095542974,14304830566
2015-08-09,1,Non-HKUST,3,16,12155,2468656387,364714985,2833371372
2015-08-09,1,Total,62,394,714752,50472951775,5350933135,55823884910
2015-08-09,G,Staff,33,191,169424,1660092372,383219774,2043312146
2015-08-09,G,TPG,39,259,230487,10513832090,664692264,11178524354
2015-08-09,G,RPG,79,332,352877,23070376312,3019252267,26089628579
2015-08-09,G,UG,128,544,570094,19690544884,2987774804,22678319688
2015-08-09,G,Alumni,21,89,77362,2056717525,961242818,3017960343
2015-08-09,G,Others(HKUST),14,69,179464,33963705461,1471390382,35435095843
2015-08-09,G,Non-HKUST,15,41,34676,1046720252,70273570,1116993822
2015-08-09,G,Total,329,1525,1614384,92001988896,9557845879,101559834775
2015-08-09,LG1,Staff,27,237,195033,35694273835,2190612317,37884886152
2015-08-09,LG1,TPG,48,723,695174,32774451021,5751402292,38525853313
2015-08-09,LG1,RPG,70,681,734601,40074161273,4212764753,44286926026
2015-08-09,LG1,UG,140,1089,1180459,84682025350,7151040977,91833066327
2015-08-09,LG1,Alumni,32,188,266750,14892996442,4245991685,19138988127
2015-08-09,LG1,Others(HKUST),8,198,652072,3449567113,513037916,3962605029
2015-08-09,LG1,Non-HKUST,19,91,104851,14858583531,9906348958,24764932489
2015-08-09,LG1,Total,344,3207,3828940,226426058565,33971198898,260397257463
2015-08-09,LG3,Staff,29,91,73986,1275510722,262314889,1537825611
2015-08-09,LG3,TPG,18,49,48067,993323170,119572610,1112895780
2015-08-09,LG3,RPG,64,406,415409,38765087906,7742704539,46507792445
2015-08-09,LG3,UG,150,394,455950,25338837176,1817740746,27156577922
2015-08-09,LG3,Alumni,22,139,196491,6257652094,912894296,7170546390
2015-08-09,LG3,Others(HKUST),8,55,111051,1061325923,71859021,1133184944
2015-08-09,LG3,Non-HKUST,14,128,196726,7390054962,938269418,8328324380
2015-08-09,LG3,Total,305,1262,1497680,81081791953,11865355519,92947147472
2015-08-09,LG4,Staff,38,107,88741,5063155612,503743429,5566899041
2015-08-09,LG4,TPG,16,31,15163,663421454,41492617,704914071
2015-08-09,LG4,RPG,86,308,298356,12066840916,1206138944,13272979860
2015-08-09,LG4,UG,160,587,597533,83539449135,6801867678,90341316813
2015-08-09,LG4,Alumni,24,175,180621,62421943644,2652372148,65074315792
2015-08-09,LG4,Others(HKUST),12,150,294616,63814764016,3763747811,67578511827
2015-08-09,LG4,Non-HKUST,7,14,15125,1866534051,91258398,1957792449
2015-08-09,LG4,Total,343,1372,1490155,229436108828,15060621025,244496729853
2015-08-09,All-Floors,Staff,88,684,694745,43712542190,3354363684,47066905874
2015-08-09,All-Floors,TPG,80,1110,1101254,53077752948,7323003814,60400756762
2015-08-09,All-Floors,RPG,190,1808,1911346,121148508945,17332641420,138481150365
2015-08-09,All-Floors,UG,405,2700,2959607,232901811739,19701732594,252603544333
2015-08-09,All-Floors,Alumni,50,598,734855,86449084907,8807769511,95256854418
2015-08-09,All-Floors,Others(HKUST),23,570,1380571,114498650105,7915578104,122414228209
2015-08-09,All-Floors,Non-HKUST,33,290,363533,27630549183,11370865329,39001414512
2015-08-09,All-Floors,Total,869,7760,9145911,679418900017,75805954456,755224854473
2015-08-10,1,Staff,73,833,1110778,7161095094,1509324922,8670420016
2015-08-10,1,TPG,9,79,74645,4217476948,336016646,4553493594
2015-08-10,1,RPG,28,154,271651,14041787998,1249063748,15290851746
2015-08-10,1,UG,51,429,723779,25662494638,2517684096,28180178734
2015-08-10,1,Alumni,3,37,73208,4519773146,217880463,4737653609
2015-08-10,1,Others(HKUST),9,65,152383,1340872062,74643225,1415515287
2015-08-10,1,Non-HKUST,7,33,20296,597674060,66112927,663786987
2015-08-10,1,Total,180,1630,2426740,57541173946,5970726027,63511899973
2015-08-10,G,Staff,168,960,882961,19443816463,2256234673,21700051136
2015-08-10,G,TPG,75,355,269496,13935741331,1241139294,15176880625
2015-08-10,G,RPG,152,841,842659,40385210326,4784020215,45169230541
2015-08-10,G,UG,246,1168,934279,36814396107,8720967846,45535363953
2015-08-10,G,Alumni,15,63,30644,3536645247,200661553,3737306800
2015-08-10,G,Others(HKUST),19,182,264103,10547469768,1065590729,11613060497
2015-08-10,G,Non-HKUST,41,174,166491,8107144232,456111132,8563255364
2015-08-10,G,Total,716,3743,3390633,132770423474,18724725442,151495148916
2015-08-10,LG1,Staff,114,730,602723,44503269415,6272048958,50775318373
2015-08-10,LG1,TPG,70,910,1093455,111874846396,15341721963,127216568359
2015-08-10,LG1,RPG,141,1604,2051278,117723328274,40996790596,158720118870
2015-08-10,LG1,UG,281,2649,2848626,146458982128,22797363857,169256345985
2015-08-10,LG1,Alumni,17,148,150344,6972859323,342188367,7315047690
2015-08-10,LG1,Others(HKUST),22,300,670089,5035207442,1135515155,6170722597
2015-08-10,LG1,Non-HKUST,42,206,196633,14524918429,953534446,15478452875
2015-08-10,LG1,Total,687,6547,7613148,447093411407,87839163342,534932574749
2015-08-10,LG3,Staff,102,286,137738,1131073382,219774809,1350848191
2015-08-10,LG3,TPG,38,235,369974,13936216865,1116327936,15052544801
2015-08-10,LG3,RPG,109,730,817041,83053072363,4268998266,87322070629
2015-08-10,LG3,UG,238,783,705031,38335325892,3335249835,41670575727
2015-08-10,LG3,Alumni,10,48,49851,2093389248,334732781,2428122029
2015-08-10,LG3,Others(HKUST),13,61,120055,2778686073,145974080,2924660153
2015-08-10,LG3,Non-HKUST,20,89,92300,7493949994,728498121,8222448115
2015-08-10,LG3,Total,530,2232,2291990,148821713817,10149555828,158971269645
2015-08-10,LG4,Staff,167,484,283746,20564478423,1031475469,21595953892
2015-08-10,LG4,TPG,28,192,211672,26063084682,4251865415,30314950097
2015-08-10,LG4,RPG,153,651,535452,30952897115,4856341509,35809238624
2015-08-10,LG4,UG,242,988,924646,45784152045,6500222524,52284374569
2015-08-10,LG4,Alumni,10,121,159053,11325900779,748008533,12073909312
2015-08-10,LG4,Others(HKUST),20,162,244929,105829056622,7874648399,113703705021
2015-08-10,LG4,Non-HKUST,31,147,93063,36518760522,1722847103,38241607625
2015-08-10,LG4,Total,651,2745,2452561,277038330188,26985408952,304023739140
2015-08-10,All-Floors,Staff,379,3293,3017946,92803732777,11288858831,104092591608
2015-08-10,All-Floors,TPG,119,1771,2019242,170027366222,22287071254,192314437476
2015-08-10,All-Floors,RPG,352,3980,4518081,286156296076,56155214334,342311510410
2015-08-10,All-Floors,UG,646,6017,6136361,293055350810,43871488158,336926838968
2015-08-10,All-Floors,Alumni,26,417,463100,28448567743,1843471697,30292039440
2015-08-10,All-Floors,Others(HKUST),48,770,1451559,125531291967,10296371588,135827663555
2015-08-10,All-Floors,Non-HKUST,88,649,568783,67242447237,3927103729,71169550966
2015-08-10,All-Floors,Total,1658,16897,18175072,1063265052832,149669579591,1212934632423
2015-08-11,1,Staff,73,670,1080825,19384552504,2371979765,21756532269
2015-08-11,1,TPG,15,180,258190,53347960304,2384526674,55732486978
2015-08-11,1,RPG,33,190,338786,12649621566,1302153606,13951775172
2015-08-11,1,UG,56,448,692760,21558746430,5871863832,27430610262
2015-08-11,1,Alumni,1,4,1429,147046,68228,215274
2015-08-11,1,Others(HKUST),10,80,151843,9517494346,345855126,9863349472
2015-08-11,1,Non-HKUST,4,9,10226,1036112639,87722869,1123835508
2015-08-11,1,Total,192,1581,2534059,117494634835,12364170100,129858804935
2015-08-11,G,Staff,162,972,878144,20112136923,1746721256,21858858179
2015-08-11,G,TPG,66,588,414208,53244625749,8024224410,61268850159
2015-08-11,G,RPG,144,752,708432,22437338143,2455839821,24893177964
2015-08-11,G,UG,295,1469,1273028,79031793816,6480243605,85512037421
2015-08-11,G,Alumni,13,56,63225,4040437292,614416640,4654853932
2015-08-11,G,Others(HKUST),28,171,245252,5131512077,631008923,5762521000
2015-08-11,G,Non-HKUST,43,157,185309,6394256422,609048002,7003304424
2015-08-11,G,Total,751,4165,3767598,190392100422,20561502657,210953603079
2015-08-11,LG1,Staff,121,763,649994,28860176320,2962977755,31823154075
2015-08-11,LG1,TPG,72,1223,1181804,104358705259,12506498820,116865204079
2015-08-11,LG1,RPG,160,2053,2310376,113461590595,38376828987,151838419582
2015-08-11,LG1,UG,398,3632,3422620,171581981667,39282521827,210864503494
2015-08-11,LG1,Alumni,18,263,275021,23593539986,2575132189,26168672175
2015-08-11,LG1,Others(HKUST),21,583,870008,18148051532,2610437268,20758488800
2015-08-11,LG1,Non-HKUST,38,196,191936,8174740915,904724820,9079465735
2015-08-11,LG1,Total,828,8713,8901759,468178786274,99219121666,567397907940
2015-08-11,LG3,Staff,81,266,212634,9020802594,614581774,9635384368
2015-08-11,LG3,TPG,32,248,247145,37552765124,41513574646,79066339770
2015-08-11,LG3,RPG,115,834,978849,60634329009,5078968275,65713297284
2015-08-11,LG3,UG,281,757,530835,21582034341,3767457622,25349491963
2015-08-11,LG3,Alumni,14,130,146723,7295121467,742529081,8037650548
2015-08-11,LG3,Others(HKUST),13,62,80074,4701817506,262676050,4964493556
2015-08-11,LG3,Non-HKUST,19,74,75387,2475692339,363693384,2839385723
2015-08-11,LG3,Total,555,2371,2271647,143262562380,52343480832,195606043212
2015-08-11,LG4,Staff,167,540,316247,62404218204,3120420430,65524638634
2015-08-11,LG4,TPG,30,214,187733,47234481143,4626952704,51861433847
2015-08-11,LG4,RPG,202,668,598389,36652935584,4607229023,41260164607
2015-08-11,LG4,UG,373,1088,745231,33533507263,3329358223,36862865486
2015-08-11,LG4,Alumni,12,138,265017,35143148197,2573038107,37716186304
2015-08-11,LG4,Others(HKUST),22,225,285160,33552169837,1458290028,35010459865
2015-08-11,LG4,Non-HKUST,43,133,117541,4721574099,2215823069,6937397168
2015-08-11,LG4,Total,849,3006,2515318,253242034327,21931111584,275173145911
2015-08-11,All-Floors,Staff,373,3211,3137844,139781886545,10816680980,150598567525
2015-08-11,All-Floors,TPG,114,2453,2289080,295738537579,69055777254,364794314833
2015-08-11,All-Floors,RPG,404,4497,4934832,245835814897,51821019712,297656834609
2015-08-11,All-Floors,UG,841,7394,6664474,327288063517,58731445109,386019508626
2015-08-11,All-Floors,Alumni,32,591,751415,70072393988,6505184245,76577578233
2015-08-11,All-Floors,Others(HKUST),47,1121,1632337,71051045298,5308267395,76359312693
2015-08-11,All-Floors,Non-HKUST,97,569,580399,22802376414,4181012144,26983388558
2015-08-11,All-Floors,Total,1908,19836,19990381,1172570118238,206419386839,1378989505077
2015-08-12,1,Staff,69,811,1281770,30178484132,6238125899,36416610031
2015-08-12,1,TPG,13,148,229788,16369141897,4129643847,20498785744
2015-08-12,1,RPG,31,241,303060,20128793350,17159319878,37288113228
2015-08-12,1,UG,57,410,482407,35728677594,7039170371,42767847965
2015-08-12,1,Alumni,0,0,0,0,0,0
2015-08-12,1,Others(HKUST),12,72,110436,1092950474,69259600,1162210074
2015-08-12,1,Non-HKUST,13,55,83132,3047373481,431675875,3479049356
2015-08-12,1,Total,195,1737,2490593,106545420928,35067195470,141612616398
2015-08-12,G,Staff,165,1024,879087,33084295647,2842218323,35926513970
2015-08-12,G,TPG,73,483,337122,33241922722,2169538095,35411460817
2015-08-12,G,RPG,148,863,780996,43669277147,3295454201,46964731348
2015-08-12,G,UG,372,1809,1369823,63029719651,7010054441,70039774092
2015-08-12,G,Alumni,8,26,24100,397115999,40505502,437621501
2015-08-12,G,Others(HKUST),23,167,247921,8964251417,864666021,9828917438
2015-08-12,G,Non-HKUST,59,245,190041,19351221802,1906969782,21258191584
2015-08-12,G,Total,848,4617,3829090,201737804385,18129406365,219867210750
2015-08-12,LG1,Staff,102,603,476109,33743840829,1928617537,35672458366
2015-08-12,LG1,TPG,69,1155,1002116,109831945439,19003447117,128835392556
2015-08-12,LG1,RPG,140,1935,2102081,135659436170,22520798812,158180234982
2015-08-12,LG1,UG,587,4739,3526674,190952363267,28677960356,219630323623
2015-08-12,LG1,Alumni,12,129,163940,2997835583,299029741,3296865324
2015-08-12,LG1,Others(HKUST),19,283,617993,8659809773,2403278431,11063088204
2015-08-12,LG1,Non-HKUST,41,155,87184,12473210489,739785609,13212996098
2015-08-12,LG1,Total,970,8999,7976097,494318441550,75572917603,569891359153
2015-08-12,LG3,Staff,93,426,304786,33455455206,1402887504,34858342710
2015-08-12,LG3,TPG,39,508,543374,28004507044,2800198075,30804705119
2015-08-12,LG3,RPG,131,1073,1182769,216199792229,16052845527,232252637756
2015-08-12,LG3,UG,346,912,588151,20054581725,1914479163,21969060888
2015-08-12,LG3,Alumni,9,52,54652,1491742648,167258227,1659000875
2015-08-12,LG3,Others(HKUST),12,33,21062,100303010,10441512,110744522
2015-08-12,LG3,Non-HKUST,25,124,91506,5450638901,396634615,5847273516
2015-08-12,LG3,Total,655,3128,2786300,304757020763,22744744623,327501765386
2015-08-12,LG4,Staff,179,537,315942,67943466410,2872897937,70816364347
2015-08-12,LG4,TPG,40,256,322837,28670800404,2145325548,30816125952
2015-08-12,LG4,RPG,218,928,940170,42614945854,11607662669,54222608523
2015-08-12,LG4,UG,526,1520,1299556,98831005673,19504837364,118335843037
2015-08-12,LG4,Alumni,12,109,210056,7543604781,715251943,8258856724
2015-08-12,LG4,Others(HKUST),29,250,230190,29233919654,2076695780,31310615434
2015-08-12,LG4,Non-HKUST,66,206,175456,16749954066,2875099128,19625053194
2015-08-12,LG4,Total,1070,3806,3494207,291587696842,41797770369,333385467211
2015-08-12,All-Floors,Staff,370,3401,3257694,198405542224,15284747200,213690289424
2015-08-12,All-Floors,TPG,118,2550,2435237,216118317506,30248152682,246366470188
2015-08-12,All-Floors,RPG,392,5040,5309076,458272244750,70636081087,528908325837
2015-08-12,All-Floors,UG,1150,9390,7266611,408596347910,64146501695,472742849605
2015-08-12,All-Floors,Alumni,25,316,452748,12430299011,1222045413,13652344424
2015-08-12,All-Floors,Others(HKUST),47,805,1227602,48051234328,5424341344,53475575672
2015-08-12,All-Floors,Non-HKUST,134,785,627319,57072398739,6350165009,63422563748
2015-08-12,All-Floors,Total,2236,22287,20576287,1398946384468,193312034430,1592258418898
2015-08-13,1,Staff,72,826,1075499,8902810558,1311609132,10214419690
2015-08-13,1,TPG,10,110,191853,8670762965,2061282618,10732045583
2015-08-13,1,RPG,29,235,321971,19625958526,2108631084,21734589610
2015-08-13,1,UG,59,278,487000,15552574615,1301134127,16853708742
2015-08-13,1,Alumni,2,2,1905,19798170,2298543,22096713
2015-08-13,1,Others(HKUST),5,72,123898,2579082028,310596030,2889678058
2015-08-13,1,Non-HKUST,5,9,8836,1890919402,68446527,1959365929
2015-08-13,1,Total,182,1532,2210962,57241906264,7163998061,64405904325
2015-08-13,G,Staff,159,1123,843937,24757961244,3140458653,27898419897
2015-08-13,G,TPG,60,434,323088,27093304262,2394887180,29488191442
2015-08-13,G,RPG,157,930,823332,38786100490,4753416777,43539517267
2015-08-13,G,UG,395,1795,1340375,57913944115,9648283532,67562227647
2015-08-13,G,Alumni,17,96,67565,1797091775,146808296,1943900071
2015-08-13,G,Others(HKUST),20,125,191469,7406577744,818424616,8225002360
2015-08-13,G,Non-HKUST,30,109,132141,5109656303,356223762,5465880065
2015-08-13,G,Total,838,4612,3721907,162864635933,21258502816,184123138749
2015-08-13,LG1,Staff,109,736,511818,12826535750,1470563996,14297099746
2015-08-13,LG1,TPG,73,1167,1133227,81387230501,11630695668,93017926169
2015-08-13,LG1,RPG,151,2147,2268150,235772949872,43961955704,279734905576
2015-08-13,LG1,UG,426,3368,2685878,144600828665,19112624225,163713452890
2015-08-13,LG1,Alumni,16,104,81235,10312047498,1844902577,12156950075
2015-08-13,LG1,Others(HKUST),15,323,663462,4073095994,2100184781,6173280775
2015-08-13,LG1,Non-HKUST,39,238,205307,13006293841,1686396346,14692690187
2015-08-13,LG1,Total,829,8083,7549077,501978982121,81807323297,583786305418
2015-08-13,LG3,Staff,98,349,270013,11160359934,2371780430,13532140364
2015-08-13,LG3,TPG,44,427,545764,41771988858,5472459623,47244448481
2015-08-13,LG3,RPG,104,802,1005639,76522395158,16169890147,92692285305
2015-08-13,LG3,UG,268,679,415210,20379951743,2059511495,22439463238
2015-08-13,LG3,Alumni,10,91,108743,2540366584,374837338,2915203922
2015-08-13,LG3,Others(HKUST),10,60,84208,2647133813,147047024,2794180837
2015-08-13,LG3,Non-HKUST,13,110,123082,2754511470,166495798,2921007268
2015-08-13,LG3,Total,547,2518,2552659,157776707560,26762021855,184538729415
2015-08-13,LG4,Staff,173,466,230913,5518484467,655880961,6174365428
2015-08-13,LG4,TPG,43,240,211361,17995137911,11667724131,29662862042
2015-08-13,LG4,RPG,231,1089,1023763,36124590426,35664432612,71789023038
2015-08-13,LG4,UG,562,1508,659382,24795212396,3596680063,28391892459
2015-08-13,LG4,Alumni,18,203,313078,32333024242,1536100881,33869125123
2015-08-13,LG4,Others(HKUST),17,194,217832,29978062344,3051914202,33029976546
2015-08-13,LG4,Non-HKUST,32,146,86868,7903913992,541467857,8445381849
2015-08-13,LG4,Total,1076,3846,2743197,154648425778,56714200707,211362626485
2015-08-13,All-Floors,Staff,347,3500,2932180,63166151953,8950293172,72116445125
2015-08-13,All-Floors,TPG,105,2378,2405293,176918424497,33227049220,210145473717
2015-08-13,All-Floors,RPG,389,5203,5442855,406831994472,102658326324,509490320796
2015-08-13,All-Floors,UG,1065,7628,5587845,263242511534,35718233442,298960744976
2015-08-13,All-Floors,Alumni,34,496,572526,47002328269,3904947635,50907275904
2015-08-13,All-Floors,Others(HKUST),36,774,1280869,46683951923,6428166653,53112118576
2015-08-13,All-Floors,Non-HKUST,72,612,556234,30665295008,2819030290,33484325298
2015-08-13,All-Floors,Total,2048,20591,18777802,1034510657656,193706046736,1228216704392
2015-08-14,1,Staff,66,582,811578,5615044674,1564558080,7179602754
2015-08-14,1,TPG,15,137,192032,14120516508,1458146365,15578662873
2015-08-14,1,RPG,28,131,140294,9325271803,1049810321,10375082124
2015-08-14,1,UG,37,256,371036,14333593945,1856938562,16190532507
2015-08-14,1,Alumni,3,14,7859,3371637633,198255044,3569892677
2015-08-14,1,Others(HKUST),7,71,113031,463298737,91449308,554748045
2015-08-14,1,Non-HKUST,5,11,13086,1160960437,68127611,1229088048
2015-08-14,1,Total,161,1202,1648916,48390323737,6287285291,54677609028
2015-08-14,G,Staff,155,999,865108,62260697328,5498514287,67759211615
2015-08-14,G,TPG,78,556,529334,20715997359,2725915069,23441912428
2015-08-14,G,RPG,175,800,655209,57975500673,5176014671,63151515344
2015-08-14,G,UG,206,893,589932,34865472064,2928212911,37793684975
2015-08-14,G,Alumni,10,98,60772,22955885640,943523265,23899408905
2015-08-14,G,Others(HKUST),17,146,243014,5477485326,346089266,5823574592
2015-08-14,G,Non-HKUST,33,163,132167,9921306746,534504208,10455810954
2015-08-14,G,Total,674,3655,3075536,214172345136,18152773677,232325118813
2015-08-14,LG1,Staff,97,685,439625,32301469963,2607253490,34908723453
2015-08-14,LG1,TPG,86,1214,1024560,94195095052,10211646801,104406741853
2015-08-14,LG1,RPG,159,1501,1456383,67217448195,17522342136,84739790331
2015-08-14,LG1,UG,252,2197,1874113,114043091209,12276237138,126319328347
2015-08-14,LG1,Alumni,13,81,79308,2770196098,487576714,3257772812
2015-08-14,LG1,Others(HKUST),17,215,560957,5404071098,3741128127,9145199225
2015-08-14,LG1,Non-HKUST,39,238,194842,26410273728,1384312314,27794586042
2015-08-14,LG1,Total,663,6131,5629788,342341645343,48230496720,390572142063
2015-08-14,LG3,Staff,91,282,153845,3211242904,230786909,3442029813
2015-08-14,LG3,TPG,46,425,436260,26933295728,2349720658,29283016386
2015-08-14,LG3,RPG,111,615,792868,61919842578,3567090871,65486933449
2015-08-14,LG3,UG,158,576,545987,49352204117,7891079351,57243283468
2015-08-14,LG3,Alumni,9,133,121458,10186619973,755138602,10941758575
2015-08-14,LG3,Others(HKUST),10,59,104396,970203932,58407542,1028611474
2015-08-14,LG3,Non-HKUST,17,116,71225,25392531955,846737035,26239268990
2015-08-14,LG3,Total,442,2206,2226039,177965941187,15698960968,193664902155
2015-08-14,LG4,Staff,157,508,308786,7432417452,789723079,8222140531
2015-08-14,LG4,TPG,42,279,238201,17146367886,3219180648,20365548534
2015-08-14,LG4,RPG,208,1079,916529,38233358617,22503570531,60736929148
2015-08-14,LG4,UG,227,672,564738,30583047227,2067962694,32651009921
2015-08-14,LG4,Alumni,10,213,263222,19095944508,1178699635,20274644143
2015-08-14,LG4,Others(HKUST),26,174,219481,14066869084,2791723714,16858592798
2015-08-14,LG4,Non-HKUST,44,97,71926,3646629439,494416916,4141046355
2015-08-14,LG4,Total,714,3022,2582883,130204634213,33045277217,163249911430
2015-08-14,All-Floors,Staff,347,3056,2578942,110820872321,10690835845,121511708166
2015-08-14,All-Floors,TPG,130,2611,2420387,173111272533,19964609541,193075882074
2015-08-14,All-Floors,RPG,400,4126,3961283,234671421866,49818828530,284490250396
2015-08-14,All-Floors,UG,563,4594,3945806,243177408562,27020430656,270197839218
2015-08-14,All-Floors,Alumni,23,539,532619,58380283852,3563193260,61943477112
2015-08-14,All-Floors,Others(HKUST),47,665,1240879,26381928177,7028797957,33410726134
2015-08-14,All-Floors,Non-HKUST,93,625,483246,66531702305,3328098084,69859800389
2015-08-14,All-Floors,Total,1603,16216,15163162,913074889616,121414793873,1034489683489
2015-08-15,1,Staff,8,46,25825,105367278,4818426,110185704
2015-08-15,1,TPG,17,62,116101,13212525829,663098297,13875624126
2015-08-15,1,RPG,17,61,32291,283954106,49617141,333571247
2015-08-15,1,UG,30,86,136332,7215691448,376371309,7592062757
2015-08-15,1,Alumni,0,0,0,0,0,0
2015-08-15,1,Others(HKUST),5,57,70085,2291253203,84437566,2375690769
2015-08-15,1,Non-HKUST,0,0,0,0,0,0
2015-08-15,1,Total,77,312,380634,23108791864,1178342739,24287134603
2015-08-15,G,Staff,36,256,280892,4053900728,329590688,4383491416
2015-08-15,G,TPG,70,403,364357,25124977594,3626454222,28751431816
2015-08-15,G,RPG,121,456,361180,15699829554,1328934367,17028763921
2015-08-15,G,UG,233,617,460845,28417539200,2995755927,31413295127
2015-08-15,G,Alumni,25,56,45837,6980119991,694867656,7674987647
2015-08-15,G,Others(HKUST),12,132,202639,6286843327,418970205,6705813532
2015-08-15,G,Non-HKUST,21,64,55776,2149090521,100853272,2249943793
2015-08-15,G,Total,518,1984,1771526,88712300915,9495426337,98207727252
2015-08-15,LG1,Staff,23,95,100478,5956977043,473892022,6430869065
2015-08-15,LG1,TPG,77,1206,1196541,98589845584,10119057598,108708903182
2015-08-15,LG1,RPG,107,978,1089894,83328814354,7003194416,90332008770
2015-08-15,LG1,UG,173,1424,1188292,68394610284,6088002070,74482612354
2015-08-15,LG1,Alumni,26,204,193000,12541953749,873628814,13415582563
2015-08-15,LG1,Others(HKUST),9,317,610543,5802502607,1892641788,7695144395
2015-08-15,LG1,Non-HKUST,13,53,12396,307544300,46581920,354126220
2015-08-15,LG1,Total,428,4277,4391144,274922247921,26496998628,301419246549
2015-08-15,LG3,Staff,43,93,73176,269895751,42116957,312012708
2015-08-15,LG3,TPG,42,332,367542,20925278761,2254310312,23179589073
2015-08-15,LG3,RPG,71,351,462953,32234795027,3064504000,35299299027
2015-08-15,LG3,UG,397,717,297273,5984939071,618966336,6603905407
2015-08-15,LG3,Alumni,20,179,276557,12188579691,898856188,13087435879
2015-08-15,LG3,Others(HKUST),6,55,76925,2027119601,88329968,2115449569
2015-08-15,LG3,Non-HKUST,14,43,54306,2751348682,232291096,2983639778
2015-08-15,LG3,Total,593,1770,1608732,76381956584,7199374857,83581331441
2015-08-15,LG4,Staff,52,184,136740,2698477521,336740513,3035218034
2015-08-15,LG4,TPG,44,136,145579,15066164337,1268949909,16335114246
2015-08-15,LG4,RPG,122,614,530548,37185652654,2967879342,40153531996
2015-08-15,LG4,UG,421,799,419834,15476333006,1224393723,16700726729
2015-08-15,LG4,Alumni,31,236,376058,22873437248,1411265784,24284703032
2015-08-15,LG4,Others(HKUST),8,173,250703,116314180335,7814920816,124129101151
2015-08-15,LG4,Non-HKUST,25,123,50936,4106886693,239285198,4346171891
2015-08-15,LG4,Total,703,2265,1910398,213721131794,15263435285,228984567079
2015-08-15,All-Floors,Staff,108,674,617111,13084618321,1187158606,14271776927
2015-08-15,All-Floors,TPG,133,2139,2190120,172918792105,17931870338,190850662443
2015-08-15,All-Floors,RPG,272,2460,2476866,168733045695,14414129266,183147174961
2015-08-15,All-Floors,UG,854,3643,2502576,125489113009,11303489365,136792602374
2015-08-15,All-Floors,Alumni,54,675,891452,54584090679,3878618442,58462709121
2015-08-15,All-Floors,Others(HKUST),22,734,1210895,132721899073,10299300343,143021199416
2015-08-15,All-Floors,Non-HKUST,46,283,173414,9314870196,619011486,9933881682
2015-08-15,All-Floors,Total,1489,10608,10062434,676846429078,59633577846,736480006924
2015-08-16,1,Staff,13,53,29140,174952460,28294334,203246794
2015-08-16,1,TPG,2,2,2059,902342,648890,1551232
2015-08-16,1,RPG,12,19,14019,11835880,1303733,13139613
2015-08-16,1,UG,21,25,5286,362617331,26829992,389447323
2015-08-16,1,Alumni,0,0,0,0,0,0
2015-08-16,1,Others(HKUST),2,41,67176,2458877,1286856,3745733
2015-08-16,1,Non-HKUST,0,0,0,0,0,0
2015-08-16,1,Total,50,140,117680,552766890,58363805,611130695
2015-08-16,G,Staff,20,74,36938,290752055,28514187,319266242
2015-08-16,G,TPG,7,11,16441,5915162201,316025290,6231187491
2015-08-16,G,RPG,40,61,39471,984675759,67463087,1052138846
2015-08-16,G,UG,100,132,51261,1625278627,304115746,1929394373
2015-08-16,G,Alumni,0,0,0,0,0,0
2015-08-16,G,Others(HKUST),3,4,86521,447721367,36122201,483843568
2015-08-16,G,Non-HKUST,0,0,0,0,0,0
2015-08-16,G,Total,170,282,230632,9263590009,752240511,10015830520
2015-08-16,LG1,Staff,23,255,222646,4440564598,470181376,4910745974
2015-08-16,LG1,TPG,71,1157,1437900,101956960461,14797146135,116754106596
2015-08-16,LG1,RPG,105,1209,1633818,117122712452,12855946665,129978659117
2015-08-16,LG1,UG,154,1386,1498099,118016019236,14623382568,132639401804
2015-08-16,LG1,Alumni,7,65,81584,5377058561,347059333,5724117894
2015-08-16,LG1,Others(HKUST),7,482,765327,15831166152,2399025408,18230191560
2015-08-16,LG1,Non-HKUST,6,59,75349,7085238080,743280750,7828518830
2015-08-16,LG1,Total,373,4613,5714723,369829719540,46236022235,416065741775
2015-08-16,LG3,Staff,24,38,22334,222601726,39144377,261746103
2015-08-16,LG3,TPG,16,34,10305,3891297459,218820600,4110118059
2015-08-16,LG3,RPG,60,84,40199,401683232,29273674,430956906
2015-08-16,LG3,UG,253,352,120521,2868647218,264803890,3133451108
2015-08-16,LG3,Alumni,4,7,3722,231987780,45506519,277494299
2015-08-16,LG3,Others(HKUST),4,39,25446,23984530,4221274,28205804
2015-08-16,LG3,Non-HKUST,5,5,832,134390,68730,203120
2015-08-16,LG3,Total,366,559,223359,7640336335,601839064,8242175399
2015-08-16,LG4,Staff,28,42,15714,61463206,6668236,68131442
2015-08-16,LG4,TPG,30,46,14745,2729500288,482801208,3212301496
2015-08-16,LG4,RPG,111,158,61660,514410586,204776946,719187532
2015-08-16,LG4,UG,268,443,234881,7653327553,352108783,8005436336
2015-08-16,LG4,Alumni,9,13,29868,962051760,65002998,1027054758
2015-08-16,LG4,Others(HKUST),6,114,220910,70893053317,9101740403,79994793720
2015-08-16,LG4,Non-HKUST,3,4,1214,366305,7293953,7660258
2015-08-16,LG4,Total,455,820,578992,82814173015,10220392527,93034565542
2015-08-16,All-Floors,Staff,79,462,326772,5190334045,572802510,5763136555
2015-08-16,All-Floors,TPG,87,1250,1481450,114493822751,15815442123,130309264874
2015-08-16,All-Floors,RPG,243,1531,1789167,119035317909,13158764105,132194082014
2015-08-16,All-Floors,UG,604,2338,1910048,130525889965,15571240979,146097130944
2015-08-16,All-Floors,Alumni,15,85,115174,6571098101,457568850,7028666951
2015-08-16,All-Floors,Others(HKUST),14,680,1165380,87198384243,11542396142,98740780385
2015-08-16,All-Floors,Non-HKUST,10,68,77395,7085738775,750643433,7836382208
2015-08-16,All-Floors,Total,1052,6414,6865386,470100585789,57868858142,527969443931
2015-08-17,1,Staff,72,651,903811,10226086659,1068072488,11294159147
2015-08-17,1,TPG,28,171,374258,28146005082,2126742149,30272747231
2015-08-17,1,RPG,43,152,156605,3166964335,614546478,3781510813
2015-08-17,1,UG,76,277,322791,7174058701,669176671,7843235372
2015-08-17,1,Alumni,0,0,0,0,0,0
2015-08-17,1,Others(HKUST),9,123,60530,3211653133,128885313,3340538446
2015-08-17,1,Non-HKUST,0,0,0,0,0,0
2015-08-17,1,Total,228,1374,1817995,51924767910,4607423099,56532191009
2015-08-17,G,Staff,169,948,823222,18245644278,1848288496,20093932774
2015-08-17,G,TPG,73,525,388054,24829275737,6300040718,31129316455
2015-08-17,G,RPG,252,1082,730347,16808904693,1662653377,18471558070
2015-08-17,G,UG,346,1166,705133,24041297821,9979947423,34021245244
2015-08-17,G,Alumni,15,46,75565,1110609666,200896941,1311506607
2015-08-17,G,Others(HKUST),18,105,160978,3113648018,276637479,3390285497
2015-08-17,G,Non-HKUST,25,140,103370,2474848113,378102046,2852950159
2015-08-17,G,Total,898,4012,2986669,90624228326,20646566480,111270794806
2015-08-17,LG1,Staff,102,731,570723,59208421810,3959145222,63167567032
2015-08-17,LG1,TPG,71,721,648663,52864478868,5304783985,58169262853
2015-08-17,LG1,RPG,191,1963,2006712,117210272836,17285690343,134495963179
2015-08-17,LG1,UG,293,2598,1906674,59963204440,11182907327,71146111767
2015-08-17,LG1,Alumni,14,96,110680,6811748253,488851277,7300599530
2015-08-17,LG1,Others(HKUST),12,259,526219,17971868466,932388910,18904257376
2015-08-17,LG1,Non-HKUST,18,118,82064,4775792549,980414524,5756207073
2015-08-17,LG1,Total,701,6486,5851735,318805787222,40134181588,358939968810
2015-08-17,LG3,Staff,90,310,188895,5249445873,419998042,5669443915
2015-08-17,LG3,TPG,29,240,343254,23599116759,2198248844,25797365603
2015-08-17,LG3,RPG,137,663,849060,43490805907,5682661886,49173467793
2015-08-17,LG3,UG,419,883,418317,7726209070,1740487823,9466696893
2015-08-17,LG3,Alumni,15,82,97456,3084357908,171095414,3255453322
2015-08-17,LG3,Others(HKUST),10,80,92757,4952921404,229868315,5182789719
2015-08-17,LG3,Non-HKUST,16,47,39748,4412774096,387955941,4800730037
2015-08-17,LG3,Total,716,2305,2029487,92515631017,10830316265,103345947282
2015-08-17,LG4,Staff,145,436,234670,5036530732,471501628,5508032360
2015-08-17,LG4,TPG,39,217,216657,51043118843,3019898686,54063017529
2015-08-17,LG4,RPG,231,831,861800,27279914638,23271815161,50551729799
2015-08-17,LG4,UG,404,930,404720,14595180209,2889267304,17484447513
2015-08-17,LG4,Alumni,18,238,280495,26569378645,1381584620,27950963265
2015-08-17,LG4,Others(HKUST),17,192,266244,40734691243,5761583431,46496274674
2015-08-17,LG4,Non-HKUST,22,141,114805,3955056990,488658312,4443715302
2015-08-17,LG4,Total,876,2985,2379391,169213871300,37284309142,206498180442
2015-08-17,All-Floors,Staff,355,3076,2721321,97966129352,7767005876,105733135228
2015-08-17,All-Floors,TPG,119,1874,1970886,180481995289,18949714382,199431709671
2015-08-17,All-Floors,RPG,503,4691,4604524,207956862409,48517367245,256474229654
2015-08-17,All-Floors,UG,989,5854,3757635,113499950241,26461786548,139961736789
2015-08-17,All-Floors,Alumni,31,462,564196,37576094472,2242428252,39818522724
2015-08-17,All-Floors,Others(HKUST),33,759,1106728,69984782264,7329363448,77314145712
2015-08-17,All-Floors,Non-HKUST,47,446,339987,15618471748,2235130823,17853602571
2015-08-17,All-Floors,Total,2077,17162,15065277,723084285775,113502796574,836587082349
2015-08-18,1,Staff,72,732,903713,7425578321,1081198018,8506776339
2015-08-18,1,TPG,30,231,461920,42263023588,2611801055,44874824643
2015-08-18,1,RPG,42,210,274209,13977296965,1487619616,15464916581
2015-08-18,1,UG,72,201,197493,4290330615,1152552581,5442883196
2015-08-18,1,Alumni,0,0,0,0,0,0
2015-08-18,1,Others(HKUST),9,114,156598,2755330272,200585391,2955915663
2015-08-18,1,Non-HKUST,0,0,0,0,0,0
2015-08-18,1,Total,225,1488,1993933,70711559761,6533756661,77245316422
2015-08-18,G,Staff,156,924,804559,23537667698,1739973945,25277641643
2015-08-18,G,TPG,92,611,454521,16323104588,3772733733,20095838321
2015-08-18,G,RPG,208,1028,750466,34034755287,2575807075,36610562362
2015-08-18,G,UG,362,1613,1043727,44465805612,6578697475,51044503087
2015-08-18,G,Alumni,8,40,27856,368241628,65349773,433591401
2015-08-18,G,Others(HKUST),25,207,235423,9781323946,1021434044,10802757990
2015-08-18,G,Non-HKUST,28,119,124657,4714224914,810319625,5524544539
2015-08-18,G,Total,879,4542,3441209,133225123673,16564315670,149789439343
2015-08-18,LG1,Staff,111,837,592144,70740356126,5176931208,75917287334
2015-08-18,LG1,TPG,74,761,722268,63883282880,8088482222,71971765102
2015-08-18,LG1,RPG,185,2013,2059999,142383882961,12156286827,154540169788
2015-08-18,LG1,UG,291,2680,1864668,114397867269,10319146900,124717014169
2015-08-18,LG1,Alumni,12,82,83745,7512247714,704228187,8216475901
2015-08-18,LG1,Others(HKUST),14,290,577495,14690469474,2115981821,16806451295
2015-08-18,LG1,Non-HKUST,19,64,87644,1445887398,344395561,1790282959
2015-08-18,LG1,Total,706,6727,5987963,415053993822,38905452726,453959446548
2015-08-18,LG3,Staff,116,495,251064,56808280019,3006886316,59815166335
2015-08-18,LG3,TPG,44,310,404017,14744436638,3023067387,17767504025
2015-08-18,LG3,RPG,139,693,720445,146931383859,18568716606,165500100465
2015-08-18,LG3,UG,356,784,486209,21706397354,2446263691,24152661045
2015-08-18,LG3,Alumni,11,65,82659,5910375161,267408569,6177783730
2015-08-18,LG3,Others(HKUST),11,74,77792,322611146,33409130,356020276
2015-08-18,LG3,Non-HKUST,10,45,50334,2686913370,715353885,3402267255
2015-08-18,LG3,Total,687,2466,2072520,249110397547,28061105584,277171503131
2015-08-18,LG4,Staff,173,462,218214,6583467211,713874621,7297341832
2015-08-18,LG4,TPG,47,257,315092,46482162459,2610403648,49092566107
2015-08-18,LG4,RPG,206,778,707308,17068992015,6838969476,23907961491
2015-08-18,LG4,UG,449,991,448446,13586488890,2112846071,15699334961
2015-08-18,LG4,Alumni,12,203,247008,19547648162,1339435078,20887083240
2015-08-18,LG4,Others(HKUST),17,249,321238,13442498925,926943251,14369442176
2015-08-18,LG4,Non-HKUST,14,105,85121,11208952716,612869156,11821821872
2015-08-18,LG4,Total,918,3045,2342427,127920210378,15155341301,143075551679
2015-08-18,All-Floors,Staff,376,3450,2769694,165095349375,11718864108,176814213483
2015-08-18,All-Floors,TPG,151,2170,2357818,183696010153,20106488045,203802498198
2015-08-18,All-Floors,RPG,464,4722,4512427,354396311087,41627399600,396023710687
2015-08-18,All-Floors,UG,952,6269,4040543,198446889740,22609506718,221056396458
2015-08-18,All-Floors,Alumni,24,390,441268,33338512665,2376421607,35714934272
2015-08-18,All-Floors,Others(HKUST),38,934,1368546,40992233763,4298353637,45290587400
2015-08-18,All-Floors,Non-HKUST,47,333,347756,20055978398,2482938227,22538916625
2015-08-18,All-Floors,Total,2052,18268,15838052,996021285181,105219971942,1101241257123
2015-08-19,1,Staff,80,782,1055509,14291857804,2789145612,17081003416
2015-08-19,1,TPG,25,152,296717,11550161891,1380278188,12930440079
2015-08-19,1,RPG,49,275,333748,37317989524,6554790061,43872779585
2015-08-19,1,UG,112,321,328420,17825387447,1559487218,19384874665
2015-08-19,1,Alumni,1,1,0,4822,1100,5922
2015-08-19,1,Others(HKUST),7,60,80802,1578842890,109945764,1688788654
2015-08-19,1,Non-HKUST,0,0,0,0,0,0
2015-08-19,1,Total,274,1591,2095196,82564244378,12393647943,94957892321
2015-08-19,G,Staff,148,809,783952,14604657968,2783161451,17387819419
2015-08-19,G,TPG,78,795,613583,34654593844,3349629168,38004223012
2015-08-19,G,RPG,212,1075,823324,36396995392,4240060327,40637055719
2015-08-19,G,UG,412,1429,711805,30295917097,3971528554,34267445651
2015-08-19,G,Alumni,9,31,55010,1289557547,138319962,1427877509
2015-08-19,G,Others(HKUST),14,74,183130,6916965885,737946580,7654912465
2015-08-19,G,Non-HKUST,15,41,34641,9369808213,680391572,10050199785
2015-08-19,G,Total,888,4254,3205445,133528495946,15901037614,149429533560
2015-08-19,LG1,Staff,116,948,677280,31931379045,3699942335,35631321380
2015-08-19,LG1,TPG,61,555,529442,32303553628,3388317005,35691870633
2015-08-19,LG1,RPG,170,2055,2246594,132834816156,15332507725,148167323881
2015-08-19,LG1,UG,452,3836,3298824,108741078260,10807774313,119548852573
2015-08-19,LG1,Alumni,14,110,142163,2747063645,364022967,3111086612
2015-08-19,LG1,Others(HKUST),18,150,532831,10160236985,1014207197,11174444182
2015-08-19,LG1,Non-HKUST,15,111,105824,7817539486,523202402,8340741888
2015-08-19,LG1,Total,846,7765,7532958,326535667205,35129973944,361665641149
2015-08-19,LG3,Staff,95,300,235882,3862207557,2306066809,6168274366
2015-08-19,LG3,TPG,36,276,322410,20522712398,1915554513,22438266911
2015-08-19,LG3,RPG,140,716,842613,58285244298,5732834111,64018078409
2015-08-19,LG3,UG,409,1132,657412,75367156350,7725680505,83092836855
2015-08-19,LG3,Alumni,10,94,159620,6683999254,433879200,7117878454
2015-08-19,LG3,Others(HKUST),10,75,130215,4220569302,272948049,4493517351
2015-08-19,LG3,Non-HKUST,6,30,29709,22140819540,683007119,22823826659
2015-08-19,LG3,Total,706,2623,2377861,191082708699,19069970306,210152679005
2015-08-19,LG4,Staff,171,559,238130,8509009376,946604124,9455613500
2015-08-19,LG4,TPG,42,213,189726,40988689152,3276595147,44265284299
2015-08-19,LG4,RPG,263,692,467469,23531054392,7733892806,31264947198
2015-08-19,LG4,UG,595,1436,594073,33872920494,2097902401,35970822895
2015-08-19,LG4,Alumni,15,236,243163,25239832378,1523995832,26763828210
2015-08-19,LG4,Others(HKUST),17,236,233122,16507839994,1590974502,18098814496
2015-08-19,LG4,Non-HKUST,13,39,26625,1315563195,132491392,1448054587
2015-08-19,LG4,Total,1116,3411,1992308,149964908981,17302456204,167267365185
2015-08-19,All-Floors,Staff,367,3398,2990753,73199111750,12524920331,85724032081
2015-08-19,All-Floors,TPG,127,1991,1951878,140019710913,13310374021,153330084934
2015-08-19,All-Floors,RPG,506,4813,4713748,288366099762,39594085030,327960184792
2015-08-19,All-Floors,UG,1192,8154,5590534,266102459648,26162372991,292264832639
2015-08-19,All-Floors,Alumni,25,472,599956,35960457646,2460219061,38420676707
2015-08-19,All-Floors,Others(HKUST),32,595,1160100,39384455056,3726022092,43110477148
2015-08-19,All-Floors,Non-HKUST,35,221,196799,40643730434,2019092485,42662822919
2015-08-19,All-Floors,Total,2284,19644,17203768,883676025209,99797086011,983473111220
2015-08-20,1,Staff,78,687,968848,13532927241,939445255,14472372496
2015-08-20,1,TPG,26,130,187716,12257366665,1565978247,13823344912
2015-08-20,1,RPG,47,242,287755,10014821985,4303088055,14317910040
2015-08-20,1,UG,77,259,330687,10492632912,1867947900,12360580812
2015-08-20,1,Alumni,0,0,0,0,0,0
2015-08-20,1,Others(HKUST),6,84,39251,1015452980,64270369,1079723349
2015-08-20,1,Non-HKUST,1,4,1078,698869,229894,928763
2015-08-20,1,Total,235,1406,1815335,47313900652,8740959720,56054860372
2015-08-20,G,Staff,163,940,868014,20560359523,1387440563,21947800086
2015-08-20,G,TPG,89,517,367299,20209035826,1872963714,22081999540
2015-08-20,G,RPG,231,1102,792959,24399486451,2976707053,27376193504
2015-08-20,G,UG,434,1599,965056,40135517436,5083395311,45218912747
2015-08-20,G,Alumni,12,108,56116,459142713,391982837,851125550
2015-08-20,G,Others(HKUST),18,74,145225,5094357344,600283758,5694641102
2015-08-20,G,Non-HKUST,13,52,23417,655666969,78253381,733920350
2015-08-20,G,Total,960,4392,3218086,111513566262,12391026617,123904592879
2015-08-20,LG1,Staff,119,989,675620,31322155033,2604365944,33926520977
2015-08-20,LG1,TPG,70,980,865126,175037187134,14225080083,189262267217
2015-08-20,LG1,RPG,167,2039,1980336,113617271763,21687134352,135304406115
2015-08-20,LG1,UG,302,3205,2525790,150672094140,28713567582,179385661722
2015-08-20,LG1,Alumni,11,104,123871,7858358437,809524933,8667883370
2015-08-20,LG1,Others(HKUST),17,207,561294,27644105360,2462489698,30106595058
2015-08-20,LG1,Non-HKUST,8,72,90877,3839706888,243192662,4082899550
2015-08-20,LG1,Total,694,7596,6822914,509990878755,70745355254,580736234009
2015-08-20,LG3,Staff,101,330,279331,8806176135,717720972,9523897107
2015-08-20,LG3,TPG,40,271,265433,46935057516,2979523506,49914581022
2015-08-20,LG3,RPG,135,748,862579,57397889891,6110382764,63508272655
2015-08-20,LG3,UG,363,945,528521,30309108610,2654712387,32963820997
2015-08-20,LG3,Alumni,17,92,178676,6084300207,398913237,6483213444
2015-08-20,LG3,Others(HKUST),11,70,98235,1519560882,91338831,1610899713
2015-08-20,LG3,Non-HKUST,15,76,72120,13018588480,706894241,13725482721
2015-08-20,LG3,Total,682,2532,2284895,164070681721,13659485938,177730167659
2015-08-20,LG4,Staff,185,561,270878,12858127478,1308922449,14167049927
2015-08-20,LG4,TPG,51,156,99636,7937673905,422388674,8360062579
2015-08-20,LG4,RPG,256,764,488542,31709420991,4911699528,36621120519
2015-08-20,LG4,UG,468,954,343760,28232966037,4006302939,32239268976
2015-08-20,LG4,Alumni,13,163,220414,13122398342,1149325190,14271723532
2015-08-20,LG4,Others(HKUST),18,246,265411,22105651681,3797161631,25902813312
2015-08-20,LG4,Non-HKUST,20,58,43786,2950116532,243075260,3193191792
2015-08-20,LG4,Total,1011,2902,1732427,118916354966,15838875671,134755230637
2015-08-20,All-Floors,Staff,387,3507,3062691,87079745410,6957895183,94037640593
2015-08-20,All-Floors,TPG,143,2054,1785210,262376321046,21065934224,283442255270
2015-08-20,All-Floors,RPG,511,4895,4412171,237138891081,39989011752,277127902833
2015-08-20,All-Floors,UG,1050,6962,4693814,259842319135,42325926119,302168245254
2015-08-20,All-Floors,Alumni,24,467,579077,27524199699,2749746197,30273945896
2015-08-20,All-Floors,Others(HKUST),32,681,1109416,57379128247,7015544287,64394672534
2015-08-20,All-Floors,Non-HKUST,35,262,231278,20464777738,1271645438,21736423176
2015-08-20,All-Floors,Total,2182,18828,15873657,951805382356,121375703200,1073181085556
2015-08-21,1,Staff,78,682,855700,7333468982,1617615129,8951084111
2015-08-21,1,TPG,26,169,217342,6434385727,708296729,7142682456
2015-08-21,1,RPG,48,237,215080,20920705827,1745897782,22666603609
2015-08-21,1,UG,62,203,265864,12362691309,1214652399,13577343708
2015-08-21,1,Alumni,0,0,0,0,0,0
2015-08-21,1,Others(HKUST),7,32,39229,2039172418,84931175,2124103593
2015-08-21,1,Non-HKUST,0,0,0,0,0,0
2015-08-21,1,Total,221,1323,1593215,49090424263,5371393214,54461817477
2015-08-21,G,Staff,163,1020,869100,8294586575,2793693185,11088279760
2015-08-21,G,TPG,100,777,596934,44837455701,4254344674,49091800375
2015-08-21,G,RPG,238,1218,1052993,37084313230,5048631155,42132944385
2015-08-21,G,UG,442,1537,1145438,34673805361,3021320807,37695126168
2015-08-21,G,Alumni,5,35,33296,997601361,494269350,1491870711
2015-08-21,G,Others(HKUST),23,120,186137,1232496642,157866827,1390363469
2015-08-21,G,Non-HKUST,19,58,43314,910077133,107733467,1017810600
2015-08-21,G,Total,990,4765,3927212,128030336003,15877859465,143908195468
2015-08-21,LG1,Staff,121,971,668550,37729181469,4948448135,42677629604
2015-08-21,LG1,TPG,93,934,887176,52332861690,10971006001,63303867691
2015-08-21,LG1,RPG,203,2164,1851119,115415574944,16877731117,132293306061
2015-08-21,LG1,UG,361,3383,3035136,245128810364,25375673881,270504484245
2015-08-21,LG1,Alumni,11,103,127658,4036909127,491178175,4528087302
2015-08-21,LG1,Others(HKUST),14,134,477215,10680107509,827244883,11507352392
2015-08-21,LG1,Non-HKUST,13,67,57666,981109756,153441903,1134551659
2015-08-21,LG1,Total,816,7756,7104520,466304554859,59644724095,525949278954
2015-08-21,LG3,Staff,108,380,224514,15518945129,1999451403,17518396532
2015-08-21,LG3,TPG,43,190,151600,18314965591,1682932641,19997898232
2015-08-21,LG3,RPG,152,652,801908,43340565980,16395868589,59736434569
2015-08-21,LG3,UG,475,1094,597861,23935906436,2520990837,26456897273
2015-08-21,LG3,Alumni,10,73,103364,4233319267,2716507835,6949827102
2015-08-21,LG3,Others(HKUST),12,85,133315,7115676465,372545434,7488221899
2015-08-21,LG3,Non-HKUST,10,26,14209,771542259,282355586,1053897845
2015-08-21,LG3,Total,810,2500,2026771,113230921127,25970652325,139201573452
2015-08-21,LG4,Staff,156,515,233804,13658225223,1889903925,15548129148
2015-08-21,LG4,TPG,53,296,259870,45772561256,2442190988,48214752244
2015-08-21,LG4,RPG,215,647,431952,27081671355,1730510521,28812181876
2015-08-21,LG4,UG,444,1001,492732,35559783481,16612882300,52172665781
2015-08-21,LG4,Alumni,10,175,227605,16065420263,4829908173,20895328436
2015-08-21,LG4,Others(HKUST),14,227,243818,9180349820,1282030938,10462380758
2015-08-21,LG4,Non-HKUST,21,97,62939,5071177510,657614505,5728792015
2015-08-21,LG4,Total,913,2958,1952720,152389188908,29445041350,181834230258
2015-08-21,All-Floors,Staff,373,3568,2851668,82534407378,13249111777,95783519155
2015-08-21,All-Floors,TPG,156,2366,2112922,167692229965,20058771033,187751000998
2015-08-21,All-Floors,RPG,500,4918,4353052,243842831336,41798639164,285641470500
2015-08-21,All-Floors,UG,1172,7218,5537031,351660996951,48745520224,400406517175
2015-08-21,All-Floors,Alumni,23,386,491923,25333250018,8531863533,33865113551
2015-08-21,All-Floors,Others(HKUST),33,598,1079714,30247802854,2724619257,32972422111
2015-08-21,All-Floors,Non-HKUST,38,248,178128,7733906658,1201145461,8935052119
2015-08-21,All-Floors,Total,2295,19302,16604438,909045425160,136309670449,1045355095609
2015-08-22,1,Staff,17,83,100671,2132836950,137437673,2270274623
2015-08-22,1,TPG,16,86,98213,4133346266,395191319,4528537585
2015-08-22,1,RPG,31,132,132054,9020743440,498437158,9519180598
2015-08-22,1,UG,42,134,182506,3698170516,537041332,4235211848
2015-08-22,1,Alumni,0,0,0,0,0,0
2015-08-22,1,Others(HKUST),3,32,16967,3892231990,150770445,4043002435
2015-08-22,1,Non-HKUST,1,1,0,0,0,0
2015-08-22,1,Total,110,468,530411,22877329162,1718877927,24596207089
2015-08-22,G,Staff,45,326,323189,7172471661,399550600,7572022261
2015-08-22,G,TPG,71,479,508639,44758188775,7198936726,51957125501
2015-08-22,G,RPG,184,918,560054,16600093072,4837640654,21437733726
2015-08-22,G,UG,212,654,397159,9712597264,1400922318,11113519582
2015-08-22,G,Alumni,16,77,69986,11549414222,1239169829,12788584051
2015-08-22,G,Others(HKUST),11,40,128787,2505032874,227503009,2732535883
2015-08-22,G,Non-HKUST,15,38,36000,744698223,728381721,1473079944
2015-08-22,G,Total,554,2532,2023814,93042496091,16032104857,109074600948
2015-08-22,LG1,Staff,45,325,340907,30496056518,2746682451,33242738969
2015-08-22,LG1,TPG,67,629,716543,65234318576,6217731650,71452050226
2015-08-22,LG1,RPG,183,1496,1531808,69333010793,10881801090,80214811883
2015-08-22,LG1,UG,185,1644,1473932,69603387725,10681788305,80285176030
2015-08-22,LG1,Alumni,12,114,105220,1897008174,173804448,2070812622
2015-08-22,LG1,Others(HKUST),13,172,612164,12714996509,923933894,13638930403
2015-08-22,LG1,Non-HKUST,15,147,119659,13909179892,762455944,14671635836
2015-08-22,LG1,Total,520,4527,4900233,263187958187,32388197782,295576155969
2015-08-22,LG3,Staff,44,121,104003,5498276251,275753634,5774029885
2015-08-22,LG3,TPG,37,158,230998,16992743063,656463508,17649206571
2015-08-22,LG3,RPG,123,463,419450,33765585903,2276203351,36041789254
2015-08-22,LG3,UG,262,443,236595,33262199127,2230798772,35492997899
2015-08-22,LG3,Alumni,19,88,107331,4539046507,300603785,4839650292
2015-08-22,LG3,Others(HKUST),8,75,104050,455320980,27935700,483256680
2015-08-22,LG3,Non-HKUST,22,106,176327,22324177910,2773486333,25097664243
2015-08-22,LG3,Total,515,1454,1378754,116837349741,8541245083,125378594824
2015-08-22,LG4,Staff,42,116,99843,6071472296,297621854,6369094150
2015-08-22,LG4,TPG,46,232,161484,15022491950,3191951725,18214443675
2015-08-22,LG4,RPG,170,648,509296,13322671121,4477466053,17800137174
2015-08-22,LG4,UG,236,480,207618,12841917462,1019505705,13861423167
2015-08-22,LG4,Alumni,21,279,293046,41722741853,2477522292,44200264145
2015-08-22,LG4,Others(HKUST),9,131,275594,47747974457,14168684760,61916659217
2015-08-22,LG4,Non-HKUST,24,73,48207,2693716887,263997784,2957714671
2015-08-22,LG4,Total,548,1959,1595088,139422986026,25896750173,165319736199
2015-08-22,All-Floors,Staff,115,971,968613,51371113676,3857046212,55228159888
2015-08-22,All-Floors,TPG,119,1584,1715877,146141088630,17660274928,163801363558
2015-08-22,All-Floors,RPG,344,3657,3152662,142042104329,22971548306,165013652635
2015-08-22,All-Floors,UG,659,3355,2497810,129118272094,15870056432,144988328526
2015-08-22,All-Floors,Alumni,36,558,575583,59708210756,4191100354,63899311110
2015-08-22,All-Floors,Others(HKUST),23,450,1137562,67315556810,15498827808,82814384618
2015-08-22,All-Floors,Non-HKUST,44,365,380193,39671772912,4528321782,44200094694
2015-08-22,All-Floors,Total,1340,10940,10428300,635368119207,84577175822,719945295029
2015-08-23,1,Staff,6,21,9244,279187609,14339497,293527106
2015-08-23,1,TPG,5,9,2396,31596,15169,46765
2015-08-23,1,RPG,13,20,8146,41476310,4401115,45877425
2015-08-23,1,UG,33,33,6949,4100706,1691845,5792551
2015-08-23,1,Alumni,0,0,0,0,0,0
2015-08-23,1,Others(HKUST),1,1,0,13606206,979484,14585690
2015-08-23,1,Non-HKUST,0,0,0,0,0,0
2015-08-23,1,Total,58,84,26735,338402427,21427110,359829537
2015-08-23,G,Staff,13,56,65997,138607153,10975469,149582622
2015-08-23,G,TPG,10,13,7299,1234487049,75390757,1309877806
2015-08-23,G,RPG,32,47,26260,1567937026,160145034,1728082060
2015-08-23,G,UG,140,169,53616,2602777678,191899631,2794677309
2015-08-23,G,Alumni,2,4,1421,45324,22713,68037
2015-08-23,G,Others(HKUST),3,4,87001,584355788,94756447,679112235
2015-08-23,G,Non-HKUST,0,0,0,0,0,0
2015-08-23,G,Total,200,293,241594,6128210018,533190051,6661400069
2015-08-23,LG1,Staff,33,296,371421,11783570030,802589556,12586159586
2015-08-23,LG1,TPG,80,1192,1856064,92862735768,9784089459,102646825227
2015-08-23,LG1,RPG,138,1629,2199873,74797862960,10497506621,85295369581
2015-08-23,LG1,UG,154,1015,1197532,36226883678,3720090352,39946974030
2015-08-23,LG1,Alumni,8,153,185015,21326371682,12794899576,34121271258
2015-08-23,LG1,Others(HKUST),8,108,588120,4385537312,307536015,4693073327
2015-08-23,LG1,Non-HKUST,9,53,90232,1168209146,86388126,1254597272
2015-08-23,LG1,Total,430,4446,6488257,242551170576,37993099705,280544270281
2015-08-23,LG3,Staff,29,44,16095,85226854,5971415,91198269
2015-08-23,LG3,TPG,38,66,27449,3425464313,311924943,3737389256
2015-08-23,LG3,RPG,52,93,53194,510444242,84346070,594790312
2015-08-23,LG3,UG,459,695,237156,3318514682,368908658,3687423340
2015-08-23,LG3,Alumni,8,22,7736,46001059,85208581,131209640
2015-08-23,LG3,Others(HKUST),8,48,73856,5175509,3010164,8185673
2015-08-23,LG3,Non-HKUST,5,7,3127,394537,395382,789919
2015-08-23,LG3,Total,599,975,418613,7391221196,859765213,8250986409
2015-08-23,LG4,Staff,39,58,25771,19521112,3843023,23364135
2015-08-23,LG4,TPG,22,32,9339,6459594588,213708104,6673302692
2015-08-23,LG4,RPG,104,150,57358,724412050,110529242,834941292
2015-08-23,LG4,UG,317,512,211202,1124998913,390737983,1515736896
2015-08-23,LG4,Alumni,7,14,15111,4294581433,89601563,4384182996
2015-08-23,LG4,Others(HKUST),6,72,201805,36954109226,13138636294,50092745520
2015-08-23,LG4,Non-HKUST,5,11,12494,1083748942,58028246,1141777188
2015-08-23,LG4,Total,500,849,533080,50660966264,14005084455,64666050719
2015-08-23,All-Floors,Staff,95,475,488528,12306112758,837718960,13143831718
2015-08-23,All-Floors,TPG,99,1312,1902547,103982313314,10385128432,114367441746
2015-08-23,All-Floors,RPG,258,1939,2344831,77642132588,10856928082,88499060670
2015-08-23,All-Floors,UG,906,2424,1706455,43277275657,4673328469,47950604126
2015-08-23,All-Floors,Alumni,18,193,209283,25666999498,12969732433,38636731931
2015-08-23,All-Floors,Others(HKUST),14,233,950782,41942784041,13544918404,55487702445
2015-08-23,All-Floors,Non-HKUST,19,71,105853,2252352625,144811754,2397164379
2015-08-23,All-Floors,Total,1409,6647,7708279,307069970481,53412566534,360482537015
2015-08-24,1,Staff,73,592,844012,4181490338,586799397,4768289735
2015-08-24,1,TPG,39,347,517969,32380068958,5919122575,38299191533
2015-08-24,1,RPG,52,247,345045,9672142919,656515523,10328658442
2015-08-24,1,UG,72,359,354827,6577583725,723980009,7301563734
2015-08-24,1,Alumni,0,0,0,0,0,0
2015-08-24,1,Others(HKUST),6,38,15443,353961251,24122523,378083774
2015-08-24,1,Non-HKUST,1,10,20421,4045052648,133743295,4178795943
2015-08-24,1,Total,243,1593,2097717,57210299839,8044283322,65254583161
2015-08-24,G,Staff,178,1057,907579,16312668338,1414097609,17726765947
2015-08-24,G,TPG,149,1203,945614,75157609696,20533295021,95690904717
2015-08-24,G,RPG,238,1167,856043,48325500678,4943011642,53268512320
2015-08-24,G,UG,489,2087,1167694,24037512242,4108550677,28146062919
2015-08-24,G,Alumni,6,25,27072,182540578,44894440,227435018
2015-08-24,G,Others(HKUST),20,107,219194,7896594668,12237483802,20134078470
2015-08-24,G,Non-HKUST,15,62,47309,2614968172,105649369,2720617541
2015-08-24,G,Total,1095,5708,4170505,174527394372,43386982560,217914376932
2015-08-24,LG1,Staff,115,846,761766,17927658710,4261200561,22188859271
2015-08-24,LG1,TPG,140,1946,1706268,161804921539,11552760252,173357681791
2015-08-24,LG1,RPG,209,2865,2755036,123825339437,20607045050,144432384487
2015-08-24,LG1,UG,490,5550,4571288,201084680904,23794393428,224879074332
2015-08-24,LG1,Alumni,14,94,129666,1625340398,184621271,1809961669
2015-08-24,LG1,Others(HKUST),15,388,740486,29445149732,2343537570,31788687302
2015-08-24,LG1,Non-HKUST,11,41,46281,3084800967,258275127,3343076094
2015-08-24,LG1,Total,994,11730,10710791,538797891687,63001833259,601799724946
2015-08-24,LG3,Staff,102,356,281708,11386513232,838408740,12224921972
2015-08-24,LG3,TPG,77,467,368118,53517115271,3679958974,57197074245
2015-08-24,LG3,RPG,146,770,704893,58857136650,3626602494,62483739144
2015-08-24,LG3,UG,458,1077,414171,22581874081,4587318736,27169192817
2015-08-24,LG3,Alumni,7,30,43410,264043848,29564399,293608247
2015-08-24,LG3,Others(HKUST),12,116,101342,5898552373,419100147,6317652520
2015-08-24,LG3,Non-HKUST,11,113,134253,9165018735,770296884,9935315619
2015-08-24,LG3,Total,813,2929,2047895,161670254190,13951250374,175621504564
2015-08-24,LG4,Staff,158,616,303749,50367257012,7923116892,58290373904
2015-08-24,LG4,TPG,62,369,205885,18960945896,1320532325,20281478221
2015-08-24,LG4,RPG,238,701,521887,27848463000,16404572953,44253035953
2015-08-24,LG4,UG,395,899,395418,9346481501,1080571897,10427053398
2015-08-24,LG4,Alumni,9,80,125204,3605157337,246274434,3851431771
2015-08-24,LG4,Others(HKUST),23,217,233995,82210448436,26791327094,109001775530
2015-08-24,LG4,Non-HKUST,16,59,40506,1125112330,99529800,1224642130
2015-08-24,LG4,Total,901,2941,1826644,193463865512,53865925395,247329790907
2015-08-24,All-Floors,Staff,374,3467,3098814,100175587630,15023623199,115199210829
2015-08-24,All-Floors,TPG,223,4332,3743854,341820661360,43005669147,384826330507
2015-08-24,All-Floors,RPG,532,5750,5182904,268528582684,46237747662,314766330346
2015-08-24,All-Floors,UG,1159,9972,6903398,263628132453,34294814747,297922947200
2015-08-24,All-Floors,Alumni,20,229,325352,5677082161,505354544,6182436705
2015-08-24,All-Floors,Others(HKUST),35,866,1310460,125804706460,41815571136,167620277596
2015-08-24,All-Floors,Non-HKUST,35,285,288770,20034952852,1367494475,21402447327
2015-08-24,All-Floors,Total,2378,24901,20853552,1125669705600,182250274910,1307919980510
2015-08-25,1,Staff,84,729,1063473,13796344248,964584699,14760928947
2015-08-25,1,TPG,47,257,321681,13765597997,1387114848,15152712845
2015-08-25,1,RPG,39,169,299966,8209460704,620272568,8829733272
2015-08-25,1,UG,97,327,436166,25756401390,1557618817,27314020207
2015-08-25,1,Alumni,0,0,0,0,0,0
2015-08-25,1,Others(HKUST),4,29,11893,456144199,64638949,520783148
2015-08-25,1,Non-HKUST,3,13,20656,3516210931,107973138,3624184069
2015-08-25,1,Total,274,1524,2153835,65500159469,4702203019,70202362488
2015-08-25,G,Staff,170,1201,862453,22976514050,22525434203,45501948253
2015-08-25,G,TPG,214,1406,1046395,50175583016,7852498009,58028081025
2015-08-25,G,RPG,203,880,721957,31940031766,5055106295,36995138061
2015-08-25,G,UG,587,2821,1683287,71500941052,12906846589,84407787641
2015-08-25,G,Alumni,9,37,44299,34048006158,888251673,34936257831
2015-08-25,G,Others(HKUST),14,119,194262,6618273855,1089675230,7707949085
2015-08-25,G,Non-HKUST,17,80,37629,9985432673,1677908361,11663341034
2015-08-25,G,Total,1214,6544,4590282,227244782570,51995720360,279240502930
2015-08-25,LG1,Staff,133,1114,857691,28920910564,2500268831,31421179395
2015-08-25,LG1,TPG,177,2823,1996407,140104166000,29885212771,169989378771
2015-08-25,LG1,RPG,176,2647,2326450,94807613649,14147184294,108954797943
2015-08-25,LG1,UG,543,5474,3923702,193270351076,22252888583,215523239659
2015-08-25,LG1,Alumni,15,203,250715,9692033269,970848220,10662881489
2015-08-25,LG1,Others(HKUST),17,371,731043,18897323282,1848909848,20746233130
2015-08-25,LG1,Non-HKUST,12,78,59633,2401102664,114230250,2515332914
2015-08-25,LG1,Total,1073,12710,10145641,488093500504,71719542797,559813043301
2015-08-25,LG3,Staff,97,371,263636,8342876263,482896214,8825772477
2015-08-25,LG3,TPG,76,446,345171,29728316327,5474295948,35202612275
2015-08-25,LG3,RPG,142,769,841527,130227595170,6947045744,137174640914
2015-08-25,LG3,UG,471,1113,604373,42677104213,3679260821,46356365034
2015-08-25,LG3,Alumni,10,30,29747,1334925032,83594815,1418519847
2015-08-25,LG3,Others(HKUST),11,106,87522,731769553,55157275,786926828
2015-08-25,LG3,Non-HKUST,9,61,40890,8239277550,319991931,8559269481
2015-08-25,LG3,Total,816,2896,2212866,221281864108,17042242748,238324106856
2015-08-25,LG4,Staff,174,723,294303,49047652802,2729262195,51776914997
2015-08-25,LG4,TPG,87,449,252742,8547201593,1502489689,10049691282
2015-08-25,LG4,RPG,233,878,698794,23731373683,4045244010,27776617693
2015-08-25,LG4,UG,514,1211,493285,26701962884,3434433142,30136396026
2015-08-25,LG4,Alumni,10,126,107357,5854915959,491883579,6346799538
2015-08-25,LG4,Others(HKUST),13,173,261175,13654106534,824593067,14478699601
2015-08-25,LG4,Non-HKUST,7,87,40589,1565328625,190167885,1755496510
2015-08-25,LG4,Total,1038,3647,2148245,129102542080,13218073567,142320615647
2015-08-25,All-Floors,Staff,395,4138,3341556,123084297927,29202446142,152286744069
2015-08-25,All-Floors,TPG,301,5381,3962396,242320864933,46101611265,288422476198
2015-08-25,All-Floors,RPG,488,5343,4888694,288916074972,30814852911,319730927883
2015-08-25,All-Floors,UG,1319,10946,7140813,359906760615,43831047952,403737808567
2015-08-25,All-Floors,Alumni,23,396,432118,50929880418,2434578287,53364458705
2015-08-25,All-Floors,Others(HKUST),27,798,1285895,40357617423,3882974369,44240591792
2015-08-25,All-Floors,Non-HKUST,27,319,199397,25707352443,2410271565,28117624008
2015-08-25,All-Floors,Total,2580,27321,21250869,1131222848731,158677782491,1289900631222
2015-08-26,1,Staff,84,833,1078577,15848823777,4914702641,20763526418
2015-08-26,1,TPG,45,428,496126,18750437174,4217150720,22967587894
2015-08-26,1,RPG,61,369,610681,20233025412,3960139787,24193165199
2015-08-26,1,UG,92,311,347526,8475399916,1060552172,9535952088
2015-08-26,1,Alumni,0,0,0,0,0,0
2015-08-26,1,Others(HKUST),5,32,14660,146100009,272873312,418973321
2015-08-26,1,Non-HKUST,3,5,7322,65112815,10718309,75831124
2015-08-26,1,Total,290,1978,2554892,63518899103,14436136941,77955036044
2015-08-26,G,Staff,165,1006,813766,12255891830,1289550428,13545442258
2015-08-26,G,TPG,177,1097,907371,112994737308,6007088121,119001825429
2015-08-26,G,RPG,203,1107,864275,32049953979,3196026541,35245980520
2015-08-26,G,UG,558,2759,1470179,44936583142,5505909591,50442492733
2015-08-26,G,Alumni,4,31,12991,172750706,20221625,192972331
2015-08-26,G,Others(HKUST),16,100,193705,7427274361,2025816069,9453090430
2015-08-26,G,Non-HKUST,13,55,20788,1101541486,168749456,1270290942
2015-08-26,G,Total,1136,6155,4283075,210938732812,18213361831,229152094643
2015-08-26,LG1,Staff,140,1039,868271,23610970207,3022524708,26633494915
2015-08-26,LG1,TPG,155,1946,2213113,172289221098,15513115918,187802337016
2015-08-26,LG1,RPG,211,2576,2700690,99992252359,9325160791,109317413150
2015-08-26,LG1,UG,543,4658,3180600,155965333919,22263976272,178229310191
2015-08-26,LG1,Alumni,12,137,216703,6779475728,5005895593,11785371321
2015-08-26,LG1,Others(HKUST),18,246,654373,1742218783,879709953,2621928736
2015-08-26,LG1,Non-HKUST,10,88,85171,1615978786,158863304,1774842090
2015-08-26,LG1,Total,1089,10690,9918921,461995450880,56169246539,518164697419
2015-08-26,LG3,Staff,122,320,145019,3106175477,1890002815,4996178292
2015-08-26,LG3,TPG,83,458,459195,106282845636,6998785726,113281631362
2015-08-26,LG3,RPG,156,796,777764,77516022920,6259723069,83775745989
2015-08-26,LG3,UG,437,1444,878856,59627910955,3820421395,63448332350
2015-08-26,LG3,Alumni,5,15,16878,711235101,34714362,745949463
2015-08-26,LG3,Others(HKUST),14,90,120502,1191844833,391077470,1582922303
2015-08-26,LG3,Non-HKUST,6,48,61084,2460228011,134115771,2594343782
2015-08-26,LG3,Total,823,3171,2459298,250896262933,19528840608,270425103541
2015-08-26,LG4,Staff,173,521,250424,4371908614,721176580,5093085194
2015-08-26,LG4,TPG,80,346,202190,7464809097,1163496006,8628305103
2015-08-26,LG4,RPG,260,888,744997,18250568123,6817358084,25067926207
2015-08-26,LG4,UG,627,1488,569181,64473997974,5843268975,70317266949
2015-08-26,LG4,Alumni,10,117,158728,6095256919,1838985367,7934242286
2015-08-26,LG4,Others(HKUST),21,261,281522,14189547181,4301451031,18490998212
2015-08-26,LG4,Non-HKUST,8,75,36305,1770293904,279195007,2049488911
2015-08-26,LG4,Total,1179,3696,2243347,116616381812,20964931050,137581312862
2015-08-26,All-Floors,Staff,410,3719,3156057,59193769905,11837957172,71031727077
2015-08-26,All-Floors,TPG,262,4275,4277995,417782050313,33899636491,451681686804
2015-08-26,All-Floors,RPG,523,5736,5698407,248041822793,29558408272,277600231065
2015-08-26,All-Floors,UG,1400,10660,6446342,333479225906,38494128405,371973354311
2015-08-26,All-Floors,Alumni,24,300,405300,13758718454,6899816947,20658535401
2015-08-26,All-Floors,Others(HKUST),41,729,1264762,24696985167,7870927835,32567913002
2015-08-26,All-Floors,Non-HKUST,31,271,210670,7013155002,751641847,7764796849
2015-08-26,All-Floors,Total,2691,25690,21459533,1103965727540,129312516969,1233278244509
2015-08-27,1,Staff,70,722,935145,7867408520,2016402323,9883810843
2015-08-27,1,TPG,44,362,404427,43893150532,7634508896,51527659428
2015-08-27,1,RPG,54,371,555308,36058901998,2591456416,38650358414
2015-08-27,1,UG,92,371,425190,24629502795,2650751127,27280253922
2015-08-27,1,Alumni,0,0,0,0,0,0
2015-08-27,1,Others(HKUST),6,34,5249,1192785134,29449642,1222234776
2015-08-27,1,Non-HKUST,3,7,608,360369,309311,669680
2015-08-27,1,Total,269,1867,2325927,113642109348,14922877715,128564987063
2015-08-27,G,Staff,150,971,839080,11921977005,1658281484,13580258489
2015-08-27,G,TPG,137,1156,702518,33483797449,5198486292,38682283741
2015-08-27,G,RPG,183,974,677932,27262263031,2952349459,30214612490
2015-08-27,G,UG,564,2781,1580098,182551865666,22067573442,204619439108
2015-08-27,G,Alumni,12,66,27770,1975437160,236013890,2211451050
2015-08-27,G,Others(HKUST),18,95,220285,7939211746,1484145067,9423356813
2015-08-27,G,Non-HKUST,21,83,47263,16230152486,11278380995,27508533481
2015-08-27,G,Total,1085,6126,4094946,281364704543,44875230629,326239935172
2015-08-27,LG1,Staff,107,764,749233,21990430512,2901031912,24891462424
2015-08-27,LG1,TPG,148,2598,2465638,219039018906,27059771509,246098790415
2015-08-27,LG1,RPG,185,2242,2575731,178753108390,15930742702,194683851092
2015-08-27,LG1,UG,548,5549,4366960,270136696480,21452559973,291589256453
2015-08-27,LG1,Alumni,15,222,272766,11564369154,7233537678,18797906832
2015-08-27,LG1,Others(HKUST),12,183,600789,5500700519,450817231,5951517750
2015-08-27,LG1,Non-HKUST,17,79,76748,5408158414,2597960154,8006118568
2015-08-27,LG1,Total,1032,11637,11107865,712392482375,77626421159,790018903534
2015-08-27,LG3,Staff,108,352,161623,13121017771,1594430594,14715448365
2015-08-27,LG3,TPG,84,410,266443,28698896457,3240877609,31939774066
2015-08-27,LG3,RPG,139,755,818556,54590581155,4727218339,59317799494
2015-08-27,LG3,UG,357,1463,787559,57487333954,36238546976,93725880930
2015-08-27,LG3,Alumni,8,66,41102,458079381,198200415,656279796
2015-08-27,LG3,Others(HKUST),8,81,109913,978697680,110540842,1089238522
2015-08-27,LG3,Non-HKUST,16,55,26722,389182312,42776410,431958722
2015-08-27,LG3,Total,720,3182,2211918,155723788710,46152591185,201876379895
2015-08-27,LG4,Staff,151,477,287351,14743072790,1097123171,15840195961
2015-08-27,LG4,TPG,69,434,313513,48685205860,5808830486,54494036346
2015-08-27,LG4,RPG,215,1111,773667,84810851513,9301277943,94112129456
2015-08-27,LG4,UG,475,1364,641486,26660940359,3403175278,30064115637
2015-08-27,LG4,Alumni,16,106,199715,5084856273,466217752,5551074025
2015-08-27,LG4,Others(HKUST),19,206,238660,18120824919,1468395707,19589220626
2015-08-27,LG4,Non-HKUST,25,74,38768,265885399,45153668,311039067
2015-08-27,LG4,Total,970,3772,2493160,198371637113,21590174005,219961811118
2015-08-27,All-Floors,Staff,358,3286,2972432,69643906598,9267269484,78911176082
2015-08-27,All-Floors,TPG,235,4960,4152539,373800069204,48942474792,422742543996
2015-08-27,All-Floors,RPG,466,5453,5401194,381475706087,35503044859,416978750946
2015-08-27,All-Floors,UG,1255,11528,7801293,561466339254,85812606796,647278946050
2015-08-27,All-Floors,Alumni,29,460,541353,19082741968,8133969735,27216711703
2015-08-27,All-Floors,Others(HKUST),35,599,1174896,33732219998,3543348489,37275568487
2015-08-27,All-Floors,Non-HKUST,58,298,190109,22293738980,13964580538,36258319518
2015-08-27,All-Floors,Total,2436,26584,22233816,1461494722089,205167294693,1666662016782
2015-08-28,1,Staff,69,649,821597,9440337885,1097380646,10537718531
2015-08-28,1,TPG,50,361,529405,33987497743,4046760937,38034258680
2015-08-28,1,RPG,45,464,530264,13843637782,4548755055,18392392837
2015-08-28,1,UG,124,714,520845,27536769247,2311758569,29848527816
2015-08-28,1,Alumni,1,26,13006,1546938095,92563033,1639501128
2015-08-28,1,Others(HKUST),5,71,52531,2705948627,140881985,2846830612
2015-08-28,1,Non-HKUST,4,37,42318,10973817417,473605584,11447423001
2015-08-28,1,Total,298,2322,2509966,100034946796,12711705809,112746652605
2015-08-28,G,Staff,146,1084,828249,19204195027,1622342351,20826537378
2015-08-28,G,TPG,193,1382,922950,47627765925,12054192088,59681958013
2015-08-28,G,RPG,215,1089,775177,21873989444,3607898178,25481887622
2015-08-28,G,UG,631,2793,1377799,71229628602,11382399117,82612027719
2015-08-28,G,Alumni,12,100,43068,11169136266,433077712,11602213978
2015-08-28,G,Others(HKUST),19,118,222031,6334609687,992310532,7326920219
2015-08-28,G,Non-HKUST,24,87,38342,425163370,215365198,640528568
2015-08-28,G,Total,1240,6653,4207616,177864488321,30307585176,208172073497
2015-08-28,LG1,Staff,101,1035,701891,17656442639,3702395283,21358837922
2015-08-28,LG1,TPG,187,3049,2613925,181810026217,32503188534,214313214751
2015-08-28,LG1,RPG,201,2561,2620762,153166441609,15830810982,168997252591
2015-08-28,LG1,UG,582,5447,4269054,205578376054,29182899850,234761275904
2015-08-28,LG1,Alumni,17,232,225269,15985397969,2048993952,18034391921
2015-08-28,LG1,Others(HKUST),25,333,738679,27691849397,2419729529,30111578926
2015-08-28,LG1,Non-HKUST,18,177,116347,142808743344,12548020971,155356764315
2015-08-28,LG1,Total,1131,12834,11285927,744697277229,98236039101,842933316330
2015-08-28,LG3,Staff,90,357,224075,4337508109,431459760,4768967869
2015-08-28,LG3,TPG,119,683,549729,49013847146,3273450563,52287297709
2015-08-28,LG3,RPG,139,574,594242,44503305676,4968469574,49471775250
2015-08-28,LG3,UG,533,1405,619908,24257434515,3042557772,27299992287
2015-08-28,LG3,Alumni,9,113,72240,5403907193,1113327619,6517234812
2015-08-28,LG3,Others(HKUST),13,128,146789,6332182838,268425191,6600608029
2015-08-28,LG3,Non-HKUST,15,32,11706,1729432668,171770036,1901202704
2015-08-28,LG3,Total,918,3292,2218689,135577618145,13269460515,148847078660
2015-08-28,LG4,Staff,152,506,274605,13981295294,1383785523,15365080817
2015-08-28,LG4,TPG,103,607,512070,38752042847,5154071526,43906114373
2015-08-28,LG4,RPG,237,1048,818887,46591155649,5195323167,51786478816
2015-08-28,LG4,UG,663,1590,622004,27098886350,2833804003,29932690353
2015-08-28,LG4,Alumni,14,65,126168,4401065909,792914531,5193980440
2015-08-28,LG4,Others(HKUST),16,187,264802,14882130872,1000700689,15882831561
2015-08-28,LG4,Non-HKUST,23,51,14299,204857076,181471898,386328974
2015-08-28,LG4,Total,1208,4054,2632835,145911433997,16542071337,162453505334
2015-08-28,All-Floors,Staff,335,3631,2850417,64619778954,8237363563,72857142517
2015-08-28,All-Floors,TPG,306,6082,5128079,351191179878,57031663648,408222843526
2015-08-28,All-Floors,RPG,508,5736,5339332,279978530160,34151256956,314129787116
2015-08-28,All-Floors,UG,1477,11949,7409610,355701094768,48753419311,404454514079
2015-08-28,All-Floors,Alumni,30,536,479751,38506445432,4480876847,42987322279
2015-08-28,All-Floors,Others(HKUST),38,837,1424832,57946721421,4822047926,62768769347
2015-08-28,All-Floors,Non-HKUST,57,384,223012,156142013875,13590233687,169732247562
2015-08-28,All-Floors,Total,2751,29155,22855033,1304085764488,171066861938,1475152626426
2015-08-29,1,Staff,13,167,148693,1715357716,122525076,1837882792
2015-08-29,1,TPG,75,482,515754,41081423629,5466530756,46547954385
2015-08-29,1,RPG,24,117,127156,4478962472,335798935,4814761407
2015-08-29,1,UG,62,252,302781,13058382660,972570512,14030953172
2015-08-29,1,Alumni,0,0,0,0,0,0
2015-08-29,1,Others(HKUST),3,5,13356,253404739,7751760,261156499
2015-08-29,1,Non-HKUST,6,20,33338,1477666027,91231644,1568897671
2015-08-29,1,Total,183,1043,1141078,62065197243,6996408683,69061605926
2015-08-29,G,Staff,50,229,202029,4305563739,319694367,4625258106
2015-08-29,G,TPG,327,1949,1056135,102707044814,11061467142,113768511956
2015-08-29,G,RPG,132,537,345108,16676499587,1298333000,17974832587
2015-08-29,G,UG,308,1144,660223,20522411580,3505427837,24027839417
2015-08-29,G,Alumni,24,72,51929,3910610174,332465523,4243075697
2015-08-29,G,Others(HKUST),10,40,149536,3690507310,615219057,4305726367
2015-08-29,G,Non-HKUST,22,63,54305,10890390997,624731258,11515122255
2015-08-29,G,Total,873,4034,2519265,162703028201,17757338184,180460366385
2015-08-29,LG1,Staff,48,450,364894,21335138065,3905254779,25240392844
2015-08-29,LG1,TPG,289,3666,3037202,229527863547,28014179057,257542042604
2015-08-29,LG1,RPG,168,2054,2334128,193399894669,12425939110,205825833779
2015-08-29,LG1,UG,359,3213,3074294,117809231616,17469603553,135278835169
2015-08-29,LG1,Alumni,27,360,356980,45791106196,20152222546,65943328742
2015-08-29,LG1,Others(HKUST),10,164,601670,5936440665,656514724,6592955389
2015-08-29,LG1,Non-HKUST,17,101,98849,14235634091,2303665683,16539299774
2015-08-29,LG1,Total,918,10008,9868017,628035308849,84927379452,712962688301
2015-08-29,LG3,Staff,48,152,102090,7998307272,747470351,8745777623
2015-08-29,LG3,TPG,180,738,510634,40893078956,3570020273,44463099229
2015-08-29,LG3,RPG,116,482,515146,65377011727,4457326631,69834338358
2015-08-29,LG3,UG,377,912,455013,17195815807,1918937940,19114753747
2015-08-29,LG3,Alumni,25,140,141537,8271952206,828102315,9100054521
2015-08-29,LG3,Others(HKUST),10,56,84018,298114044,25293212,323407256
2015-08-29,LG3,Non-HKUST,19,47,56720,8863067279,323483282,9186550561
2015-08-29,LG3,Total,775,2527,1865158,148897347291,11870634004,160767981295
2015-08-29,LG4,Staff,49,160,119229,5423173006,608097347,6031270353
2015-08-29,LG4,TPG,209,985,437677,34421232097,5456538057,39877770154
2015-08-29,LG4,RPG,165,708,602007,80175510385,6339745287,86515255672
2015-08-29,LG4,UG,452,985,523073,10168676258,1618832891,11787509149
2015-08-29,LG4,Alumni,19,178,247740,7475264974,1493495640,8968760614
2015-08-29,LG4,Others(HKUST),9,119,293597,18590549864,1856319348,20446869212
2015-08-29,LG4,Non-HKUST,21,85,63199,7743980584,419519542,8163500126
2015-08-29,LG4,Total,924,3220,2286522,163998387168,17792548112,181790935280
2015-08-29,All-Floors,Staff,128,1158,936935,40777539798,5703041920,46480581718
2015-08-29,All-Floors,TPG,458,7820,5557402,448630643043,53568735285,502199378328
2015-08-29,All-Floors,RPG,339,3898,3923545,360107878840,24857142963,384965021803
2015-08-29,All-Floors,UG,1027,6506,5015384,178754517921,25485372733,204239890654
2015-08-29,All-Floors,Alumni,46,750,798186,65448933550,22806286024,88255219574
2015-08-29,All-Floors,Others(HKUST),23,384,1142177,28769016622,3161098101,31930114723
2015-08-29,All-Floors,Non-HKUST,62,316,306411,43210738978,3762631409,46973370387
2015-08-29,All-Floors,Total,2083,20832,17680040,1165699268752,139344308435,1305043577187
2015-08-30,1,Staff,7,102,142589,17121311,5920050,23041361
2015-08-30,1,TPG,5,5,1077,196795,93689,290484
2015-08-30,1,RPG,9,14,16578,306889,180260,487149
2015-08-30,1,UG,27,30,8421,2772839,1449924,4222763
2015-08-30,1,Alumni,0,0,0,0,0,0
2015-08-30,1,Others(HKUST),0,0,0,0,0,0
2015-08-30,1,Non-HKUST,0,0,0,0,0,0
2015-08-30,1,Total,48,151,168665,20397834,7643923,28041757
2015-08-30,G,Staff,8,22,7947,7823933,1474970,9298903
2015-08-30,G,TPG,31,40,11303,596425570,68847001,665272571
2015-08-30,G,RPG,30,48,35781,745696547,66670022,812366569
2015-08-30,G,UG,86,107,45416,318416781,1291032208,1609448989
2015-08-30,G,Alumni,0,0,0,0,0,0
2015-08-30,G,Others(HKUST),1,1,86399,712995814,147309240,860305054
2015-08-30,G,Non-HKUST,4,5,1307,141607457,39942298,181549755
2015-08-30,G,Total,160,223,188153,2522966102,1615275739,4138241841
2015-08-30,LG1,Staff,29,328,295501,15316490416,1006445652,16322936068
2015-08-30,LG1,TPG,192,4150,4041996,349834024849,25774241902,375608266751
2015-08-30,LG1,RPG,137,2347,2686391,112634193090,30181690072,142815883162
2015-08-30,LG1,UG,339,3864,4111845,197144679542,33612275027,230756954569
2015-08-30,LG1,Alumni,13,195,241970,9433580522,821597385,10255177907
2015-08-30,LG1,Others(HKUST),5,497,711682,11496900036,1275508106,12772408142
2015-08-30,LG1,Non-HKUST,12,47,39751,3619944851,2826871342,6446816193
2015-08-30,LG1,Total,727,11428,12129136,699479813306,95498629486,794978442792
2015-08-30,LG3,Staff,28,53,17258,36015794,5114797,41130591
2015-08-30,LG3,TPG,77,148,84129,6551524093,754167944,7305692037
2015-08-30,LG3,RPG,72,135,67579,3573311904,660605638,4233917542
2015-08-30,LG3,UG,251,386,140056,13059626043,1914503517,14974129560
2015-08-30,LG3,Alumni,6,9,3472,26173056,1913191,28086247
2015-08-30,LG3,Others(HKUST),4,56,78137,19162176,5676157,24838333
2015-08-30,LG3,Non-HKUST,11,13,1808,11078758,1196400,12275158
2015-08-30,LG3,Total,449,800,392439,23276891824,3343177644,26620069468
2015-08-30,LG4,Staff,45,76,27213,356116991,59460579,415577570
2015-08-30,LG4,TPG,63,96,31622,806261306,180412430,986673736
2015-08-30,LG4,RPG,145,215,88636,1052152950,226966750,1279119700
2015-08-30,LG4,UG,477,812,326395,6435357319,675717898,7111075217
2015-08-30,LG4,Alumni,8,11,3958,849390765,38138194,887528959
2015-08-30,LG4,Others(HKUST),6,64,213655,14102213693,1182219710,15284433403
2015-08-30,LG4,Non-HKUST,18,23,8299,15317179,3457243,18774422
2015-08-30,LG4,Total,762,1297,699778,23616810203,2366372804,25983183007
2015-08-30,All-Floors,Staff,92,581,490508,15733568445,1078416048,16811984493
2015-08-30,All-Floors,TPG,232,4439,4170127,357788432613,26777762966,384566195579
2015-08-30,All-Floors,RPG,287,2759,2894965,118005661380,31136112742,149141774122
2015-08-30,All-Floors,UG,882,5199,4632133,216960852524,37494978574,254455831098
2015-08-30,All-Floors,Alumni,19,215,249400,10309144343,861648770,11170793113
2015-08-30,All-Floors,Others(HKUST),11,618,1089873,26331271719,2610713213,28941984932
2015-08-30,All-Floors,Non-HKUST,38,88,51165,3787948245,2871467283,6659415528
2015-08-30,All-Floors,Total,1561,13899,13578171,748916879269,102831099596,851747978865
2015-08-31,1,Staff,80,881,939108,11356487222,1664390589,13020877811
2015-08-31,1,TPG,107,995,967876,102043894606,16648363088,118692257694
2015-08-31,1,RPG,48,311,366677,13089744544,1447383602,14537128146
2015-08-31,1,UG,130,600,790681,30921119323,4087490701,35008610024
2015-08-31,1,Alumni,0,0,0,0,0,0
2015-08-31,1,Others(HKUST),5,31,7119,573987120,26523157,600510277
2015-08-31,1,Non-HKUST,8,28,46219,988347264,203542005,1191889269
2015-08-31,1,Total,378,2846,3117680,158973580079,24077693142,183051273221
2015-08-31,G,Staff,176,1109,863263,18454605605,2895409792,21350015397
2015-08-31,G,TPG,376,2565,1714867,109705713215,16246606080,125952319295
2015-08-31,G,RPG,248,1199,796287,25519712238,3963942289,29483654527
2015-08-31,G,UG,709,3249,1751714,133227005012,15614808829,148841813841
2015-08-31,G,Alumni,13,67,42464,1338629912,131241462,1469871374
2015-08-31,G,Others(HKUST),14,78,188966,5022055960,576477509,5598533469
2015-08-31,G,Non-HKUST,27,83,51841,2450466470,177780548,2628247018
2015-08-31,G,Total,1563,8350,5409402,295718188412,39606266509,335324454921
2015-08-31,LG1,Staff,122,1098,872393,40675963313,3423072058,44099035371
2015-08-31,LG1,TPG,319,5157,3684091,286202897012,28753265658,314956162670
2015-08-31,LG1,RPG,231,2922,2810203,105508191267,12749817991,118258009258
2015-08-31,LG1,UG,650,6050,4194890,207407683459,32451245046,239858928505
2015-08-31,LG1,Alumni,11,240,173118,8529198675,541128697,9070327372
2015-08-31,LG1,Others(HKUST),14,307,680108,6404101096,849952247,7254053343
2015-08-31,LG1,Non-HKUST,15,124,62772,43663610109,6392683176,50056293285
2015-08-31,LG1,Total,1362,15898,12477575,698391644931,85161164873,783552809804
2015-08-31,LG3,Staff,96,356,217851,6359454492,437015916,6796470408
2015-08-31,LG3,TPG,229,1594,1137891,94122031892,8921952687,103043984579
2015-08-31,LG3,RPG,159,777,727531,34957317854,3916738271,38874056125
2015-08-31,LG3,UG,607,2121,1303427,48859380085,13021432469,61880812554
2015-08-31,LG3,Alumni,6,19,10181,103493247,49546915,153040162
2015-08-31,LG3,Others(HKUST),15,90,107146,1346151301,97254153,1443405454
2015-08-31,LG3,Non-HKUST,18,85,54938,172634544978,19732249950,192366794928
2015-08-31,LG3,Total,1130,5042,3558965,358382373849,46176190361,404558564210
2015-08-31,LG4,Staff,180,747,344681,21328708376,1664250931,22992959307
2015-08-31,LG4,TPG,302,1536,855763,59533966508,10768931715,70302898223
2015-08-31,LG4,RPG,330,1525,1110985,61564812764,14096548935,75661361699
2015-08-31,LG4,UG,1000,3088,1512838,112953529752,17383585868,130337115620
2015-08-31,LG4,Alumni,5,16,20044,357377694,33641971,391019665
2015-08-31,LG4,Others(HKUST),19,184,222581,14320410563,1255994699,15576405262
2015-08-31,LG4,Non-HKUST,45,107,48506,6621476412,262878990,6884355402
2015-08-31,LG4,Total,1881,7203,4115398,276680282069,45465833109,322146115178
2015-08-31,All-Floors,Staff,376,4191,3237296,98175219008,10084139286,108259358294
2015-08-31,All-Floors,TPG,594,11847,8360488,651608503233,81339119228,732947622461
2015-08-31,All-Floors,RPG,583,6734,5811683,240639778667,36174431088,276814209755
2015-08-31,All-Floors,UG,1761,15108,9553550,533368717631,82558562913,615927280544
2015-08-31,All-Floors,Alumni,25,342,245807,10328699528,755559045,11084258573
2015-08-31,All-Floors,Others(HKUST),35,690,1205920,27666706040,2806201765,30472907805
2015-08-31,All-Floors,Non-HKUST,71,427,264276,226358445233,26769134669,253127579902
2015-08-31,All-Floors,Total,3445,39339,28679020,1788146069340,240487147994,2028633217334
