Date,Floor,User-Group,User-Count,WiFi-Conn,Duration-Sec,Traffic-In-Byte,Traffic-Out-Byte,Traffic-Both-Byte
2015-06-01,1,Staff,55,377,1094145,10056846,180110804,190167650
2015-06-01,1,TPG,45,401,1476028,149011791,6512780446,6661792237
2015-06-01,1,RPG,21,145,396351,271272331,1545687810,1816960141
2015-06-01,1,UG,50,325,807067,109542728,1961233903,2070776631
2015-06-01,1,Alumni,2,2,2738,25036,30840,55876
2015-06-01,1,Others(HKUST),5,19,67085,1081075,29158505,30239580
2015-06-01,1,Non-HKUST,2,2,2007,584759,1167180,1751939
2015-06-01,1,Total,180,1271,3845421,541574566,10230169488,10771744054
2015-06-01,G,Staff,102,382,827779,7461166,88942507,96403673
2015-06-01,G,TPG,153,718,1582669,676581841,7236346133,7912927974
2015-06-01,G,RPG,99,278,516978,2000982484,2477286977,4478269461
2015-06-01,G,UG,320,864,1353976,77136225,1271176654,1348312879
2015-06-01,G,Alumni,7,59,178765,15989,26204,42193
2015-06-01,G,Others(HKUST),10,40,47974,155427,384329,539756
2015-06-01,G,Non-HKUST,11,64,82588,7511956,56021723,63533679
2015-06-01,G,Total,702,2405,4590729,2769845088,11130184527,13900029615
2015-06-01,LG1,Staff,79,243,434802,305917,514270,820187
2015-06-01,LG1,TPG,194,1519,4038970,1372295224,2766741022,4139036246
2015-06-01,LG1,RPG,107,663,1810242,726077789,8578473249,9304551038
2015-06-01,LG1,UG,395,2043,5244716,836426393,3308606140,4145032533
2015-06-01,LG1,Alumni,14,59,191597,543010,2684781,3227791
2015-06-01,LG1,Others(HKUST),7,116,296377,0,0,0
2015-06-01,LG1,Non-HKUST,11,23,44846,28553,37604,66157
2015-06-01,LG1,Total,807,4666,12061550,2935676886,14657057066,17592733952
2015-06-01,LG3,Staff,52,141,225975,759472,595999,1355471
2015-06-01,LG3,TPG,73,428,1061484,102364915,437319574,539684489
2015-06-01,LG3,RPG,68,370,973383,8374254,78466128,86840382
2015-06-01,LG3,UG,97,291,659715,866651775,1204340985,2070992760
2015-06-01,LG3,Alumni,13,74,198608,58909268,1500857983,1559767251
2015-06-01,LG3,Others(HKUST),7,54,174745,875,168,1043
2015-06-01,LG3,Non-HKUST,7,84,176349,1380864586,2197041684,3577906270
2015-06-01,LG3,Total,317,1442,3470259,2417925145,5418622521,7836547666
2015-06-01,LG4,Staff,49,158,408315,74549712,1218126493,1292676205
2015-06-01,LG4,TPG,89,745,1869941,6347326494,16059441679,22406768173
2015-06-01,LG4,RPG,77,348,821713,133079836,1701258995,1834338831
2015-06-01,LG4,UG,120,402,778897,1127127455,1902284210,3029411665
2015-06-01,LG4,Alumni,12,102,249758,16243679,142348642,158592321
2015-06-01,LG4,Others(HKUST),5,81,166499,128387642,4622046847,4750434489
2015-06-01,LG4,Non-HKUST,7,23,67778,837376686,309548686,1146925372
2015-06-01,LG4,Total,359,1859,4362901,8664091504,25955055552,34619147056
2015-06-01,All-Floors,Staff,211,1301,2991016,93133113,1488290073,1581423186
2015-06-01,All-Floors,TPG,329,3811,10029092,8647580265,33012628854,41660209119
2015-06-01,All-Floors,RPG,246,1804,4518667,3139786694,14381173159,17520959853
2015-06-01,All-Floors,UG,727,3925,8844371,3016884576,9647641892,12664526468
2015-06-01,All-Floors,Alumni,26,296,821466,75736982,1645948450,1721685432
2015-06-01,All-Floors,Others(HKUST),20,310,752680,129625019,4651589849,4781214868
2015-06-01,All-Floors,Non-HKUST,24,196,373568,2226366540,2563816877,4790183417
2015-06-01,All-Floors,Total,1583,11643,28330860,17329113189,67391089154,84720202343
2015-06-02,1,Staff,67,704,1117519,2918162044,170656693,3088818737
2015-06-02,1,TPG,54,799,1094231,893315722,51331360,944647082
2015-06-02,1,RPG,33,268,455637,1981678331,1911132604,3892810935
2015-06-02,1,UG,41,279,369122,123511267,15856686,139367953
2015-06-02,1,Alumni,6,57,52074,71309069,3594872,74903941
2015-06-02,1,Others(HKUST),6,42,37882,0,0,0
2015-06-02,1,Non-HKUST,5,25,36224,10382628,1037973,11420601
2015-06-02,1,Total,212,2174,3162689,5998359061,2153610188,8151969249
2015-06-02,G,Staff,125,712,719277,108646457,51292737,159939194
2015-06-02,G,TPG,200,1269,1118426,729707483,77350667,807058150
2015-06-02,G,RPG,149,636,569013,279284471,106205410,385489881
2015-06-02,G,UG,378,1707,1216155,326094612,1757549692,2083644304
2015-06-02,G,Alumni,19,150,190529,19792592,26001347,45793939
2015-06-02,G,Others(HKUST),11,68,173673,16531238,13804598,30335836
2015-06-02,G,Non-HKUST,10,52,52204,0,0,0
2015-06-02,G,Total,892,4594,4039277,1480056853,2032204451,3512261304
2015-06-02,LG1,Staff,100,452,461386,39998052,39293844,79291896
2015-06-02,LG1,TPG,249,3130,3654591,7377261809,3909005702,11286267511
2015-06-02,LG1,RPG,168,1456,1845810,3038000088,380321070,3418321158
2015-06-02,LG1,UG,404,2786,2963085,14171898925,1973303678,16145202603
2015-06-02,LG1,Alumni,12,85,121842,209749911,52592131,262342042
2015-06-02,LG1,Others(HKUST),12,195,530290,3531239,1542345,5073584
2015-06-02,LG1,Non-HKUST,12,45,49020,2764819,3324976,6089795
2015-06-02,LG1,Total,957,8149,9626024,24843204843,6359383746,31202588589
2015-06-02,LG3,Staff,66,251,220976,403321189,85088570,488409759
2015-06-02,LG3,TPG,107,921,1060818,5615350279,669807678,6285157957
2015-06-02,LG3,RPG,81,506,750243,4690145903,789393388,5479539291
2015-06-02,LG3,UG,137,526,362063,43785127,66106792,109891919
2015-06-02,LG3,Alumni,9,160,156181,912132456,218722670,1130855126
2015-06-02,LG3,Others(HKUST),9,93,152045,471060,84531,555591
2015-06-02,LG3,Non-HKUST,9,52,68676,27658621,10746356,38404977
2015-06-02,LG3,Total,418,2509,2771002,11692864635,1839949985,13532814620
2015-06-02,LG4,Staff,104,337,338715,7954102712,6049883062,14003985774
2015-06-02,LG4,TPG,101,1182,1686964,68767635154,9725033857,78492669011
2015-06-02,LG4,RPG,147,751,1017113,29949481381,2145085690,32094567071
2015-06-02,LG4,UG,225,636,459205,11942961046,1624619100,13567580146
2015-06-02,LG4,Alumni,13,263,317015,9227475389,967354479,10194829868
2015-06-02,LG4,Others(HKUST),15,190,152880,22211694383,6084110867,28295805250
2015-06-02,LG4,Non-HKUST,8,15,28438,189219113,132214421,321433534
2015-06-02,LG4,Total,613,3374,4000330,150242569178,26728301476,176970870654
2015-06-02,All-Floors,Staff,273,2456,2857873,11424230454,6396214906,17820445360
2015-06-02,All-Floors,TPG,348,7301,8615030,83383270447,14432529264,97815799711
2015-06-02,All-Floors,RPG,365,3617,4637816,39938590174,5332138162,45270728336
2015-06-02,All-Floors,UG,806,5934,5369630,26608250977,5437435948,32045686925
2015-06-02,All-Floors,Alumni,27,715,837641,10440459417,1268265499,11708724916
2015-06-02,All-Floors,Others(HKUST),30,588,1046770,22232227920,6099542341,28331770261
2015-06-02,All-Floors,Non-HKUST,26,189,234562,230025181,147323726,377348907
2015-06-02,All-Floors,Total,1875,20800,23599322,194257054570,39113449846,233370504416
2015-06-03,1,Staff,62,576,1066786,6737880571,226755332,6964635903
2015-06-03,1,TPG,51,490,906593,2141546,734531,2876077
2015-06-03,1,RPG,26,291,495336,451662828,1339046463,1790709291
2015-06-03,1,UG,45,374,495744,964654883,32658722,997313605
2015-06-03,1,Alumni,4,50,70742,90444965,7227299,97672264
2015-06-03,1,Others(HKUST),5,24,43861,119746,106371,226117
2015-06-03,1,Non-HKUST,5,21,34152,0,0,0
2015-06-03,1,Total,198,1826,3113214,8246904539,1606528718,9853433257
2015-06-03,G,Staff,131,610,563123,88040555,11622778,99663333
2015-06-03,G,TPG,191,1450,1234739,12971424887,778567289,13749992176
2015-06-03,G,RPG,134,679,548608,331754542,1156577146,1488331688
2015-06-03,G,UG,269,1149,853923,108628778,15820568,124449346
2015-06-03,G,Alumni,23,132,227020,1095887842,109445579,1205333421
2015-06-03,G,Others(HKUST),8,34,111898,16531238,13804598,30335836
2015-06-03,G,Non-HKUST,18,60,32801,0,0,0
2015-06-03,G,Total,774,4114,3572112,14612267842,2085837958,16698105800
2015-06-03,LG1,Staff,89,504,378149,2009169146,71509184,2080678330
2015-06-03,LG1,TPG,207,2479,3105811,3952793153,505052403,4457845556
2015-06-03,LG1,RPG,153,1239,1534544,1301985273,78468879,1380454152
2015-06-03,LG1,UG,303,2247,2504506,2459110419,6246651043,8705761462
2015-06-03,LG1,Alumni,21,130,144978,677695581,31166425,708862006
2015-06-03,LG1,Others(HKUST),8,103,411412,1999703,1619309,3619012
2015-06-03,LG1,Non-HKUST,17,165,96385,135191,111866,247057
2015-06-03,LG1,Total,798,6867,8175785,10402888466,6934579109,17337467575
2015-06-03,LG3,Staff,69,243,181738,1575308078,79892424,1655200502
2015-06-03,LG3,TPG,92,868,880914,3990540982,389321343,4379862325
2015-06-03,LG3,RPG,109,573,808983,1032660596,1199059339,2231719935
2015-06-03,LG3,UG,108,432,314497,299941891,14432231,314374122
2015-06-03,LG3,Alumni,15,164,163341,378995041,15950121,394945162
2015-06-03,LG3,Others(HKUST),6,45,106894,13925749,9972249,23897998
2015-06-03,LG3,Non-HKUST,12,107,159641,21181306,5330267,26511573
2015-06-03,LG3,Total,411,2432,2616008,7312553643,1713957974,9026511617
2015-06-03,LG4,Staff,116,423,423616,4128899101,263042468,4391941569
2015-06-03,LG4,TPG,97,1333,1846832,100676222749,6493335619,107169558368
2015-06-03,LG4,RPG,148,711,921830,29608229300,1348167937,30956397237
2015-06-03,LG4,UG,182,436,270739,6886436057,309300349,7195736406
2015-06-03,LG4,Alumni,19,303,462588,25329037622,1287036439,26616074061
2015-06-03,LG4,Others(HKUST),9,198,198310,6718982697,2697030708,9416013405
2015-06-03,LG4,Non-HKUST,9,154,138421,761035512,4315908564,5076944076
2015-06-03,LG4,Total,580,3558,4262336,174108843038,16713822084,190822665122
2015-06-03,All-Floors,Staff,272,2356,2613412,14539297451,652822186,15192119637
2015-06-03,All-Floors,TPG,324,6620,7974889,121593123317,8167011185,129760134502
2015-06-03,All-Floors,RPG,351,3493,4309301,32726292539,5121319764,37847612303
2015-06-03,All-Floors,UG,599,4638,4439409,10718772028,6618862913,17337634941
2015-06-03,All-Floors,Alumni,40,779,1068669,27572061051,1450825863,29022886914
2015-06-03,All-Floors,Others(HKUST),19,404,872375,6751559133,2722533235,9474092368
2015-06-03,All-Floors,Non-HKUST,32,507,461400,782352009,4321350697,5103702706
2015-06-03,All-Floors,Total,1637,18797,21739455,214683457528,29054725843,243738183371
2015-06-04,1,Staff,67,686,1029296,2301994496,132635556,2434630052
2015-06-04,1,TPG,42,571,792611,1147737182,321532130,1469269312
2015-06-04,1,RPG,27,230,354270,4389248521,1321849406,5711097927
2015-06-04,1,UG,33,236,288254,323797093,74788826,398585919
2015-06-04,1,Alumni,2,57,29815,553790624,33260229,587050853
2015-06-04,1,Others(HKUST),4,34,39538,188257,112694,300951
2015-06-04,1,Non-HKUST,6,32,39971,0,0,0
2015-06-04,1,Total,181,1846,2573755,8716756173,1884178841,10600935014
2015-06-04,G,Staff,126,731,774637,1091723177,79728170,1171451347
2015-06-04,G,TPG,189,1308,1077776,2253856601,558024011,2811880612
2015-06-04,G,RPG,110,453,417394,437761593,68559744,506321337
2015-06-04,G,UG,217,952,706934,734306500,71715687,806022187
2015-06-04,G,Alumni,13,83,105025,75428768,15436667,90865435
2015-06-04,G,Others(HKUST),14,62,165573,48424578,25398774,73823352
2015-06-04,G,Non-HKUST,18,40,14394,110775045,164953968,275729013
2015-06-04,G,Total,687,3629,3261733,4752276262,983817021,5736093283
2015-06-04,LG1,Staff,108,654,441233,4497717473,132059630,4629777103
2015-06-04,LG1,TPG,203,2986,3046584,25682978683,1836419650,27519398333
2015-06-04,LG1,RPG,127,1301,1772639,3757488552,718685323,4476173875
2015-06-04,LG1,UG,273,2328,2376554,8085862125,481933007,8567795132
2015-06-04,LG1,Alumni,20,203,221725,747003226,50380234,797383460
2015-06-04,LG1,Others(HKUST),8,101,351827,8400909,6910466,15311375
2015-06-04,LG1,Non-HKUST,14,48,14985,295134172,37030011,332164183
2015-06-04,LG1,Total,753,7621,8225547,43074585140,3263418321,46338003461
2015-06-04,LG3,Staff,84,250,147753,8966011320,563557363,9529568683
2015-06-04,LG3,TPG,108,994,1111783,11734907931,1272714360,13007622291
2015-06-04,LG3,RPG,88,563,756470,1832078876,250386228,2082465104
2015-06-04,LG3,UG,116,572,476630,713203736,30748646,743952382
2015-06-04,LG3,Alumni,15,170,156250,846922296,181553408,1028475704
2015-06-04,LG3,Others(HKUST),9,24,11525,145067,82094,227161
2015-06-04,LG3,Non-HKUST,15,239,273472,2907113221,211081684,3118194905
2015-06-04,LG3,Total,435,2812,2933883,27000382447,2510123783,29510506230
2015-06-04,LG4,Staff,105,523,425594,2934117362,217336077,3151453439
2015-06-04,LG4,TPG,91,1003,1406057,51166032438,3833058159,54999090597
2015-06-04,LG4,RPG,142,788,764800,15578938596,1405063977,16984002573
2015-06-04,LG4,UG,153,543,415572,5023303815,4165171215,9188475030
2015-06-04,LG4,Alumni,20,266,349732,7594680471,836362190,8431042661
2015-06-04,LG4,Others(HKUST),9,175,202891,18250789214,5186450439,23437239653
2015-06-04,LG4,Non-HKUST,13,131,93346,2142046,1850637,3992683
2015-06-04,LG4,Total,533,3429,3657992,100550003942,15645292694,116195296636
2015-06-04,All-Floors,Staff,277,2844,2818513,19791563828,1125316796,20916880624
2015-06-04,All-Floors,TPG,309,6862,7434811,91985512835,7821748310,99807261145
2015-06-04,All-Floors,RPG,314,3335,4065573,25995516138,3764544678,29760060816
2015-06-04,All-Floors,UG,515,4631,4263944,14880473269,4824357381,19704830650
2015-06-04,All-Floors,Alumni,34,779,862547,9817825385,1116992728,10934818113
2015-06-04,All-Floors,Others(HKUST),24,396,771354,18307948025,5218954467,23526902492
2015-06-04,All-Floors,Non-HKUST,31,490,436168,3315164484,414916300,3730080784
2015-06-04,All-Floors,Total,1504,19337,20652910,184094003964,24286830660,208380834624
2015-06-05,1,Staff,61,615,1074753,5493154786,543888484,6037043270
2015-06-05,1,TPG,45,497,779684,19946784180,1591737227,21538521407
2015-06-05,1,RPG,32,268,423894,10305863837,7977672224,18283536061
2015-06-05,1,UG,43,397,419237,9970594311,815704894,10786299205
2015-06-05,1,Alumni,3,22,18819,1363214911,56018726,1419233637
2015-06-05,1,Others(HKUST),3,63,55818,99337468,6096431,105433899
2015-06-05,1,Non-HKUST,2,20,29046,799722019,220868831,1020590850
2015-06-05,1,Total,189,1882,2801251,47978671512,11211986817,59190658329
2015-06-05,G,Staff,125,628,579459,1286666331,426418406,1713084737
2015-06-05,G,TPG,182,1161,1073534,10550492735,989488950,11539981685
2015-06-05,G,RPG,122,539,446859,1510557577,82489988,1593047565
2015-06-05,G,UG,230,959,745507,5816287287,1039441650,6855728937
2015-06-05,G,Alumni,23,116,241272,1081056477,57220347,1138276824
2015-06-05,G,Others(HKUST),9,26,105412,17532693,10872126,28404819
2015-06-05,G,Non-HKUST,16,65,11840,41242726,8078666,49321392
2015-06-05,G,Total,707,3494,3203883,20303835826,2614010133,22917845959
2015-06-05,LG1,Staff,96,444,364925,3166299738,165949414,3332249152
2015-06-05,LG1,TPG,209,2955,3233887,54849538865,12459510563,67309049428
2015-06-05,LG1,RPG,155,1035,1338739,14511410046,5158834836,19670244882
2015-06-05,LG1,UG,391,2465,2558131,59659435283,12550306603,72209741886
2015-06-05,LG1,Alumni,23,110,181511,840396265,59070619,899466884
2015-06-05,LG1,Others(HKUST),7,47,289642,410193986,89099830,499293816
2015-06-05,LG1,Non-HKUST,13,118,46273,587562044,64748536,652310580
2015-06-05,LG1,Total,894,7174,8013108,134024836227,30547520401,164572356628
2015-06-05,LG3,Staff,91,274,195914,876969102,159073708,1036042810
2015-06-05,LG3,TPG,95,740,980991,39436121955,10446441976,49882563931
2015-06-05,LG3,RPG,102,483,652792,64243345510,4453659665,68697005175
2015-06-05,LG3,UG,130,554,469691,10400604446,2820764399,13221368845
2015-06-05,LG3,Alumni,14,151,104077,4801241713,247666891,5048908604
2015-06-05,LG3,Others(HKUST),6,43,117312,2364357034,176197916,2540554950
2015-06-05,LG3,Non-HKUST,7,111,113404,7230202057,413031204,7643233261
2015-06-05,LG3,Total,445,2356,2634181,129352841817,18716835759,148069677576
2015-06-05,LG4,Staff,90,368,355596,16965690386,707097777,17672788163
2015-06-05,LG4,TPG,78,1004,1420948,64997954257,6570640524,71568594781
2015-06-05,LG4,RPG,100,639,975771,34676985476,2954925339,37631910815
2015-06-05,LG4,UG,134,657,631476,7568490097,1758704693,9327194790
2015-06-05,LG4,Alumni,21,314,521047,16607694523,1608108824,18215803347
2015-06-05,LG4,Others(HKUST),8,138,172324,28475421697,13268117316,41743539013
2015-06-05,LG4,Non-HKUST,12,121,141048,941768356,203449316,1145217672
2015-06-05,LG4,Total,443,3241,4218210,170234004792,27071043789,197305048581
2015-06-05,All-Floors,Staff,285,2329,2570647,27788780343,2002427789,29791208132
2015-06-05,All-Floors,TPG,309,6357,7489044,189780891992,32057819240,221838711232
2015-06-05,All-Floors,RPG,307,2964,3838055,125248162446,20627582052,145875744498
2015-06-05,All-Floors,UG,605,5032,4824042,93415411424,18984922239,112400333663
2015-06-05,All-Floors,Alumni,37,713,1066726,24693603889,2028085407,26721689296
2015-06-05,All-Floors,Others(HKUST),21,317,740508,31366842878,13550383619,44917226497
2015-06-05,All-Floors,Non-HKUST,24,435,341611,9600497202,910176553,10510673755
2015-06-05,All-Floors,Total,1588,18147,20870633,501894190174,90161396899,592055587073
2015-06-06,1,Staff,15,123,367286,118199113,28258579,146457692
2015-06-06,1,TPG,20,207,424745,4079558629,330510860,4410069489
2015-06-06,1,RPG,21,101,158204,1196786575,53262361,1250048936
2015-06-06,1,UG,14,144,110915,1197541987,68088163,1265630150
2015-06-06,1,Alumni,6,47,90658,293907178,35318449,329225627
2015-06-06,1,Others(HKUST),4,44,80466,106128534,13691133,119819667
2015-06-06,1,Non-HKUST,3,25,79625,1644310856,234338395,1878649251
2015-06-06,1,Total,83,691,1311899,8636432872,763467940,9399900812
2015-06-06,G,Staff,46,198,291517,3443113987,738155674,4181269661
2015-06-06,G,TPG,91,397,363742,9712191579,357848822,10070040401
2015-06-06,G,RPG,67,376,453359,2088908580,498143587,2587052167
2015-06-06,G,UG,105,396,382788,1601746776,73751104,1675497880
2015-06-06,G,Alumni,29,104,98309,1223455188,158861234,1382316422
2015-06-06,G,Others(HKUST),8,21,107279,11015161,10040336,21055497
2015-06-06,G,Non-HKUST,13,39,6975,98319798,8288279,106608077
2015-06-06,G,Total,359,1531,1703969,18178751069,1845089036,20023840105
2015-06-06,LG1,Staff,47,170,230153,2107879143,204516121,2312395264
2015-06-06,LG1,TPG,108,794,914330,20706695364,1045654144,21752349508
2015-06-06,LG1,RPG,81,526,728189,4120086850,1091765767,5211852617
2015-06-06,LG1,UG,181,1455,1875667,2253579297,219111876,2472691173
2015-06-06,LG1,Alumni,25,138,194078,2796780389,10907049044,13703829433
2015-06-06,LG1,Others(HKUST),7,47,380381,34714862,26460429,61175291
2015-06-06,LG1,Non-HKUST,10,50,48711,678516851,117167830,795684681
2015-06-06,LG1,Total,459,3180,4371509,32698252756,13611725211,46309977967
2015-06-06,LG3,Staff,41,266,136331,5055173877,826770097,5881943974
2015-06-06,LG3,TPG,50,335,440407,5785054131,1563669269,7348723400
2015-06-06,LG3,RPG,64,392,453122,11072861959,1762656058,12835518017
2015-06-06,LG3,UG,80,274,184109,1031542150,67289744,1098831894
2015-06-06,LG3,Alumni,20,150,204479,23145626197,5759239901,28904866098
2015-06-06,LG3,Others(HKUST),5,30,107560,154740909,15005212,169746121
2015-06-06,LG3,Non-HKUST,13,46,42096,1455488671,224282131,1679770802
2015-06-06,LG3,Total,273,1493,1568104,47700487894,10218912412,57919400306
2015-06-06,LG4,Staff,44,272,324825,13649079454,765741753,14414821207
2015-06-06,LG4,TPG,47,344,461860,23241197102,890344240,24131541342
2015-06-06,LG4,RPG,78,410,515736,5499036620,3708636590,9207673210
2015-06-06,LG4,UG,81,349,406774,10370264126,380872775,10751136901
2015-06-06,LG4,Alumni,27,349,557359,21029941600,12982250646,34012192246
2015-06-06,LG4,Others(HKUST),6,129,161954,8159816196,974609494,9134425690
2015-06-06,LG4,Non-HKUST,9,54,76250,1122552782,112460256,1235013038
2015-06-06,LG4,Total,292,1907,2504758,83071887880,19814915754,102886803634
2015-06-06,All-Floors,Staff,119,1029,1350112,24373445574,2563442224,26936887798
2015-06-06,All-Floors,TPG,175,2077,2605084,63524696805,4188027335,67712724140
2015-06-06,All-Floors,RPG,197,1805,2308610,23977680584,7114464363,31092144947
2015-06-06,All-Floors,UG,305,2618,2960253,16454674336,809113662,17263787998
2015-06-06,All-Floors,Alumni,55,788,1144883,48489710552,29842719274,78332429826
2015-06-06,All-Floors,Others(HKUST),16,271,837640,8466415662,1039806604,9506222266
2015-06-06,All-Floors,Non-HKUST,25,214,253657,4999188958,696536891,5695725849
2015-06-06,All-Floors,Total,892,8802,11460239,190285812471,46254110353,236539922824
2015-06-07,1,Staff,17,97,341273,21339708,22961788,44301496
2015-06-07,1,TPG,16,113,254466,6149593235,329556584,6479149819
2015-06-07,1,RPG,15,57,113499,5529617577,648717142,6178334719
2015-06-07,1,UG,13,59,141163,7965168724,229467531,8194636255
2015-06-07,1,Alumni,4,38,55942,280406799,246696193,527102992
2015-06-07,1,Others(HKUST),2,23,34799,972098,554344,1526442
2015-06-07,1,Non-HKUST,2,27,28332,14639937952,444751504,15084689456
2015-06-07,1,Total,69,414,969474,34587036093,1922705086,36509741179
2015-06-07,G,Staff,24,92,95010,3430716262,501767447,3932483709
2015-06-07,G,TPG,49,154,147704,53756965,8693745,62450710
2015-06-07,G,RPG,59,211,287174,1734916575,56821028,1791737603
2015-06-07,G,UG,72,334,264176,2912082216,257142039,3169224255
2015-06-07,G,Alumni,28,122,158655,125837649,86912163,212749812
2015-06-07,G,Others(HKUST),12,90,141972,38440558,103288880,141729438
2015-06-07,G,Non-HKUST,15,30,31438,117706742,7796302,125503044
2015-06-07,G,Total,259,1033,1126129,8413456967,1022421604,9435878571
2015-06-07,LG1,Staff,35,138,227301,2694987187,104590677,2799577864
2015-06-07,LG1,TPG,74,586,776446,11113444173,1464078639,12577522812
2015-06-07,LG1,RPG,62,418,684855,5043099739,570038881,5613138620
2015-06-07,LG1,UG,113,807,1113125,24163819717,845321986,25009141703
2015-06-07,LG1,Alumni,25,151,196236,3028283087,95053808,3123336895
2015-06-07,LG1,Others(HKUST),4,27,374746,50532738,39987036,90519774
2015-06-07,LG1,Non-HKUST,12,45,26417,5908025,1150672,7058697
2015-06-07,LG1,Total,325,2172,3399126,46100074666,3120221699,49220296365
2015-06-07,LG3,Staff,27,96,101971,147206698,18468487,165675185
2015-06-07,LG3,TPG,35,188,223358,6152670068,922761854,7075431922
2015-06-07,LG3,RPG,51,206,337131,28471177819,2016060648,30487238467
2015-06-07,LG3,UG,54,128,53042,498315943,40225764,538541707
2015-06-07,LG3,Alumni,17,75,117920,1704768833,132062731,1836831564
2015-06-07,LG3,Others(HKUST),2,5,31169,5900302,2098995,7999297
2015-06-07,LG3,Non-HKUST,7,54,72501,209607452,69261298,278868750
2015-06-07,LG3,Total,193,752,937092,37189647115,3200939777,40390586892
2015-06-07,LG4,Staff,39,161,178907,228441998,40652219,269094217
2015-06-07,LG4,TPG,36,220,322172,12031193999,1738537021,13769731020
2015-06-07,LG4,RPG,58,195,262942,11527768843,1436850594,12964619437
2015-06-07,LG4,UG,46,197,225088,613308981,81762002,695070983
2015-06-07,LG4,Alumni,23,186,271978,9429070191,649979656,10079049847
2015-06-07,LG4,Others(HKUST),2,54,240404,6682191852,980786095,7662977947
2015-06-07,LG4,Non-HKUST,14,70,78048,2505124090,152949590,2658073680
2015-06-07,LG4,Total,218,1083,1579539,43017099954,5081517177,48098617131
2015-06-07,All-Floors,Staff,84,584,944462,6522691853,688440618,7211132471
2015-06-07,All-Floors,TPG,119,1261,1724146,35500658440,4463627843,39964286283
2015-06-07,All-Floors,RPG,164,1087,1685601,52306580553,4728488293,57035068846
2015-06-07,All-Floors,UG,212,1525,1796594,36152695581,1453919322,37606614903
2015-06-07,All-Floors,Alumni,55,572,800731,14568366559,1210704551,15779071110
2015-06-07,All-Floors,Others(HKUST),14,199,823090,6778037548,1126715350,7904752898
2015-06-07,All-Floors,Non-HKUST,29,226,236736,17478284261,675909366,18154193627
2015-06-07,All-Floors,Total,677,5454,8011360,169307314795,14347805343,183655120138
2015-06-08,1,Staff,63,627,959378,4232785841,394417048,4627202889
2015-06-08,1,TPG,42,465,895712,22701522339,3954422087,26655944426
2015-06-08,1,RPG,35,360,564953,8765240019,3119887899,11885127918
2015-06-08,1,UG,37,274,377717,2493915261,233281775,2727197036
2015-06-08,1,Alumni,3,9,20665,37102794,1662544,38765338
2015-06-08,1,Others(HKUST),8,87,94269,1007946277,30073667,1038019944
2015-06-08,1,Non-HKUST,6,26,49395,320950941,27271861,348222802
2015-06-08,1,Total,194,1848,2962089,39559463472,7761016881,47320480353
2015-06-08,G,Staff,116,605,626881,1512847618,603987192,2116834810
2015-06-08,G,TPG,164,1038,786585,18766495063,254429013,19020924076
2015-06-08,G,RPG,134,692,750715,1690094155,172665303,1862759458
2015-06-08,G,UG,202,978,842336,1516106234,181811944,1697918178
2015-06-08,G,Alumni,15,39,14832,108457153,5239420,113696573
2015-06-08,G,Others(HKUST),17,219,243254,68102429,122760677,190863106
2015-06-08,G,Non-HKUST,22,68,95681,1203805229,106599327,1310404556
2015-06-08,G,Total,670,3639,3360284,24865907881,1447492876,26313400757
2015-06-08,LG1,Staff,115,548,668363,2380574022,131942933,2512516955
2015-06-08,LG1,TPG,177,1845,2281689,15836023709,1684945924,17520969633
2015-06-08,LG1,RPG,142,1028,1544626,15250092406,1793255337,17043347743
2015-06-08,LG1,UG,257,1561,1793850,70128663740,2279860283,72408524023
2015-06-08,LG1,Alumni,24,123,245218,118512905,19372924,137885829
2015-06-08,LG1,Others(HKUST),15,136,449544,182929938,75751094,258681032
2015-06-08,LG1,Non-HKUST,15,66,44728,3860531069,1464795594,5325326663
2015-06-08,LG1,Total,745,5307,7028018,107757327789,7449924089,115207251878
2015-06-08,LG3,Staff,85,283,201543,2867006363,89347963,2956354326
2015-06-08,LG3,TPG,57,523,657260,29872388461,1582090210,31454478671
2015-06-08,LG3,RPG,86,527,925435,23806545178,4421679180,28228224358
2015-06-08,LG3,UG,130,458,312983,3793151694,641143977,4434295671
2015-06-08,LG3,Alumni,17,131,168047,34268506,7307247,41575753
2015-06-08,LG3,Others(HKUST),8,76,177300,394228612,34884099,429112711
2015-06-08,LG3,Non-HKUST,10,59,116313,5815616779,1405067968,7220684747
2015-06-08,LG3,Total,393,2057,2558881,66583205593,8181520644,74764726237
2015-06-08,LG4,Staff,97,307,379436,7329109133,645896309,7975005442
2015-06-08,LG4,TPG,74,702,692604,24391087636,1264758514,25655846150
2015-06-08,LG4,RPG,133,602,924374,24849453168,5010049316,29859502484
2015-06-08,LG4,UG,119,670,630471,21289807911,21701276987,42991084898
2015-06-08,LG4,Alumni,13,134,195070,2836657547,125863683,2962521230
2015-06-08,LG4,Others(HKUST),10,104,183046,16945531545,5809196831,22754728376
2015-06-08,LG4,Non-HKUST,16,116,175752,2893410963,3889311300,6782722263
2015-06-08,LG4,Total,462,2635,3180753,100535057903,38446352940,138981410843
2015-06-08,All-Floors,Staff,294,2370,2835601,18322322977,1865591445,20187914422
2015-06-08,All-Floors,TPG,267,4573,5313850,111567517208,8740645748,120308162956
2015-06-08,All-Floors,RPG,346,3209,4710103,74361424926,14517537035,88878961961
2015-06-08,All-Floors,UG,493,3941,3957357,99221644840,25037374966,124259019806
2015-06-08,All-Floors,Alumni,33,436,643832,3134998905,159445818,3294444723
2015-06-08,All-Floors,Others(HKUST),29,622,1147413,18598738801,6072666368,24671405169
2015-06-08,All-Floors,Non-HKUST,41,335,481869,14094314981,6893046050,20987361031
2015-06-08,All-Floors,Total,1503,15486,19090025,339300962638,63286307430,402587270068
2015-06-09,1,Staff,68,651,1179757,17654460680,1210288750,18864749430
2015-06-09,1,TPG,36,407,651752,32119928460,1314972904,33434901364
2015-06-09,1,RPG,30,241,427125,11882251484,2562461504,14444712988
2015-06-09,1,UG,37,275,321281,1113867069,104193340,1218060409
2015-06-09,1,Alumni,2,12,11803,33977206,2792933,36770139
2015-06-09,1,Others(HKUST),7,94,111390,8439557,3837947,12277504
2015-06-09,1,Non-HKUST,5,16,18058,68277920,5056980,73334900
2015-06-09,1,Total,185,1696,2721166,62881202376,5203604358,68084806734
2015-06-09,G,Staff,126,703,767614,10056471493,1324437211,11380908704
2015-06-09,G,TPG,168,1206,865247,14065200528,600541162,14665741690
2015-06-09,G,RPG,127,544,620746,9337494685,300221164,9637715849
2015-06-09,G,UG,213,1106,834200,2673372262,659552706,3332924968
2015-06-09,G,Alumni,8,41,51438,5998038505,350763767,6348802272
2015-06-09,G,Others(HKUST),16,189,162837,29047415,87415077,116462492
2015-06-09,G,Non-HKUST,17,76,68429,4139898189,97841621,4237739810
2015-06-09,G,Total,675,3865,3370511,46299523077,3420772708,49720295785
2015-06-09,LG1,Staff,114,558,709150,1351022473,166590401,1517612874
2015-06-09,LG1,TPG,171,1864,2214217,22448164378,1964641338,24412805716
2015-06-09,LG1,RPG,148,1136,1739694,5591308532,2568781997,8160090529
2015-06-09,LG1,UG,236,1779,1917090,23463615535,3214684868,26678300403
2015-06-09,LG1,Alumni,14,111,197611,2577025564,88697809,2665723373
2015-06-09,LG1,Others(HKUST),10,111,499087,168477991,122963420,291441411
2015-06-09,LG1,Non-HKUST,11,115,107866,106550355,14480766,121031121
2015-06-09,LG1,Total,704,5674,7384715,55706164828,8140840599,63847005427
2015-06-09,LG3,Staff,76,239,175170,1788269986,46956780,1835226766
2015-06-09,LG3,TPG,70,508,745525,22939156878,4044026785,26983183663
2015-06-09,LG3,RPG,105,537,785994,10341249117,1662488883,12003738000
2015-06-09,LG3,UG,128,390,247790,1376645865,1794721506,3171367371
2015-06-09,LG3,Alumni,9,27,43514,471191724,30255930,501447654
2015-06-09,LG3,Others(HKUST),7,70,143194,37726512,6637672,44364184
2015-06-09,LG3,Non-HKUST,11,75,116643,862463698,84185396,946649094
2015-06-09,LG3,Total,406,1846,2257830,37816703780,7669272952,45485976732
2015-06-09,LG4,Staff,90,338,365304,1388205722,630691878,2018897600
2015-06-09,LG4,TPG,61,512,764579,36401122209,5204143314,41605265523
2015-06-09,LG4,RPG,108,675,975124,14242161480,2212742424,16454903904
2015-06-09,LG4,UG,142,458,363921,4382816221,318474908,4701291129
2015-06-09,LG4,Alumni,9,155,219988,9574547016,487783204,10062330220
2015-06-09,LG4,Others(HKUST),12,136,217524,21936120073,7083630264,29019750337
2015-06-09,LG4,Non-HKUST,13,50,68474,310240137,44071565,354311702
2015-06-09,LG4,Total,435,2324,2974914,88235212858,15981537557,104216750415
2015-06-09,All-Floors,Staff,300,2489,3196995,32238430354,3378965020,35617395374
2015-06-09,All-Floors,TPG,274,4497,5241320,127973572453,13128325503,141101897956
2015-06-09,All-Floors,RPG,322,3133,4548683,51394465298,9306695972,60701161270
2015-06-09,All-Floors,UG,505,4008,3684282,33010316952,6091627328,39101944280
2015-06-09,All-Floors,Alumni,26,346,524354,18654780015,960293643,19615073658
2015-06-09,All-Floors,Others(HKUST),30,600,1134032,22179811548,7304484380,29484295928
2015-06-09,All-Floors,Non-HKUST,31,332,379470,5487430299,245636328,5733066627
2015-06-09,All-Floors,Total,1488,15405,18709136,290938806919,40416028174,331354835093
2015-06-10,1,Staff,66,549,1035541,2693346044,6894201334,9587547378
2015-06-10,1,TPG,34,359,641165,15170428530,1819052200,16989480730
2015-06-10,1,RPG,33,276,438373,2417392755,343577826,2760970581
2015-06-10,1,UG,42,234,376104,8623402047,320392296,8943794343
2015-06-10,1,Alumni,4,15,27901,65091,41366,106457
2015-06-10,1,Others(HKUST),6,81,65794,1820866,1006275,2827141
2015-06-10,1,Non-HKUST,6,14,28625,733556343,27487224,761043567
2015-06-10,1,Total,191,1528,2613503,29640011676,9405758521,39045770197
2015-06-10,G,Staff,112,635,738762,2284808820,220321901,2505130721
2015-06-10,G,TPG,134,978,831625,1958563882,238085535,2196649417
2015-06-10,G,RPG,148,838,794574,735359079,326150294,1061509373
2015-06-10,G,UG,187,996,696023,1174389001,52093768,1226482769
2015-06-10,G,Alumni,19,66,58907,1191764,762810,1954574
2015-06-10,G,Others(HKUST),19,263,209384,80379118,72565284,152944402
2015-06-10,G,Non-HKUST,20,64,62128,3104911,2429443,5534354
2015-06-10,G,Total,639,3840,3391403,6237796575,912409035,7150205610
2015-06-10,LG1,Staff,112,629,685872,1068500466,118618280,1187118746
2015-06-10,LG1,TPG,154,1641,2415913,46981331960,1236191200,48217523160
2015-06-10,LG1,RPG,163,1343,1878645,2380128282,232758114,2612886396
2015-06-10,LG1,UG,234,1852,2010714,11096124710,3701530849,14797655559
2015-06-10,LG1,Alumni,18,171,304028,955551281,56404639,1011955920
2015-06-10,LG1,Others(HKUST),12,144,507871,863485326,120798769,984284095
2015-06-10,LG1,Non-HKUST,18,140,114849,134316146,6970533,141286679
2015-06-10,LG1,Total,711,5920,7917892,63479438171,5473272384,68952710555
2015-06-10,LG3,Staff,94,303,188789,1495861920,263697565,1759559485
2015-06-10,LG3,TPG,69,470,615926,75751150407,1927204580,77678354987
2015-06-10,LG3,RPG,110,628,861692,14187391060,404878729,14592269789
2015-06-10,LG3,UG,111,319,269279,2739875383,93442035,2833317418
2015-06-10,LG3,Alumni,10,82,150700,501207911,64941295,566149206
2015-06-10,LG3,Others(HKUST),8,66,147290,34935643,5571445,40507088
2015-06-10,LG3,Non-HKUST,9,77,99673,1673573879,190741041,1864314920
2015-06-10,LG3,Total,411,1945,2333349,96383996203,2950476690,99334472893
2015-06-10,LG4,Staff,84,383,453112,19608541627,428234118,20036775745
2015-06-10,LG4,TPG,70,761,1043252,51168408910,8418729734,59587138644
2015-06-10,LG4,RPG,112,702,1024328,18921437148,2636150194,21557587342
2015-06-10,LG4,UG,128,572,661496,6389124019,827433220,7216557239
2015-06-10,LG4,Alumni,9,88,185203,4542695456,239402020,4782097476
2015-06-10,LG4,Others(HKUST),16,127,237159,15502752392,2848773768,18351526160
2015-06-10,LG4,Non-HKUST,17,61,57433,214857989,1719623130,1934481119
2015-06-10,LG4,Total,436,2694,3661983,116347817541,17118346184,133466163725
2015-06-10,All-Floors,Staff,287,2499,3102076,27151058877,7925073198,35076132075
2015-06-10,All-Floors,TPG,226,4209,5547881,191029883689,13639263249,204669146938
2015-06-10,All-Floors,RPG,338,3787,4997612,38641708324,3943515157,42585223481
2015-06-10,All-Floors,UG,452,3973,4013616,30022915160,4994892168,35017807328
2015-06-10,All-Floors,Alumni,37,422,726739,6000711503,361552130,6362263633
2015-06-10,All-Floors,Others(HKUST),34,681,1167498,16483373345,3048715541,19532088886
2015-06-10,All-Floors,Non-HKUST,46,356,362708,2759409268,1947251371,4706660639
2015-06-10,All-Floors,Total,1420,15927,19918130,312089060166,35860262814,347949322980
2015-06-11,1,Staff,68,695,1023172,7746514066,715713880,8462227946
2015-06-11,1,TPG,25,312,505389,10869348156,735464704,11604812860
2015-06-11,1,RPG,31,292,523431,16743338030,3941145342,20684483372
2015-06-11,1,UG,32,213,345254,3866665988,386968131,4253634119
2015-06-11,1,Alumni,3,19,36055,99594616,4147766,103742382
2015-06-11,1,Others(HKUST),3,55,71819,150569601,2990018,153559619
2015-06-11,1,Non-HKUST,6,41,32955,66512435,5231763,71744198
2015-06-11,1,Total,168,1627,2538075,39542542892,5791661604,45334204496
2015-06-11,G,Staff,122,660,717311,643079704,67324541,710404245
2015-06-11,G,TPG,126,717,743166,12487520275,451899441,12939419716
2015-06-11,G,RPG,134,704,776134,4579323779,2433736918,7013060697
2015-06-11,G,UG,166,848,609511,1107441412,688365679,1795807091
2015-06-11,G,Alumni,13,43,32527,24495,10964,35459
2015-06-11,G,Others(HKUST),12,195,123930,244848047,15301811,260149858
2015-06-11,G,Non-HKUST,26,72,90604,499065907,89582967,588648874
2015-06-11,G,Total,599,3239,3093183,19561303619,3746222321,23307525940
2015-06-11,LG1,Staff,107,459,531501,847472561,352238267,1199710828
2015-06-11,LG1,TPG,161,1766,2197416,17551018304,1115912428,18666930732
2015-06-11,LG1,RPG,150,1343,1813178,13288825166,2688243912,15977069078
2015-06-11,LG1,UG,234,1846,2009606,15216990695,746830003,15963820698
2015-06-11,LG1,Alumni,17,117,160815,1802934650,85499743,1888434393
2015-06-11,LG1,Others(HKUST),13,147,543562,903761206,180830786,1084591992
2015-06-11,LG1,Non-HKUST,16,61,41234,334722243,14617806,349340049
2015-06-11,LG1,Total,698,5739,7297312,49945724825,5184172945,55129897770
2015-06-11,LG3,Staff,76,244,129905,1809957453,6295573354,8105530807
2015-06-11,LG3,TPG,68,433,641824,12199844820,796359002,12996203822
2015-06-11,LG3,RPG,107,562,858202,10681306593,11104723854,21786030447
2015-06-11,LG3,UG,127,445,325382,4000605579,166860478,4167466057
2015-06-11,LG3,Alumni,11,151,235550,354330898,66442504,420773402
2015-06-11,LG3,Others(HKUST),5,37,53288,4375908,834695,5210603
2015-06-11,LG3,Non-HKUST,11,130,153370,2881160429,105898457,2987058886
2015-06-11,LG3,Total,405,2002,2397521,31931581680,18536692344,50468274024
2015-06-11,LG4,Staff,94,348,323718,1510591026,409207070,1919798096
2015-06-11,LG4,TPG,46,552,707006,10308079832,845550865,11153630697
2015-06-11,LG4,RPG,111,599,857386,11108790513,706215696,11815006209
2015-06-11,LG4,UG,120,453,481617,79399017830,1883207896,81282225726
2015-06-11,LG4,Alumni,14,166,244840,605009294,75375960,680385254
2015-06-11,LG4,Others(HKUST),7,129,229787,22667614801,9701838850,32369453651
2015-06-11,LG4,Non-HKUST,13,38,30178,1187229616,493767134,1680996750
2015-06-11,LG4,Total,405,2285,2874532,126786332912,14115163471,140901496383
2015-06-11,All-Floors,Staff,276,2406,2725607,12557614810,7840057112,20397671922
2015-06-11,All-Floors,TPG,240,3780,4794801,63415811387,3945186440,67360997827
2015-06-11,All-Floors,RPG,323,3500,4828331,56401584081,20874065722,77275649803
2015-06-11,All-Floors,UG,445,3805,3771370,103590721504,3872232187,107462953691
2015-06-11,All-Floors,Alumni,31,496,709787,2861893953,231476937,3093370890
2015-06-11,All-Floors,Others(HKUST),22,563,1022386,23971169563,9901796160,33872965723
2015-06-11,All-Floors,Non-HKUST,46,342,348341,4968690630,709098127,5677788757
2015-06-11,All-Floors,Total,1383,14892,18200623,267767485928,47373912685,315141398613
2015-06-12,1,Staff,59,678,1086412,9457626571,346802004,9804428575
2015-06-12,1,TPG,26,343,565388,16939001311,1058010883,17997012194
2015-06-12,1,RPG,30,214,351438,10526551364,2988215447,13514766811
2015-06-12,1,UG,26,184,263634,5048421949,385273912,5433695861
2015-06-12,1,Alumni,3,7,13065,502170,366186,868356
2015-06-12,1,Others(HKUST),6,52,139563,149910553,2664677,152575230
2015-06-12,1,Non-HKUST,6,17,51112,1424402827,1446540896,2870943723
2015-06-12,1,Total,156,1495,2470612,43546416745,6227874005,49774290750
2015-06-12,G,Staff,130,725,697698,4004776352,563485876,4568262228
2015-06-12,G,TPG,140,757,764119,4023942548,435169186,4459111734
2015-06-12,G,RPG,123,561,688671,1242156413,85258522,1327414935
2015-06-12,G,UG,184,875,733109,1305991793,77495410,1383487203
2015-06-12,G,Alumni,17,72,62771,62733676,9746910,72480586
2015-06-12,G,Others(HKUST),14,102,132634,0,0,0
2015-06-12,G,Non-HKUST,27,114,153626,1731342,1069100,2800442
2015-06-12,G,Total,635,3206,3232628,10641332124,1172225004,11813557128
2015-06-12,LG1,Staff,100,457,489013,6965352190,205915923,7171268113
2015-06-12,LG1,TPG,147,1506,2156665,4572978426,646067258,5219045684
2015-06-12,LG1,RPG,142,965,1383086,2402173181,250366963,2652540144
2015-06-12,LG1,UG,223,1506,1745504,4009451260,385164934,4394616194
2015-06-12,LG1,Alumni,18,129,131134,42483737,1229063,43712800
2015-06-12,LG1,Others(HKUST),15,145,548758,107388753,72208966,179597719
2015-06-12,LG1,Non-HKUST,15,58,55555,118248,53520,171768
2015-06-12,LG1,Total,660,4766,6509715,18099945795,1561006627,19660952422
2015-06-12,LG3,Staff,81,235,134156,1215620164,47292549,1262912713
2015-06-12,LG3,TPG,72,451,602310,3074917677,524334479,3599252156
2015-06-12,LG3,RPG,93,557,819883,6696332158,328865093,7025197251
2015-06-12,LG3,UG,130,461,382850,6716790791,2179741553,8896532344
2015-06-12,LG3,Alumni,8,112,208207,222153290,48388619,270541909
2015-06-12,LG3,Others(HKUST),7,91,140428,60819592,8059870,68879462
2015-06-12,LG3,Non-HKUST,18,76,150225,1855307363,116823600,1972130963
2015-06-12,LG3,Total,409,1983,2438059,19841941035,3253505763,23095446798
2015-06-12,LG4,Staff,87,336,429096,7551612242,3368815493,10920427735
2015-06-12,LG4,TPG,56,458,625604,15091673179,1951853792,17043526971
2015-06-12,LG4,RPG,116,518,670560,5588772261,1180468659,6769240920
2015-06-12,LG4,UG,138,478,530884,12264355589,10012964234,22277319823
2015-06-12,LG4,Alumni,11,140,177599,1357010720,112878855,1469889575
2015-06-12,LG4,Others(HKUST),4,125,229446,23895789138,7067001657,30962790795
2015-06-12,LG4,Non-HKUST,29,46,28396,326863895,17193072,344056967
2015-06-12,LG4,Total,441,2101,2691585,66076077024,23711175762,89787252786
2015-06-12,All-Floors,Staff,270,2431,2836375,29194987519,4532311845,33727299364
2015-06-12,All-Floors,TPG,232,3515,4714086,43702513141,4615435598,48317948739
2015-06-12,All-Floors,RPG,310,2815,3913638,26455985377,4833174684,31289160061
2015-06-12,All-Floors,UG,468,3504,3655981,29345011382,13040640043,42385651425
2015-06-12,All-Floors,Alumni,33,460,592776,1684883593,172609633,1857493226
2015-06-12,All-Floors,Others(HKUST),27,515,1190829,24213908036,7149935170,31363843206
2015-06-12,All-Floors,Non-HKUST,63,311,438914,3608423675,1581680188,5190103863
2015-06-12,All-Floors,Total,1403,13551,17342599,158205712723,35925787161,194131499884
2015-06-13,1,Staff,17,153,319868,892914629,29238217,922152846
2015-06-13,1,TPG,20,242,435666,5106278311,215347392,5321625703
2015-06-13,1,RPG,12,98,172300,0,0,0
2015-06-13,1,UG,17,141,212333,1049290608,156260374,1205550982
2015-06-13,1,Alumni,4,10,8893,0,0,0
2015-06-13,1,Others(HKUST),4,83,88343,717932160,1782577614,2500509774
2015-06-13,1,Non-HKUST,2,64,94085,347599886,15251584,362851470
2015-06-13,1,Total,76,791,1331488,8114015594,2198675181,10312690775
2015-06-13,G,Staff,48,276,220145,13511032,10225112,23736144
2015-06-13,G,TPG,91,454,386945,324021374,19914994,343936368
2015-06-13,G,RPG,71,322,417690,293820081,21096632,314916713
2015-06-13,G,UG,100,445,321555,32043652,14289119,46332771
2015-06-13,G,Alumni,26,107,70591,488778112,114066876,602844988
2015-06-13,G,Others(HKUST),13,145,126787,23838,10302,34140
2015-06-13,G,Non-HKUST,16,36,17887,0,0,0
2015-06-13,G,Total,365,1785,1561600,1152198089,179603035,1331801124
2015-06-13,LG1,Staff,51,228,239253,836690055,129488647,966178702
2015-06-13,LG1,TPG,104,986,1271124,9153340784,731595633,9884936417
2015-06-13,LG1,RPG,84,545,778439,2350630769,65657985,2416288754
2015-06-13,LG1,UG,167,1558,1901410,2035383147,151100680,2186483827
2015-06-13,LG1,Alumni,30,119,126046,1068066307,159781471,1227847778
2015-06-13,LG1,Others(HKUST),10,70,502689,104495295,82167132,186662427
2015-06-13,LG1,Non-HKUST,19,47,49194,5070427,672604,5743031
2015-06-13,LG1,Total,465,3553,4868155,15553676784,1320464152,16874140936
2015-06-13,LG3,Staff,48,190,204558,1240157082,335117054,1575274136
2015-06-13,LG3,TPG,58,365,551229,11704627736,1176062470,12880690206
2015-06-13,LG3,RPG,71,323,496492,8171592007,268642981,8440234988
2015-06-13,LG3,UG,83,327,279118,441425089,24457842,465882931
2015-06-13,LG3,Alumni,21,128,233846,6438891822,967278291,7406170113
2015-06-13,LG3,Others(HKUST),5,60,152188,138243911,8127842,146371753
2015-06-13,LG3,Non-HKUST,9,35,45986,1064217876,63221633,1127439509
2015-06-13,LG3,Total,295,1428,1963417,29199155523,2842908113,32042063636
2015-06-13,LG4,Staff,28,151,155265,1792163876,2573948474,4366112350
2015-06-13,LG4,TPG,40,345,466061,11544571108,481274501,12025845609
2015-06-13,LG4,RPG,70,433,485261,5439598770,299808922,5739407692
2015-06-13,LG4,UG,94,361,242549,6008860440,156011554,6164871994
2015-06-13,LG4,Alumni,29,424,531498,9757716809,840742755,10598459564
2015-06-13,LG4,Others(HKUST),6,142,322519,22544926194,3127329177,25672255371
2015-06-13,LG4,Non-HKUST,25,113,207127,109907611,18709361,128616972
2015-06-13,LG4,Total,292,1969,2410280,57197744808,7497824744,64695569552
2015-06-13,All-Floors,Staff,115,998,1139089,4775436674,3078017504,7853454178
2015-06-13,All-Floors,TPG,173,2392,3111025,37832839313,2624194990,40457034303
2015-06-13,All-Floors,RPG,189,1721,2350182,16255641627,655206520,16910848147
2015-06-13,All-Floors,UG,291,2832,2956965,9567002936,502119569,10069122505
2015-06-13,All-Floors,Alumni,50,788,970874,17753453050,2081869393,19835322443
2015-06-13,All-Floors,Others(HKUST),22,500,1192526,23505621398,5000212067,28505833465
2015-06-13,All-Floors,Non-HKUST,46,295,414279,1526795800,97855182,1624650982
2015-06-13,All-Floors,Total,886,9526,12134940,111216790798,14039475225,125256266023
2015-06-14,1,Staff,9,137,143901,19562665,29411011,48973676
2015-06-14,1,TPG,13,139,137381,1432700107,60189599,1492889706
2015-06-14,1,RPG,17,60,156376,719985782,42039025,762024807
2015-06-14,1,UG,19,105,163545,167988899,13866569,181855468
2015-06-14,1,Alumni,4,84,81721,290408967,16533219,306942186
2015-06-14,1,Others(HKUST),6,70,95274,0,0,0
2015-06-14,1,Non-HKUST,1,2,5751,0,0,0
2015-06-14,1,Total,69,597,783949,2630646420,162039423,2792685843
2015-06-14,G,Staff,28,150,183212,2639524,1346096,3985620
2015-06-14,G,TPG,61,337,379431,16452638,10381864,26834502
2015-06-14,G,RPG,68,230,271479,91807767,22084369,113892136
2015-06-14,G,UG,85,411,453572,422917623,5239407914,5662325537
2015-06-14,G,Alumni,28,129,116703,40666004,2039061,42705065
2015-06-14,G,Others(HKUST),10,97,42555,0,0,0
2015-06-14,G,Non-HKUST,7,11,27960,0,0,0
2015-06-14,G,Total,287,1365,1474912,574483556,5275259304,5849742860
2015-06-14,LG1,Staff,24,112,98633,6515867,1061336,7577203
2015-06-14,LG1,TPG,69,610,882535,2997302706,183275985,3180578691
2015-06-14,LG1,RPG,61,399,601100,9599206238,1170944466,10770150704
2015-06-14,LG1,UG,114,948,999095,2470540130,106802341,2577342471
2015-06-14,LG1,Alumni,27,128,202402,112120461,5336166,117456627
2015-06-14,LG1,Others(HKUST),5,60,451073,43414863,30791547,74206410
2015-06-14,LG1,Non-HKUST,10,59,73487,192267452,6486190,198753642
2015-06-14,LG1,Total,310,2316,3308325,15421367717,1504698031,16926065748
2015-06-14,LG3,Staff,21,135,123583,908875531,61148999,970024530
2015-06-14,LG3,TPG,41,189,225149,1713326936,70016032,1783342968
2015-06-14,LG3,RPG,50,206,272322,284961194,132850365,417811559
2015-06-14,LG3,UG,80,162,118575,37667883,4961207,42629090
2015-06-14,LG3,Alumni,25,142,172678,872573088,35507202,908080290
2015-06-14,LG3,Others(HKUST),3,35,70789,0,0,0
2015-06-14,LG3,Non-HKUST,4,18,17147,1033752403,45836679,1079589082
2015-06-14,LG3,Total,224,887,1000243,4851157035,350320484,5201477519
2015-06-14,LG4,Staff,26,62,35813,11802289,1336535,13138824
2015-06-14,LG4,TPG,16,110,166450,6314012555,292554400,6606566955
2015-06-14,LG4,RPG,57,377,339127,933866669,396162282,1330028951
2015-06-14,LG4,UG,73,267,224791,2018174686,617833971,2636008657
2015-06-14,LG4,Alumni,19,171,208757,1137894293,45553244,1183447537
2015-06-14,LG4,Others(HKUST),3,74,153714,8116627869,3845608103,11962235972
2015-06-14,LG4,Non-HKUST,10,45,73332,163420913,5544891,168965804
2015-06-14,LG4,Total,204,1106,1201984,18695799274,5204593426,23900392700
2015-06-14,All-Floors,Staff,70,596,585142,949395876,94303977,1043699853
2015-06-14,All-Floors,TPG,126,1385,1790946,12473794942,616417880,13090212822
2015-06-14,All-Floors,RPG,173,1272,1640404,11629827650,1764080507,13393908157
2015-06-14,All-Floors,UG,261,1893,1959578,5117289221,5982872002,11100161223
2015-06-14,All-Floors,Alumni,54,654,782261,2453662813,104968892,2558631705
2015-06-14,All-Floors,Others(HKUST),16,336,813405,8160042732,3876399650,12036442382
2015-06-14,All-Floors,Non-HKUST,21,135,197677,1389440768,57867760,1447308528
2015-06-14,All-Floors,Total,721,6271,7769413,42173454002,12496910668,54670364670
2015-06-15,1,Staff,61,631,987194,4880806779,430406336,5311213115
2015-06-15,1,TPG,29,419,465487,5596903187,1813244680,7410147867
2015-06-15,1,RPG,37,258,571978,17946192841,4922574019,22868766860
2015-06-15,1,UG,31,227,332502,63079004249,1364618805,64443623054
2015-06-15,1,Alumni,2,14,12490,1616387,582225,2198612
2015-06-15,1,Others(HKUST),8,107,125879,35840355,2539587,38379942
2015-06-15,1,Non-HKUST,2,4,17287,6415732157,2073120282,8488852439
2015-06-15,1,Total,170,1660,2512817,97956095955,10607085934,108563181889
2015-06-15,G,Staff,123,666,821147,5030151700,2702345576,7732497276
2015-06-15,G,TPG,135,761,593367,8022855711,544500873,8567356584
2015-06-15,G,RPG,156,799,764851,2208447694,522441033,2730888727
2015-06-15,G,UG,213,1059,849974,1966965702,1502053976,3469019678
2015-06-15,G,Alumni,9,54,53509,306410080,4833096,311243176
2015-06-15,G,Others(HKUST),16,195,137635,744782419,1344788254,2089570673
2015-06-15,G,Non-HKUST,15,49,73572,58369457,5152490,63521947
2015-06-15,G,Total,667,3583,3294055,18337982763,6626115298,24964098061
2015-06-15,LG1,Staff,111,493,453627,2117588897,130565437,2248154334
2015-06-15,LG1,TPG,147,1985,2428731,21614094112,1842620496,23456714608
2015-06-15,LG1,RPG,147,1256,1703295,15169693018,1590471650,16760164668
2015-06-15,LG1,UG,256,1631,1892899,5811538058,535889910,6347427968
2015-06-15,LG1,Alumni,13,91,111072,183952194,6634840,190587034
2015-06-15,LG1,Others(HKUST),8,139,452463,170520634,72529456,243050090
2015-06-15,LG1,Non-HKUST,10,47,41354,31822332,3365590,35187922
2015-06-15,LG1,Total,692,5642,7083441,45099209245,4182077379,49281286624
2015-06-15,LG3,Staff,93,252,134366,150308756,9430302,159739058
2015-06-15,LG3,TPG,78,447,563520,4375862196,393461564,4769323760
2015-06-15,LG3,RPG,91,627,885877,27871248990,2498038271,30369287261
2015-06-15,LG3,UG,136,551,504437,7206935820,2075466424,9282402244
2015-06-15,LG3,Alumni,10,76,134186,270213586,23922387,294135973
2015-06-15,LG3,Others(HKUST),12,105,190687,234252722,12739359,246992081
2015-06-15,LG3,Non-HKUST,10,84,139160,327233302,55037407,382270709
2015-06-15,LG3,Total,430,2142,2552233,40436055372,5068095714,45504151086
2015-06-15,LG4,Staff,88,322,215396,2842200582,64712358,2906912940
2015-06-15,LG4,TPG,48,581,762234,15768209550,2333293207,18101502757
2015-06-15,LG4,RPG,124,624,662728,12041118393,1156375242,13197493635
2015-06-15,LG4,UG,136,603,638967,12485862986,1855160113,14341023099
2015-06-15,LG4,Alumni,12,149,199730,2209633311,250030628,2459663939
2015-06-15,LG4,Others(HKUST),8,135,189306,12036759409,6063868286,18100627695
2015-06-15,LG4,Non-HKUST,12,195,246392,381130148,122475217,503605365
2015-06-15,LG4,Total,428,2609,2914753,57764914379,11845915051,69610829430
2015-06-15,All-Floors,Staff,287,2364,2611730,15021056714,3337460009,18358516723
2015-06-15,All-Floors,TPG,226,4193,4813339,55377924756,6927120820,62305045576
2015-06-15,All-Floors,RPG,339,3564,4588729,75236700936,10689900215,85926601151
2015-06-15,All-Floors,UG,472,4071,4218779,90550306815,7333189228,97883496043
2015-06-15,All-Floors,Alumni,25,384,510987,2971825558,286003176,3257828734
2015-06-15,All-Floors,Others(HKUST),32,681,1095970,13222155539,7496464942,20718620481
2015-06-15,All-Floors,Non-HKUST,26,379,517765,7214287396,2259150986,9473438382
2015-06-15,All-Floors,Total,1407,15636,18357299,259594257714,38329289376,297923547090
2015-06-16,1,Staff,67,734,1176566,12020079017,766982283,12787061300
2015-06-16,1,TPG,29,283,478424,2574687520,391118542,2965806062
2015-06-16,1,RPG,36,308,651204,5546503211,1112946334,6659449545
2015-06-16,1,UG,25,228,297968,1377454990,106304701,1483759691
2015-06-16,1,Alumni,1,2,962,0,0,0
2015-06-16,1,Others(HKUST),6,81,119535,1765716,723088,2488804
2015-06-16,1,Non-HKUST,0,0,0,0,0,0
2015-06-16,1,Total,164,1636,2724659,21520490454,2378074948,23898565402
2015-06-16,G,Staff,144,593,669895,766219621,201569566,967789187
2015-06-16,G,TPG,125,660,495185,1164039420,195421854,1359461274
2015-06-16,G,RPG,163,687,748428,815773360,134961215,950734575
2015-06-16,G,UG,182,909,769172,5348469275,257840771,5606310046
2015-06-16,G,Alumni,19,92,113933,1414350414,97104152,1511454566
2015-06-16,G,Others(HKUST),11,95,126972,1925850,1624015,3549865
2015-06-16,G,Non-HKUST,8,32,61171,0,0,0
2015-06-16,G,Total,652,3068,2984756,9510777940,888521573,10399299513
2015-06-16,LG1,Staff,121,603,630094,3033700872,128989040,3162689912
2015-06-16,LG1,TPG,149,1724,2212981,2970102106,1274557900,4244660006
2015-06-16,LG1,RPG,191,1592,2087793,2100485484,206092757,2306578241
2015-06-16,LG1,UG,240,1905,2255351,5597008792,446236762,6043245554
2015-06-16,LG1,Alumni,22,188,247565,716416561,31714112,748130673
2015-06-16,LG1,Others(HKUST),10,102,518509,137101565,108985444,246087009
2015-06-16,LG1,Non-HKUST,8,42,29413,3186,6910,10096
2015-06-16,LG1,Total,741,6156,7981706,14554818566,2196582925,16751401491
2015-06-16,LG3,Staff,107,290,158134,687716490,93655180,781371670
2015-06-16,LG3,TPG,65,413,610759,11813181666,1201287405,13014469071
2015-06-16,LG3,RPG,111,551,939072,28461252110,1754719080,30215971190
2015-06-16,LG3,UG,117,381,317420,4204610966,313398008,4518008974
2015-06-16,LG3,Alumni,13,56,113607,88519276,15948467,104467743
2015-06-16,LG3,Others(HKUST),10,106,179594,596747060,24246500,620993560
2015-06-16,LG3,Non-HKUST,7,29,47543,251445288,10068355,261513643
2015-06-16,LG3,Total,430,1826,2366129,46103472856,3413322995,49516795851
2015-06-16,LG4,Staff,117,357,274240,2038083150,96537861,2134621011
2015-06-16,LG4,TPG,51,347,418152,4177644165,763970885,4941615050
2015-06-16,LG4,RPG,133,621,777694,10220918255,1167318529,11388236784
2015-06-16,LG4,UG,163,560,598672,751169562,96309520,847479082
2015-06-16,LG4,Alumni,16,163,280655,3098981288,218019028,3317000316
2015-06-16,LG4,Others(HKUST),7,170,177619,14702666187,4397933654,19100599841
2015-06-16,LG4,Non-HKUST,7,178,203082,20697736,11550249,32247985
2015-06-16,LG4,Total,494,2396,2730114,35010160343,6751639726,41761800069
2015-06-16,All-Floors,Staff,347,2577,2908929,18545799150,1287733930,19833533080
2015-06-16,All-Floors,TPG,227,3427,4215501,22699654877,3826356586,26526011463
2015-06-16,All-Floors,RPG,373,3759,5204191,47144932420,4376037915,51520970335
2015-06-16,All-Floors,UG,463,3983,4238583,17278713585,1220089762,18498803347
2015-06-16,All-Floors,Alumni,36,501,756722,5318267539,362785759,5681053298
2015-06-16,All-Floors,Others(HKUST),25,554,1122229,15440206378,4533512701,19973719079
2015-06-16,All-Floors,Non-HKUST,15,281,341209,272146210,21625514,293771724
2015-06-16,All-Floors,Total,1486,15082,18787364,126699720159,15628142167,142327862326
2015-06-17,1,Staff,60,561,924744,11182056368,914730999,12096787367
2015-06-17,1,TPG,31,418,586418,30892958427,7085238544,37978196971
2015-06-17,1,RPG,30,394,658821,25876370663,4730296589,30606667252
2015-06-17,1,UG,41,239,486231,10989145276,1068410210,12057555486
2015-06-17,1,Alumni,3,56,80608,3826351516,372154244,4198505760
2015-06-17,1,Others(HKUST),4,83,240251,611848644,47353354,659201998
2015-06-17,1,Non-HKUST,2,11,16646,1613528346,641629878,2255158224
2015-06-17,1,Total,171,1762,2993719,84992259240,14859813818,99852073058
2015-06-17,G,Staff,119,728,846734,31177370678,8129572263,39306942941
2015-06-17,G,TPG,160,847,698696,35744751660,4239314360,39984066020
2015-06-17,G,RPG,164,790,957751,48579598760,21536776307,70116375067
2015-06-17,G,UG,191,945,1029399,47967999686,12685475570,60653475256
2015-06-17,G,Alumni,23,91,109989,6003171117,868788958,6871960075
2015-06-17,G,Others(HKUST),12,194,183712,2450297530,598111021,3048408551
2015-06-17,G,Non-HKUST,9,25,39122,3527923179,1744331013,5272254192
2015-06-17,G,Total,678,3620,3865403,175451112610,49802369492,225253482102
2015-06-17,LG1,Staff,92,551,432885,15306550434,6259723101,21566273535
2015-06-17,LG1,TPG,166,2602,2523458,305574221415,68803150260,374377371675
2015-06-17,LG1,RPG,165,1687,1752013,136875088476,27666751471,164541839947
2015-06-17,LG1,UG,266,2658,2470989,213605462094,84392578930,297998041024
2015-06-17,LG1,Alumni,22,160,253916,4922002279,482467244,5404469523
2015-06-17,LG1,Others(HKUST),10,166,600033,1304319620,691991045,1996310665
2015-06-17,LG1,Non-HKUST,11,43,39796,5094320886,924828937,6019149823
2015-06-17,LG1,Total,732,7867,8073090,682681965204,189221490988,871903456192
2015-06-17,LG3,Staff,87,243,141513,5814280885,3127449868,8941730753
2015-06-17,LG3,TPG,97,535,789377,87011276268,17249353789,104260630057
2015-06-17,LG3,RPG,148,883,1169991,76601582748,18784583880,95386166628
2015-06-17,LG3,UG,133,437,346576,65287539960,23250118338,88537658298
2015-06-17,LG3,Alumni,15,83,48998,3949064639,503530704,4452595343
2015-06-17,LG3,Others(HKUST),10,96,195700,747099567,86671009,833770576
2015-06-17,LG3,Non-HKUST,12,27,46376,447890609,48190815,496081424
2015-06-17,LG3,Total,502,2304,2738531,239858734676,63049898403,302908633079
2015-06-17,LG4,Staff,110,337,234735,21906825647,6514512973,28421338620
2015-06-17,LG4,TPG,58,539,709398,84332551642,6043356159,90375907801
2015-06-17,LG4,RPG,139,752,775493,47582840855,14610552733,62193393588
2015-06-17,LG4,UG,153,710,830096,41609338992,9951389334,51560728326
2015-06-17,LG4,Alumni,19,160,279028,26158900814,3248931315,29407832129
2015-06-17,LG4,Others(HKUST),10,154,232316,13890173244,1774364289,15664537533
2015-06-17,LG4,Non-HKUST,8,119,137121,3211989654,367896126,3579885780
2015-06-17,LG4,Total,497,2771,3198187,238692620848,42511002929,281203623777
2015-06-17,All-Floors,Staff,286,2420,2580611,85387084012,24945989204,110333073216
2015-06-17,All-Floors,TPG,246,4941,5307347,543555759412,103420413112,646976172524
2015-06-17,All-Floors,RPG,365,4506,5314069,335515481502,87328960980,422844442482
2015-06-17,All-Floors,UG,491,4989,5163291,379459486008,131347972382,510807458390
2015-06-17,All-Floors,Alumni,39,550,772539,44859490365,5475872465,50335362830
2015-06-17,All-Floors,Others(HKUST),27,693,1452012,19003738605,3198490718,22202229323
2015-06-17,All-Floors,Non-HKUST,24,225,279061,13895652674,3726876769,17622529443
2015-06-17,All-Floors,Total,1478,18324,20868930,1421676692578,359444575630,1781121268208
2015-06-18,1,Staff,58,572,739945,3408023851,1988496075,5396519926
2015-06-18,1,TPG,26,457,639807,33801030317,10044238221,43845268538
2015-06-18,1,RPG,29,365,736051,14268299352,2375977629,16644276981
2015-06-18,1,UG,28,206,346291,16929041410,1590369161,18519410571
2015-06-18,1,Alumni,3,38,97856,1009019562,186599533,1195619095
2015-06-18,1,Others(HKUST),8,104,226003,1386714588,255693006,1642407594
2015-06-18,1,Non-HKUST,2,3,8139,565284519,187475331,752759850
2015-06-18,1,Total,154,1745,2794092,71367413599,16628848956,87996262555
2015-06-18,G,Staff,128,725,687000,59826864109,4289600000,64116464109
2015-06-18,G,TPG,122,624,612211,31738768264,7507330601,39246098865
2015-06-18,G,RPG,147,781,706032,118631893602,35430103190,154061996792
2015-06-18,G,UG,226,1173,981782,42087011183,9188481356,51275492539
2015-06-18,G,Alumni,18,74,77113,20209882308,1452187945,21662070253
2015-06-18,G,Others(HKUST),12,195,216340,3967541529,622964320,4590505849
2015-06-18,G,Non-HKUST,13,44,94030,8742000195,1136393095,9878393290
2015-06-18,G,Total,666,3616,3374508,285203961190,59627060507,344831021697
2015-06-18,LG1,Staff,119,879,868940,22686785218,5312413536,27999198754
2015-06-18,LG1,TPG,131,1768,1833912,166117362907,38176707686,204294070593
2015-06-18,LG1,RPG,139,1302,1585640,103582039602,8619357607,112201397209
2015-06-18,LG1,UG,208,2036,2170541,69809821814,19765398213,89575220027
2015-06-18,LG1,Alumni,16,123,136962,11724081899,1315522915,13039604814
2015-06-18,LG1,Others(HKUST),11,105,526451,3256652245,548513873,3805166118
2015-06-18,LG1,Non-HKUST,15,133,141693,4808333912,394484049,5202817961
2015-06-18,LG1,Total,639,6346,7264139,381985077597,74132397879,456117475476
2015-06-18,LG3,Staff,88,213,139832,22539587009,1347900766,23887487775
2015-06-18,LG3,TPG,61,395,434725,50665154546,8151786059,58816940605
2015-06-18,LG3,RPG,119,644,896606,73203487078,9173052885,82376539963
2015-06-18,LG3,UG,158,615,433321,33121575482,4814390462,37935965944
2015-06-18,LG3,Alumni,14,91,157228,20505096384,1963799070,22468895454
2015-06-18,LG3,Others(HKUST),6,97,136133,1044422117,118418744,1162840861
2015-06-18,LG3,Non-HKUST,10,16,6369,66707371,5273367,71980738
2015-06-18,LG3,Total,456,2071,2204214,201146029987,25574621353,226720651340
2015-06-18,LG4,Staff,106,255,202306,8329428234,706457788,9035886022
2015-06-18,LG4,TPG,48,420,524466,43633413744,3762864319,47396278063
2015-06-18,LG4,RPG,152,816,1059938,72744810212,7847007202,80591817414
2015-06-18,LG4,UG,156,671,648004,23819517772,3998463091,27817980863
2015-06-18,LG4,Alumni,18,218,285179,52875910303,5876180171,58752090474
2015-06-18,LG4,Others(HKUST),11,144,207946,24571187693,6389434121,30960621814
2015-06-18,LG4,Non-HKUST,17,147,185341,5692215155,1093974993,6786190148
2015-06-18,LG4,Total,508,2671,3113180,231666483113,29674381685,261340864798
2015-06-18,All-Floors,Staff,293,2644,2638023,116790688421,13644868165,130435556586
2015-06-18,All-Floors,TPG,206,3664,4045121,325955729778,67642926886,393598656664
2015-06-18,All-Floors,RPG,350,3908,4984267,382430529846,63445498513,445876028359
2015-06-18,All-Floors,UG,488,4701,4579939,185766967661,39357102283,225124069944
2015-06-18,All-Floors,Alumni,35,544,754338,106323990456,10794289634,117118280090
2015-06-18,All-Floors,Others(HKUST),29,645,1312873,34226518172,7935024064,42161542236
2015-06-18,All-Floors,Non-HKUST,38,343,435572,19874541152,2817600835,22692141987
2015-06-18,All-Floors,Total,1439,16449,18750133,1171368965486,205637310380,1377006275866
2015-06-19,1,Staff,62,558,738625,13858224155,4161429960,18019654115
2015-06-19,1,TPG,34,625,653441,47972364680,6608281097,54580645777
2015-06-19,1,RPG,33,405,528504,47999841065,8893189961,56893031026
2015-06-19,1,UG,47,292,241893,5278366264,591817248,5870183512
2015-06-19,1,Alumni,2,22,31719,800416762,137809101,938225863
2015-06-19,1,Others(HKUST),4,113,220112,47447554,17074375,64521929
2015-06-19,1,Non-HKUST,2,2,3477,278536527,18871209,297407736
2015-06-19,1,Total,184,2017,2417771,116235197007,20428472951,136663669958
2015-06-19,G,Staff,123,587,638609,10754467152,1137638644,11892105796
2015-06-19,G,TPG,119,766,702765,43854609046,7294314584,51148923630
2015-06-19,G,RPG,139,633,569203,35263318280,4061780486,39325098766
2015-06-19,G,UG,224,1093,884154,54187889215,13232563335,67420452550
2015-06-19,G,Alumni,14,61,38998,5902642261,358600484,6261242745
2015-06-19,G,Others(HKUST),14,176,147901,3282716943,299177708,3581894651
2015-06-19,G,Non-HKUST,12,55,76784,4286418172,615273454,4901691626
2015-06-19,G,Total,645,3371,3058414,157532061069,26999348695,184531409764
2015-06-19,LG1,Staff,120,870,685620,12840608293,4698133459,17538741752
2015-06-19,LG1,TPG,136,1637,1726212,180277928706,32321173316,212599102022
2015-06-19,LG1,RPG,135,1300,1435899,135544258453,13989832873,149534091326
2015-06-19,LG1,UG,213,1946,2045785,161845131788,36529306310,198374438098
2015-06-19,LG1,Alumni,15,113,141136,7845136458,628610631,8473747089
2015-06-19,LG1,Others(HKUST),16,125,519346,1879669734,391532405,2271202139
2015-06-19,LG1,Non-HKUST,10,66,39116,1825904074,94557263,1920461337
2015-06-19,LG1,Total,645,6057,6593114,502058637506,88653146257,590711783763
2015-06-19,LG3,Staff,97,238,124367,4797873931,686748947,5484622878
2015-06-19,LG3,TPG,52,297,381247,16892904426,4231288711,21124193137
2015-06-19,LG3,RPG,112,609,965950,65762777690,6022350203,71785127893
2015-06-19,LG3,UG,151,468,322664,24498928762,3971333705,28470262467
2015-06-19,LG3,Alumni,9,91,105989,7195219794,415637410,7610857204
2015-06-19,LG3,Others(HKUST),7,46,85524,1577073543,235948733,1813022276
2015-06-19,LG3,Non-HKUST,11,49,93937,3114332526,1859636527,4973969053
2015-06-19,LG3,Total,439,1798,2079678,123839110672,17422944236,141262054908
2015-06-19,LG4,Staff,129,420,267551,7804594689,1246958308,9051552997
2015-06-19,LG4,TPG,44,462,530180,80642855864,7358815402,88001671266
2015-06-19,LG4,RPG,137,772,1033970,55197087087,7931711700,63128798787
2015-06-19,LG4,UG,193,741,781247,82166096136,24384364620,106550460756
2015-06-19,LG4,Alumni,15,321,265313,18700514386,1467452617,20167967003
2015-06-19,LG4,Others(HKUST),8,133,138383,9009193175,4335066950,13344260125
2015-06-19,LG4,Non-HKUST,13,95,76182,887828371,165688004,1053516375
2015-06-19,LG4,Total,539,2944,3092826,254408169708,46890057601,301298227309
2015-06-19,All-Floors,Staff,289,2673,2454772,50055768220,11930909318,61986677538
2015-06-19,All-Floors,TPG,190,3787,3993845,369640662722,57813873110,427454535832
2015-06-19,All-Floors,RPG,325,3719,4533526,339767282575,40898865223,380666147798
2015-06-19,All-Floors,UG,489,4540,4275743,327976412165,78709385218,406685797383
2015-06-19,All-Floors,Alumni,31,608,583155,40443929661,3008110243,43452039904
2015-06-19,All-Floors,Others(HKUST),24,593,1111266,15796100949,5278800171,21074901120
2015-06-19,All-Floors,Non-HKUST,29,267,289496,10393019670,2754026457,13147046127
2015-06-19,All-Floors,Total,1377,16187,17241803,1154073175962,200393969740,1354467145702
2015-06-20,1,Staff,4,99,160093,50594589,10432258,61026847
2015-06-20,1,TPG,0,0,0,0,0,0
2015-06-20,1,RPG,5,6,14628,92988490,24457261,117445751
2015-06-20,1,UG,5,6,0,34876661,11619648,46496309
2015-06-20,1,Alumni,1,3,2521,1167887,473501,1641388
2015-06-20,1,Others(HKUST),4,130,207276,14308515,5569877,19878392
2015-06-20,1,Non-HKUST,0,0,0,0,0,0
2015-06-20,1,Total,19,244,384518,193936142,52552545,246488687
2015-06-20,G,Staff,2,5,841,2412065,254272,2666337
2015-06-20,G,TPG,0,0,0,0,0,0
2015-06-20,G,RPG,1,1,0,555025,218390,773415
2015-06-20,G,UG,1,1,0,21336,17479,38815
2015-06-20,G,Alumni,0,0,0,0,0,0
2015-06-20,G,Others(HKUST),2,3,86875,19475610,17975744,37451354
2015-06-20,G,Non-HKUST,0,0,0,0,0,0
2015-06-20,G,Total,6,10,87716,22464036,18465885,40929921
2015-06-20,LG1,Staff,3,7,5644,585447,261793,847240
2015-06-20,LG1,TPG,0,0,0,0,0,0
2015-06-20,LG1,RPG,1,1,0,82777,49229,132006
2015-06-20,LG1,UG,3,3,119,364460,336938,701398
2015-06-20,LG1,Alumni,0,0,0,0,0,0
2015-06-20,LG1,Others(HKUST),2,45,505309,147779711,120380571,268160282
2015-06-20,LG1,Non-HKUST,0,0,0,0,0,0
2015-06-20,LG1,Total,9,56,511072,148812395,121028531,269840926
2015-06-20,LG3,Staff,4,6,841,854154,292491,1146645
2015-06-20,LG3,TPG,3,4,230,113036396,4886024,117922420
2015-06-20,LG3,RPG,11,11,1200,91977729,13121537,105099266
2015-06-20,LG3,UG,37,41,1315,222948493,19788631,242737124
2015-06-20,LG3,Alumni,2,2,0,38394497,12672777,51067274
2015-06-20,LG3,Others(HKUST),3,3,111,23894337,3045738,26940075
2015-06-20,LG3,Non-HKUST,0,0,0,0,0,0
2015-06-20,LG3,Total,60,67,3697,491105606,53807198,544912804
2015-06-20,LG4,Staff,18,23,7906,368898296,93881436,462779732
2015-06-20,LG4,TPG,13,14,9371,229879875,15060104,244939979
2015-06-20,LG4,RPG,41,49,5038,142672934,17811337,160484271
2015-06-20,LG4,UG,86,138,53241,1479189492,122025263,1601214755
2015-06-20,LG4,Alumni,8,18,20169,7800405931,206448541,8006854472
2015-06-20,LG4,Others(HKUST),3,107,163331,9188875735,1529265895,10718141630
2015-06-20,LG4,Non-HKUST,4,4,0,7165078,949453,8114531
2015-06-20,LG4,Total,173,353,259056,19217087341,1985442029,21202529370
2015-06-20,All-Floors,Staff,29,140,175325,423344551,105122250,528466801
2015-06-20,All-Floors,TPG,16,18,9601,342916271,19946128,362862399
2015-06-20,All-Floors,RPG,59,68,20866,328276955,55657754,383934709
2015-06-20,All-Floors,UG,123,189,54675,1737400442,153787959,1891188401
2015-06-20,All-Floors,Alumni,10,23,22690,7839968315,219594819,8059563134
2015-06-20,All-Floors,Others(HKUST),9,288,962902,9394333908,1676237825,11070571733
2015-06-20,All-Floors,Non-HKUST,4,4,0,7165078,949453,8114531
2015-06-20,All-Floors,Total,250,730,1246059,20073405520,2231296188,22304701708
2015-06-21,1,Staff,9,133,218254,1056687168,62609047,1119296215
2015-06-21,1,TPG,22,237,379421,23643340760,5616455323,29259796083
2015-06-21,1,RPG,15,70,197537,4303823830,748586108,5052409938
2015-06-21,1,UG,9,14,8040,167054883,17057987,184112870
2015-06-21,1,Alumni,3,29,59183,8868935980,505874676,9374810656
2015-06-21,1,Others(HKUST),3,99,224221,66861330,12650967,79512297
2015-06-21,1,Non-HKUST,2,15,64448,1425725238,2978833789,4404559027
2015-06-21,1,Total,63,597,1151104,39532429189,9942067897,49474497086
2015-06-21,G,Staff,28,173,194807,2365206216,255762444,2620968660
2015-06-21,G,TPG,50,286,271232,10324017875,2406913016,12730930891
2015-06-21,G,RPG,58,254,284360,8350107230,2195941198,10546048428
2015-06-21,G,UG,108,418,330338,10377159952,2543804596,12920964548
2015-06-21,G,Alumni,28,114,133396,5479557345,445753490,5925310835
2015-06-21,G,Others(HKUST),6,47,134509,480121347,369885822,850007169
2015-06-21,G,Non-HKUST,10,54,64700,7380690751,1306142266,8686833017
2015-06-21,G,Total,288,1346,1413342,44756860716,9524202832,54281063548
2015-06-21,LG1,Staff,27,152,192165,15555334186,5699408426,21254742612
2015-06-21,LG1,TPG,69,722,796055,53263615547,8239903137,61503518684
2015-06-21,LG1,RPG,59,461,571372,47637128887,9318119985,56955248872
2015-06-21,LG1,UG,116,887,1063011,49589325385,8014127789,57603453174
2015-06-21,LG1,Alumni,25,145,179049,10688287459,1103174731,11791462190
2015-06-21,LG1,Others(HKUST),5,62,505224,299622754,243691124,543313878
2015-06-21,LG1,Non-HKUST,14,95,82319,3371058170,281344944,3652403114
2015-06-21,LG1,Total,315,2524,3389195,180404372388,32899770136,213304142524
2015-06-21,LG3,Staff,30,141,95400,3779870734,338805072,4118675806
2015-06-21,LG3,TPG,41,147,204985,49735640298,7590502399,57326142697
2015-06-21,LG3,RPG,54,313,376406,20214663404,6534408104,26749071508
2015-06-21,LG3,UG,78,208,120355,13035442657,1706841143,14742283800
2015-06-21,LG3,Alumni,16,92,100841,3049416825,1290398298,4339815123
2015-06-21,LG3,Others(HKUST),2,7,475,19116387,15589079,34705466
2015-06-21,LG3,Non-HKUST,11,53,88061,3197611629,439321299,3636932928
2015-06-21,LG3,Total,232,961,986523,93031761934,17915865394,110947627328
2015-06-21,LG4,Staff,35,98,21345,1040402474,105809518,1146211992
2015-06-21,LG4,TPG,27,109,151346,8337550119,907435865,9244985984
2015-06-21,LG4,RPG,78,229,246018,10870895217,1824945453,12695840670
2015-06-21,LG4,UG,125,612,742039,58045163878,11690376018,69735539896
2015-06-21,LG4,Alumni,16,218,272378,22309076891,5229621121,27538698012
2015-06-21,LG4,Others(HKUST),3,43,176885,12641226427,2746701520,15387927947
2015-06-21,LG4,Non-HKUST,11,113,141661,17639487262,4455726611,22095213873
2015-06-21,LG4,Total,295,1422,1751672,130883802268,26960616106,157844418374
2015-06-21,All-Floors,Staff,79,697,721971,23797500778,6462394507,30259895285
2015-06-21,All-Floors,TPG,114,1501,1803039,145304164599,24761209740,170065374339
2015-06-21,All-Floors,RPG,172,1327,1675693,91376618568,20622000848,111998619416
2015-06-21,All-Floors,UG,282,2139,2263783,131214146755,23972207533,155186354288
2015-06-21,All-Floors,Alumni,51,598,744847,50395274500,8574822316,58970096816
2015-06-21,All-Floors,Others(HKUST),10,258,1041314,13506948245,3388518512,16895466757
2015-06-21,All-Floors,Non-HKUST,31,330,441189,33014573050,9461368909,42475941959
2015-06-21,All-Floors,Total,739,6850,8691836,488609226495,97242522365,585851748860
2015-06-22,1,Staff,66,667,898015,6805651598,1934453923,8740105521
2015-06-22,1,TPG,39,531,764931,96320362382,7363708763,103684071145
2015-06-22,1,RPG,30,349,530583,27817672225,50972652792,78790325017
2015-06-22,1,UG,59,462,514771,24720997204,3827855729,28548852933
2015-06-22,1,Alumni,1,32,22890,2658822593,151583525,2810406118
2015-06-22,1,Others(HKUST),2,90,221463,13967284,4944175,18911459
2015-06-22,1,Non-HKUST,1,15,16375,954062309,74732060,1028794369
2015-06-22,1,Total,198,2146,2969028,159291535595,64329930967,223621466562
2015-06-22,G,Staff,128,708,705005,18311588200,3807974837,22119563037
2015-06-22,G,TPG,123,733,595080,35535086905,7440819622,42975906527
2015-06-22,G,RPG,151,848,827810,31995399280,3902968046,35898367326
2015-06-22,G,UG,403,1955,1261797,63508726199,11077637050,74586363249
2015-06-22,G,Alumni,13,57,72570,8500237571,844953000,9345190571
2015-06-22,G,Others(HKUST),20,144,215201,2650192841,507840924,3158033765
2015-06-22,G,Non-HKUST,18,73,84850,9543983618,518625665,10062609283
2015-06-22,G,Total,856,4518,3762313,170045214614,28100819144,198146033758
2015-06-22,LG1,Staff,97,557,451647,17487277195,1165523877,18652801072
2015-06-22,LG1,TPG,151,1795,1880909,264020091465,38442527298,302462618763
2015-06-22,LG1,RPG,140,1595,1839868,116406303173,8335484044,124741787217
2015-06-22,LG1,UG,447,3741,3455618,173360730331,28197037353,201557767684
2015-06-22,LG1,Alumni,15,188,255255,23657040340,2489395206,26146435546
2015-06-22,LG1,Others(HKUST),12,192,684176,11602026498,1676407571,13278434069
2015-06-22,LG1,Non-HKUST,12,57,32305,1130713671,95972608,1226686279
2015-06-22,LG1,Total,874,8125,8599778,607664182673,80402347957,688066530630
2015-06-22,LG3,Staff,85,309,203658,4562636916,457448950,5020085866
2015-06-22,LG3,TPG,74,527,733977,43353122985,8076219181,51429342166
2015-06-22,LG3,RPG,108,672,916443,45719011199,6631621055,52350632254
2015-06-22,LG3,UG,263,1160,895980,43074835282,5679752497,48754587779
2015-06-22,LG3,Alumni,9,52,60246,5936239332,267577992,6203817324
2015-06-22,LG3,Others(HKUST),7,38,90249,656491012,75188540,731679552
2015-06-22,LG3,Non-HKUST,10,38,53584,2255192473,409892986,2665085459
2015-06-22,LG3,Total,556,2796,2954137,145557529199,21597701201,167155230400
2015-06-22,LG4,Staff,130,484,357154,8751183728,708688968,9459872696
2015-06-22,LG4,TPG,43,504,664792,37624557411,4633574785,42258132196
2015-06-22,LG4,RPG,148,709,873133,38015562056,4092264496,42107826552
2015-06-22,LG4,UG,372,1283,1192680,98844232477,7345946038,106190178515
2015-06-22,LG4,Alumni,12,72,91112,2170325142,155615579,2325940721
2015-06-22,LG4,Others(HKUST),9,102,142459,23150401251,8555756378,31706157629
2015-06-22,LG4,Non-HKUST,14,77,135902,12810717482,1965943888,14776661370
2015-06-22,LG4,Total,728,3231,3457232,221366979547,27457790132,248824769679
2015-06-22,All-Floors,Staff,314,2725,2615479,55918337637,8074090555,63992428192
2015-06-22,All-Floors,TPG,228,4090,4639689,476853221148,65956849649,542810070797
2015-06-22,All-Floors,RPG,347,4173,4987837,259953947933,73934990433,333888938366
2015-06-22,All-Floors,UG,943,8601,7320846,403509521493,56128228667,459637750160
2015-06-22,All-Floors,Alumni,29,401,502073,42922664978,3909125302,46831790280
2015-06-22,All-Floors,Others(HKUST),31,566,1353548,38073078886,10820137588,48893216474
2015-06-22,All-Floors,Non-HKUST,35,260,323016,26694669553,3065167207,29759836760
2015-06-22,All-Floors,Total,1927,20816,21742488,1303925441628,221888589401,1525814031029
2015-06-23,1,Staff,66,692,1096435,30919049940,2468948273,33387998213
2015-06-23,1,TPG,32,580,740199,49135087074,3888418468,53023505542
2015-06-23,1,RPG,40,303,541014,12789523361,1175277477,13964800838
2015-06-23,1,UG,79,521,883077,43329391723,3690429435,47019821158
2015-06-23,1,Alumni,4,72,126532,3699176784,366013621,4065190405
2015-06-23,1,Others(HKUST),5,112,204405,62141100,41844208,103985308
2015-06-23,1,Non-HKUST,4,33,57254,457568708,55268935,512837643
2015-06-23,1,Total,230,2313,3648916,140391938690,11686200417,152078139107
2015-06-23,G,Staff,121,708,630796,10467620290,2282023387,12749643677
2015-06-23,G,TPG,99,541,413631,31032202915,6473971254,37506174169
2015-06-23,G,RPG,134,886,678534,20945834651,3687059535,24632894186
2015-06-23,G,UG,340,1834,1212930,63732096888,14712822413,78444919301
2015-06-23,G,Alumni,19,115,95464,23624992641,1966630631,25591623272
2015-06-23,G,Others(HKUST),15,229,208272,1355307159,768125140,2123432299
2015-06-23,G,Non-HKUST,16,77,98639,7884692498,456903008,8341595506
2015-06-23,G,Total,744,4390,3338266,159042747042,30347535368,189390282410
2015-06-23,LG1,Staff,103,469,301613,11954444645,1242343138,13196787783
2015-06-23,LG1,TPG,111,1455,1413081,99355943897,17154170626,116510114523
2015-06-23,LG1,RPG,158,1430,1707644,124612894308,10034467767,134647362075
2015-06-23,LG1,UG,377,3292,3469072,302906948517,39442135930,342349084447
2015-06-23,LG1,Alumni,16,210,220074,23693256316,2367471914,26060728230
2015-06-23,LG1,Others(HKUST),8,75,501089,330153178,208463272,538616450
2015-06-23,LG1,Non-HKUST,14,87,67009,8735558575,469060004,9204618579
2015-06-23,LG1,Total,787,7018,7679582,571589199436,70918112651,642507312087
2015-06-23,LG3,Staff,103,342,316124,74917331743,7380362081,82297693824
2015-06-23,LG3,TPG,49,272,368245,14532813880,1739026373,16271840253
2015-06-23,LG3,RPG,112,698,1131137,65741604357,11967390020,77708994377
2015-06-23,LG3,UG,233,742,525069,77069136614,17671029967,94740166581
2015-06-23,LG3,Alumni,11,95,77813,7340790600,2587279449,9928070049
2015-06-23,LG3,Others(HKUST),7,47,122952,914817990,67891960,982709950
2015-06-23,LG3,Non-HKUST,8,35,45531,1310471554,400963404,1711434958
2015-06-23,LG3,Total,523,2231,2586871,241826966738,41813943254,283640909992
2015-06-23,LG4,Staff,103,465,358186,27034514120,1220322285,28254836405
2015-06-23,LG4,TPG,48,432,559656,67440553184,6088091221,73528644405
2015-06-23,LG4,RPG,140,702,914528,38613423518,4577292710,43190716228
2015-06-23,LG4,UG,278,1083,1093213,45571819170,11021543194,56593362364
2015-06-23,LG4,Alumni,16,256,275308,25163185762,12011570286,37174756048
2015-06-23,LG4,Others(HKUST),12,150,241466,31565446914,8734658455,40300105369
2015-06-23,LG4,Non-HKUST,8,60,62987,13019755544,323417826,13343173370
2015-06-23,LG4,Total,605,3148,3505344,248408698212,43976895977,292385594189
2015-06-23,All-Floors,Staff,287,2676,2703154,155292960738,14593999164,169886959902
2015-06-23,All-Floors,TPG,189,3280,3494812,261496600950,35343677942,296840278892
2015-06-23,All-Floors,RPG,354,4019,4972857,262703280195,31441487509,294144767704
2015-06-23,All-Floors,UG,780,7472,7183361,532609392912,86537960939,619147353851
2015-06-23,All-Floors,Alumni,33,748,795191,83521402103,19298965901,102820368004
2015-06-23,All-Floors,Others(HKUST),26,613,1278184,34227866341,9820983035,44048849376
2015-06-23,All-Floors,Non-HKUST,33,292,331420,31408046879,1705613177,33113660056
2015-06-23,All-Floors,Total,1702,19100,20758979,1361259550118,198742687667,1560002237785
2015-06-24,1,Staff,68,731,1240745,32836913539,4090696121,36927609660
2015-06-24,1,TPG,35,743,989715,78379911091,7615019607,85994930698
2015-06-24,1,RPG,28,305,544087,19366659113,3114364371,22481023484
2015-06-24,1,UG,97,749,1164927,52590523085,14706712314,67297235399
2015-06-24,1,Alumni,1,32,24175,2250978219,104440461,2355418680
2015-06-24,1,Others(HKUST),11,128,258795,1052469187,113635396,1166104583
2015-06-24,1,Non-HKUST,5,7,5780,24087024,44937764,69024788
2015-06-24,1,Total,245,2695,4228224,186501541258,29789806034,216291347292
2015-06-24,G,Staff,132,745,668554,35648696365,3233456919,38882153284
2015-06-24,G,TPG,127,718,492091,29456315573,4141878744,33598194317
2015-06-24,G,RPG,158,829,883658,59319240662,8093223246,67412463908
2015-06-24,G,UG,405,1613,1157909,61079731970,17065452760,78145184730
2015-06-24,G,Alumni,13,47,37677,3280580818,147364334,3427945152
2015-06-24,G,Others(HKUST),26,238,235929,19493531755,932043114,20425574869
2015-06-24,G,Non-HKUST,14,51,101966,6045594047,353922118,6399516165
2015-06-24,G,Total,875,4241,3577784,214323691190,33967341235,248291032425
2015-06-24,LG1,Staff,109,559,400457,9434677977,1441982449,10876660426
2015-06-24,LG1,TPG,128,1935,1908990,263690859559,26917887480,290608747039
2015-06-24,LG1,RPG,150,1655,1848971,110324833377,8956644665,119281478042
2015-06-24,LG1,UG,388,3315,3111989,216603329054,26494541991,243097871045
2015-06-24,LG1,Alumni,22,179,289663,8552097735,551650384,9103748119
2015-06-24,LG1,Others(HKUST),9,62,512252,1050147221,344174047,1394321268
2015-06-24,LG1,Non-HKUST,13,69,37162,2641748664,154493148,2796241812
2015-06-24,LG1,Total,819,7774,8109484,612297693587,64861374164,677159067751
2015-06-24,LG3,Staff,98,262,124118,15556537770,612122272,16168660042
2015-06-24,LG3,TPG,63,310,508892,15743524867,2853221443,18596746310
2015-06-24,LG3,RPG,120,647,1086352,78427960916,9204969024,87632929940
2015-06-24,LG3,UG,239,691,542292,47170636835,6157368053,53328004888
2015-06-24,LG3,Alumni,14,99,156298,4667267231,369226032,5036493263
2015-06-24,LG3,Others(HKUST),8,50,114172,3272466635,173031755,3445498390
2015-06-24,LG3,Non-HKUST,10,42,53132,515435856,201779740,717215596
2015-06-24,LG3,Total,552,2101,2585256,165353830110,19571718319,184925548429
2015-06-24,LG4,Staff,112,481,431932,31185371950,1868721703,33054093653
2015-06-24,LG4,TPG,42,271,461263,22344615036,4238843351,26583458387
2015-06-24,LG4,RPG,130,604,697598,47916763939,6867533146,54784297085
2015-06-24,LG4,UG,358,1317,1129072,81171185363,8925495160,90096680523
2015-06-24,LG4,Alumni,13,252,300130,18955652648,1354941770,20310594418
2015-06-24,LG4,Others(HKUST),12,153,273316,46543878550,10066734922,56610613472
2015-06-24,LG4,Non-HKUST,16,68,123586,7478349199,1238515048,8716864247
2015-06-24,LG4,Total,683,3146,3416897,255595816685,34560785100,290156601785
2015-06-24,All-Floors,Staff,312,2778,2865806,124662197601,11246979464,135909177065
2015-06-24,All-Floors,TPG,205,3977,4360951,409615226126,45766850625,455382076751
2015-06-24,All-Floors,RPG,355,4040,5060666,315355458007,36236734452,351592192459
2015-06-24,All-Floors,UG,879,7685,7106189,458615406307,73349570278,531964976585
2015-06-24,All-Floors,Alumni,33,609,807943,37706576651,2527622981,40234199632
2015-06-24,All-Floors,Others(HKUST),36,631,1394464,71412493348,11629619234,83042112582
2015-06-24,All-Floors,Non-HKUST,30,237,321626,16705214790,1993647818,18698862608
2015-06-24,All-Floors,Total,1850,19957,21917645,1434072572830,182751024852,1616823597682
2015-06-25,1,Staff,64,737,1087509,15595047085,2050672791,17645719876
2015-06-25,1,TPG,42,731,956390,111427959054,31632380427,143060339481
2015-06-25,1,RPG,24,304,354599,32119980463,1885707389,34005687852
2015-06-25,1,UG,58,577,798427,57208166791,7812663421,65020830212
2015-06-25,1,Alumni,2,41,24874,8183317217,408848349,8592165566
2015-06-25,1,Others(HKUST),6,115,243020,1134105007,80993549,1215098556
2015-06-25,1,Non-HKUST,1,67,58719,1236778123,80857367,1317635490
2015-06-25,1,Total,197,2572,3523538,226905353740,43952123293,270857477033
2015-06-25,G,Staff,124,691,642886,31476890028,1930763022,33407653050
2015-06-25,G,TPG,132,746,508469,30024394048,2460808297,32485202345
2015-06-25,G,RPG,128,596,573644,28788511109,2162681664,30951192773
2015-06-25,G,UG,304,1536,1241796,57764436337,17665890523,75430326860
2015-06-25,G,Alumni,16,160,181329,14323354252,1121919649,15445273901
2015-06-25,G,Others(HKUST),17,133,198732,1486065831,213257257,1699323088
2015-06-25,G,Non-HKUST,19,96,135955,3555122867,642332105,4197454972
2015-06-25,G,Total,740,3958,3482811,167418774472,26197652517,193616426989
2015-06-25,LG1,Staff,86,351,269826,6563483359,830954905,7394438264
2015-06-25,LG1,TPG,114,1441,1520566,239840580283,29533163163,269373743446
2015-06-25,LG1,RPG,145,1067,1373448,81099502008,7034652813,88134154821
2015-06-25,LG1,UG,341,3319,3191612,200973073845,26485191121,227458264966
2015-06-25,LG1,Alumni,13,91,142282,7422195542,431520344,7853715886
2015-06-25,LG1,Others(HKUST),16,115,614036,2176726990,419205606,2595932596
2015-06-25,LG1,Non-HKUST,10,35,30544,5863934519,168299032,6032233551
2015-06-25,LG1,Total,725,6419,7142314,543939496546,64902986984,608842483530
2015-06-25,LG3,Staff,100,323,256221,5567417573,452439069,6019856642
2015-06-25,LG3,TPG,55,284,374651,34139662210,3191231828,37330894038
2015-06-25,LG3,RPG,112,684,919447,65689821559,6046438168,71736259727
2015-06-25,LG3,UG,229,827,606468,49072369584,5360071571,54432441155
2015-06-25,LG3,Alumni,12,115,151934,21715811019,1202729552,22918540571
2015-06-25,LG3,Others(HKUST),7,45,117034,1951912371,211474055,2163386426
2015-06-25,LG3,Non-HKUST,12,18,15675,195145697,25510143,220655840
2015-06-25,LG3,Total,527,2296,2441430,178332140013,16489894386,194822034399
2015-06-25,LG4,Staff,130,488,413583,11264502865,1249784552,12514287417
2015-06-25,LG4,TPG,52,356,545752,81656425274,5237726963,86894152237
2015-06-25,LG4,RPG,149,656,746341,38769902184,5079012037,43848914221
2015-06-25,LG4,UG,260,1118,996374,50458701511,11976280855,62434982366
2015-06-25,LG4,Alumni,10,228,299476,42808756664,2907199138,45715955802
2015-06-25,LG4,Others(HKUST),8,106,206377,71101321141,26956979038,98058300179
2015-06-25,LG4,Non-HKUST,13,129,84622,9057596602,493350952,9550947554
2015-06-25,LG4,Total,622,3081,3292525,305117206241,53900333535,359017539776
2015-06-25,All-Floors,Staff,294,2590,2670025,70467340910,6514614339,76981955249
2015-06-25,All-Floors,TPG,216,3558,3905828,497089020869,72055310678,569144331547
2015-06-25,All-Floors,RPG,335,3307,3967479,246467717323,22208492071,268676209394
2015-06-25,All-Floors,UG,715,7377,6834677,415476748068,69300097491,484776845559
2015-06-25,All-Floors,Alumni,29,635,799895,94453434694,6072217032,100525651726
2015-06-25,All-Floors,Others(HKUST),32,514,1379199,77850131340,27881909505,105732040845
2015-06-25,All-Floors,Non-HKUST,32,345,325515,19908577808,1410349599,21318927407
2015-06-25,All-Floors,Total,1653,18326,19882618,1421712971012,205442990715,1627155961727
2015-06-26,1,Staff,67,660,963342,11064596430,1383354964,12447951394
2015-06-26,1,TPG,40,542,856242,62817810678,17787691732,80605502410
2015-06-26,1,RPG,31,268,430875,13629198388,2825945972,16455144360
2015-06-26,1,UG,66,535,607794,46901534386,8255969455,55157503841
2015-06-26,1,Alumni,3,46,25587,2549876582,153590481,2703467063
2015-06-26,1,Others(HKUST),6,115,253364,1145890272,69078300,1214968572
2015-06-26,1,Non-HKUST,4,74,82432,1763042782,190625656,1953668438
2015-06-26,1,Total,217,2240,3219636,139871949518,30666256560,170538206078
2015-06-26,G,Staff,135,706,702480,16825647825,4375364173,21201011998
2015-06-26,G,TPG,132,758,520202,28197987025,4496036221,32694023246
2015-06-26,G,RPG,120,529,533782,41717100777,6013619245,47730720022
2015-06-26,G,UG,304,1350,1047523,49190717153,6156035225,55346752378
2015-06-26,G,Alumni,16,97,94780,3021706091,1301732929,4323439020
2015-06-26,G,Others(HKUST),15,110,179545,2266147051,269029112,2535176163
2015-06-26,G,Non-HKUST,13,75,60774,5011905673,679745616,5691651289
2015-06-26,G,Total,735,3625,3139086,146231211595,23291562521,169522774116
2015-06-26,LG1,Staff,85,439,480933,20675634735,1330709793,22006344528
2015-06-26,LG1,TPG,110,1008,1178950,104766503695,40697282032,145463785727
2015-06-26,LG1,RPG,128,1061,1381587,113517103213,7052475663,120569578876
2015-06-26,LG1,UG,432,3924,3409076,294386048488,33305676985,327691725473
2015-06-26,LG1,Alumni,19,116,175303,5623450875,506289536,6129740411
2015-06-26,LG1,Others(HKUST),12,93,523793,2002531667,834520652,2837052319
2015-06-26,LG1,Non-HKUST,10,43,11402,1121503820,4693545211,5815049031
2015-06-26,LG1,Total,796,6684,7161044,542092776493,88420499872,630513276365
2015-06-26,LG3,Staff,81,206,114775,3896318578,492476513,4388795091
2015-06-26,LG3,TPG,47,255,325152,104390351233,20415714627,124806065860
2015-06-26,LG3,RPG,105,536,736574,246865799608,8285585252,255151384860
2015-06-26,LG3,UG,210,762,482973,60873231946,5122258653,65995490599
2015-06-26,LG3,Alumni,12,66,76763,5005954772,3272749495,8278704267
2015-06-26,LG3,Others(HKUST),8,73,139915,1753200510,173273093,1926473603
2015-06-26,LG3,Non-HKUST,6,64,127044,7531264118,39679321369,47210585487
2015-06-26,LG3,Total,469,1962,2003196,430316120765,77441379002,507757499767
2015-06-26,LG4,Staff,95,334,259976,14184243097,1296680619,15480923716
2015-06-26,LG4,TPG,48,306,552625,37217237233,5629807503,42847044736
2015-06-26,LG4,RPG,133,461,528206,59185934787,3738942846,62924877633
2015-06-26,LG4,UG,275,906,857177,54476848543,5505343133,59982191676
2015-06-26,LG4,Alumni,15,163,219770,14852169296,1314522027,16166691323
2015-06-26,LG4,Others(HKUST),14,164,248988,42606828006,12181624159,54788452165
2015-06-26,LG4,Non-HKUST,8,42,35660,562509164,223664235,786173399
2015-06-26,LG4,Total,588,2376,2702402,223085770126,29890584522,252976354648
2015-06-26,All-Floors,Staff,290,2345,2521506,66646440665,8878586062,75525026727
2015-06-26,All-Floors,TPG,200,2869,3433171,337389889864,89026532115,426416421979
2015-06-26,All-Floors,RPG,320,2855,3611024,474915136773,27916568978,502831705751
2015-06-26,All-Floors,UG,846,7477,6404543,505828380516,58345283451,564173663967
2015-06-26,All-Floors,Alumni,34,488,592203,31053157616,6548884468,37602042084
2015-06-26,All-Floors,Others(HKUST),28,555,1345605,49774597506,13527525316,63302122822
2015-06-26,All-Floors,Non-HKUST,24,298,317312,15990225557,45466902087,61457127644
2015-06-26,All-Floors,Total,1742,16887,18225364,1481597828497,249710282477,1731308110974
2015-06-27,1,Staff,12,89,241703,450991130,133965902,584957032
2015-06-27,1,TPG,24,240,387283,45642354805,8027803890,53670158695
2015-06-27,1,RPG,18,115,338676,16144258717,838981425,16983240142
2015-06-27,1,UG,29,160,260057,21649137558,1683435630,23332573188
2015-06-27,1,Alumni,3,5,605,76890837,8398557,85289394
2015-06-27,1,Others(HKUST),3,82,240237,862190939,57653003,919843942
2015-06-27,1,Non-HKUST,7,55,100977,7413449637,540676856,7954126493
2015-06-27,1,Total,96,746,1569538,92239273623,11290915263,103530188886
2015-06-27,G,Staff,41,236,244845,6820323989,552211599,7372535588
2015-06-27,G,TPG,81,396,309135,14896304684,1970911363,16867216047
2015-06-27,G,RPG,76,371,494289,39488824155,4865980154,44354804309
2015-06-27,G,UG,149,812,731248,35540765207,4350050740,39890815947
2015-06-27,G,Alumni,32,118,87440,7462535243,3001093143,10463628386
2015-06-27,G,Others(HKUST),10,93,191082,8301895605,3672354138,11974249743
2015-06-27,G,Non-HKUST,18,78,137383,7776363387,623154925,8399518312
2015-06-27,G,Total,407,2104,2195422,120287012270,19035756062,139322768332
2015-06-27,LG1,Staff,37,251,349020,5563009953,984864517,6547874470
2015-06-27,LG1,TPG,79,624,571028,53549940022,32676962540,86226902562
2015-06-27,LG1,RPG,88,763,977523,54388316552,8928246605,63316563157
2015-06-27,LG1,UG,188,1828,2167591,204721867798,17219467596,221941335394
2015-06-27,LG1,Alumni,24,150,171940,16011277896,1147719712,17158997608
2015-06-27,LG1,Others(HKUST),6,58,522136,772379241,262442951,1034822192
2015-06-27,LG1,Non-HKUST,13,68,100822,2298924935,183691166,2482616101
2015-06-27,LG1,Total,435,3742,4860060,337305716397,61403395087,398709111484
2015-06-27,LG3,Staff,25,47,11789,338076606,19633236,357709842
2015-06-27,LG3,TPG,42,191,260338,12598807405,1985061795,14583869200
2015-06-27,LG3,RPG,60,239,323732,15772881598,4994968718,20767850316
2015-06-27,LG3,UG,116,333,255415,18610127199,2027921144,20638048343
2015-06-27,LG3,Alumni,22,138,170331,6505128395,866463140,7371591535
2015-06-27,LG3,Others(HKUST),2,40,73783,6845854,3715777,10561631
2015-06-27,LG3,Non-HKUST,9,52,96645,1440563146,1300056583,2740619729
2015-06-27,LG3,Total,276,1040,1192033,55272430203,11197820393,66470250596
2015-06-27,LG4,Staff,41,144,194554,7156421322,4319245346,11475666668
2015-06-27,LG4,TPG,33,271,396086,22830353902,5298439314,28128793216
2015-06-27,LG4,RPG,64,246,331439,14994461578,1695616300,16690077878
2015-06-27,LG4,UG,154,572,639186,62019660317,9278516546,71298176863
2015-06-27,LG4,Alumni,25,286,607864,25479687437,3963477373,29443164810
2015-06-27,LG4,Others(HKUST),5,162,289794,48371816285,10646956646,59018772931
2015-06-27,LG4,Non-HKUST,7,41,58331,2196861375,164603552,2361464927
2015-06-27,LG4,Total,329,1722,2517254,183049262216,35366855077,218416117293
2015-06-27,All-Floors,Staff,106,767,1041911,20328823000,6009920600,26338743600
2015-06-27,All-Floors,TPG,148,1722,1923870,149517760818,49959178902,199476939720
2015-06-27,All-Floors,RPG,189,1734,2465659,140788742600,21323793202,162112535802
2015-06-27,All-Floors,UG,403,3705,4053497,342541558079,34559391656,377100949735
2015-06-27,All-Floors,Alumni,56,697,1038180,55535519808,8987151925,64522671733
2015-06-27,All-Floors,Others(HKUST),17,435,1317032,58315127924,14643122515,72958250439
2015-06-27,All-Floors,Non-HKUST,28,294,494158,21126162480,2812183082,23938345562
2015-06-27,All-Floors,Total,947,9354,12334307,788153694709,138294741882,926448436591
2015-06-28,1,Staff,12,113,204847,214145141,178758983,392904124
2015-06-28,1,TPG,15,154,207093,25269425158,3655807706,28925232864
2015-06-28,1,RPG,21,124,197652,16608358195,3143067521,19751425716
2015-06-28,1,UG,16,101,178563,2625835184,539175699,3165010883
2015-06-28,1,Alumni,1,12,24613,142532949,50049866,192582815
2015-06-28,1,Others(HKUST),3,102,231991,104572494,14052994,118625488
2015-06-28,1,Non-HKUST,4,43,26324,162967346,146829366,309796712
2015-06-28,1,Total,72,649,1071083,45127836467,7727742135,52855578602
2015-06-28,G,Staff,31,157,141472,5212505231,516949652,5729454883
2015-06-28,G,TPG,59,380,328092,15359934924,2229611490,17589546414
2015-06-28,G,RPG,75,300,361751,20722602075,1742543159,22465145234
2015-06-28,G,UG,119,573,554366,20114101433,2718267078,22832368511
2015-06-28,G,Alumni,24,128,90837,4565965209,499391244,5065356453
2015-06-28,G,Others(HKUST),7,26,122627,430162862,109937479,540100341
2015-06-28,G,Non-HKUST,9,37,26893,10372468523,1034790280,11407258803
2015-06-28,G,Total,324,1601,1626038,76777740257,8851490382,85629230639
2015-06-28,LG1,Staff,24,128,268013,5223422250,606367103,5829789353
2015-06-28,LG1,TPG,60,573,606471,80176020362,10325738914,90501759276
2015-06-28,LG1,RPG,56,444,647016,29570887039,2977207628,32548094667
2015-06-28,LG1,UG,160,1326,1663764,127566470301,23344805704,150911276005
2015-06-28,LG1,Alumni,23,111,127210,10653389236,511693353,11165082589
2015-06-28,LG1,Others(HKUST),7,69,552278,654101988,259949740,914051728
2015-06-28,LG1,Non-HKUST,12,39,82470,4722581279,323710447,5046291726
2015-06-28,LG1,Total,342,2690,3947222,258566872455,38349472889,296916345344
2015-06-28,LG3,Staff,20,75,76114,1735095908,105121310,1840217218
2015-06-28,LG3,TPG,40,111,149660,11651461405,2315541129,13967002534
2015-06-28,LG3,RPG,55,159,169354,25246721438,1966330313,27213051751
2015-06-28,LG3,UG,106,348,332306,14198865934,1290139262,15489005196
2015-06-28,LG3,Alumni,19,140,237150,6891411849,813199046,7704610895
2015-06-28,LG3,Others(HKUST),3,40,63710,12804523,4426695,17231218
2015-06-28,LG3,Non-HKUST,9,16,11288,93615338,72173671,165789009
2015-06-28,LG3,Total,252,889,1039582,59829976395,6566931426,66396907821
2015-06-28,LG4,Staff,23,89,90600,4576465584,257188575,4833654159
2015-06-28,LG4,TPG,24,93,105604,13817727282,1395692390,15213419672
2015-06-28,LG4,RPG,66,243,199585,14358031228,1102980128,15461011356
2015-06-28,LG4,UG,103,387,420806,22347070534,3882268101,26229338635
2015-06-28,LG4,Alumni,16,108,150742,14357911626,1740234902,16098146528
2015-06-28,LG4,Others(HKUST),6,94,225680,45691922872,10453853564,56145776436
2015-06-28,LG4,Non-HKUST,9,54,45170,1814591956,97964635,1912556591
2015-06-28,LG4,Total,247,1068,1238187,116963721082,18930182295,135893903377
2015-06-28,All-Floors,Staff,67,562,781046,16961634114,1664385623,18626019737
2015-06-28,All-Floors,TPG,105,1311,1396920,146274569131,19922391629,166196960760
2015-06-28,All-Floors,RPG,181,1270,1575358,106506599975,10932128749,117438728724
2015-06-28,All-Floors,UG,344,2735,3149805,186852343386,31774655844,218626999230
2015-06-28,All-Floors,Alumni,49,499,630552,36611210869,3614568411,40225779280
2015-06-28,All-Floors,Others(HKUST),14,331,1196286,46893564739,10842220472,57735785211
2015-06-28,All-Floors,Non-HKUST,30,189,192145,17166224442,1675468399,18841692841
2015-06-28,All-Floors,Total,790,6897,8922112,557266146656,80425819127,637691965783
2015-06-29,1,Staff,58,488,820201,13160403351,1056875006,14217278357
2015-06-29,1,TPG,30,492,716354,36474420742,7608544962,44082965704
2015-06-29,1,RPG,45,533,1001340,33769076410,6201487682,39970564092
2015-06-29,1,UG,73,673,794734,55284366483,8126503049,63410869532
2015-06-29,1,Alumni,3,17,12084,428556685,57130094,485686779
2015-06-29,1,Others(HKUST),5,158,263985,1100581828,374520256,1475102084
2015-06-29,1,Non-HKUST,7,74,73488,4617535792,1046850504,5664386296
2015-06-29,1,Total,221,2435,3682186,144834941291,24471911553,169306852844
2015-06-29,G,Staff,122,642,570314,16415550260,5038657653,21454207913
2015-06-29,G,TPG,124,789,602646,25360224918,3829536468,29189761386
2015-06-29,G,RPG,143,678,658194,32392325269,6220026396,38612351665
2015-06-29,G,UG,398,1818,1333903,59672074293,9963998972,69636073265
2015-06-29,G,Alumni,16,50,49954,2455394640,223586524,2678981164
2015-06-29,G,Others(HKUST),17,213,184889,1559337368,470587567,2029924935
2015-06-29,G,Non-HKUST,22,96,105101,9151270111,702707903,9853978014
2015-06-29,G,Total,842,4286,3505001,147006176859,26449101483,173455278342
2015-06-29,LG1,Staff,89,546,517636,9362213892,1288331580,10650545472
2015-06-29,LG1,TPG,110,1059,1211965,78751449347,16310687228,95062136575
2015-06-29,LG1,RPG,135,1176,1500140,55035444002,6277088017,61312532019
2015-06-29,LG1,UG,501,4253,4172134,258114631552,50853723290,308968354842
2015-06-29,LG1,Alumni,15,106,119011,3285966887,451197658,3737164545
2015-06-29,LG1,Others(HKUST),13,176,528698,1865478496,543753803,2409232299
2015-06-29,LG1,Non-HKUST,27,137,119796,10973163641,1351414509,12324578150
2015-06-29,LG1,Total,890,7453,8169380,417388347817,77076196085,494464543902
2015-06-29,LG3,Staff,88,270,192424,4496014156,434887903,4930902059
2015-06-29,LG3,TPG,42,264,269417,25360001577,3442942156,28802943733
2015-06-29,LG3,RPG,108,616,1002982,32869078674,5565486850,38434565524
2015-06-29,LG3,UG,258,811,704222,56373160755,5536546664,61909707419
2015-06-29,LG3,Alumni,12,63,81985,1052401295,561890188,1614291483
2015-06-29,LG3,Others(HKUST),15,134,92021,450317677,201253030,651570707
2015-06-29,LG3,Non-HKUST,14,100,108503,2333153568,1857435646,4190589214
2015-06-29,LG3,Total,537,2258,2451554,122934127702,17600442437,140534570139
2015-06-29,LG4,Staff,73,302,201686,8266558086,775950807,9042508893
2015-06-29,LG4,TPG,41,339,542301,54865636543,5661999153,60527635696
2015-06-29,LG4,RPG,112,563,682498,26615798271,3557087281,30172885552
2015-06-29,LG4,UG,241,1013,934330,65765406187,8612873265,74378279452
2015-06-29,LG4,Alumni,14,209,278612,7567166578,757483963,8324650541
2015-06-29,LG4,Others(HKUST),12,201,241215,42288910425,11506004453,53794914878
2015-06-29,LG4,Non-HKUST,18,185,108657,9782224110,1402757784,11184981894
2015-06-29,LG4,Total,511,2812,2989299,215151700200,32274156706,247425856906
2015-06-29,All-Floors,Staff,250,2248,2302261,51700739745,8594702949,60295442694
2015-06-29,All-Floors,TPG,197,2943,3342683,220811733127,36853709967,257665443094
2015-06-29,All-Floors,RPG,308,3566,4845154,180681722626,27821176226,208502898852
2015-06-29,All-Floors,UG,918,8568,7939323,495209639270,83093645240,578303284510
2015-06-29,All-Floors,Alumni,32,445,541646,14789486085,2051288427,16840774512
2015-06-29,All-Floors,Others(HKUST),32,882,1310808,47264625794,13096119109,60360744903
2015-06-29,All-Floors,Non-HKUST,50,592,515545,36857347222,6361166346,43218513568
2015-06-29,All-Floors,Total,1787,19244,20797420,1047315293869,177871808264,1225187102133
2015-06-30,1,Staff,46,407,777149,9423253027,816002008,10239255035
2015-06-30,1,TPG,25,324,485491,39022739435,4239432068,43262171503
2015-06-30,1,RPG,38,416,582647,27820051965,3216177798,31036229763
2015-06-30,1,UG,56,553,670454,31745745959,4738559646,36484305605
2015-06-30,1,Alumni,3,3,0,5807501,1854150,7661651
2015-06-30,1,Others(HKUST),5,197,212891,585809321,385617900,971427221
2015-06-30,1,Non-HKUST,2,20,22677,1627034058,127552653,1754586711
2015-06-30,1,Total,175,1920,2751309,110230441266,13525196223,123755637489
2015-06-30,G,Staff,121,645,490576,25348283135,1910083191,27258366326
2015-06-30,G,TPG,86,471,391685,30407741166,7124512753,37532253919
2015-06-30,G,RPG,155,607,642674,35612350449,3042796068,38655146517
2015-06-30,G,UG,309,1771,1471910,68250277327,7237938592,75488215919
2015-06-30,G,Alumni,19,77,55569,4708175353,381249185,5089424538
2015-06-30,G,Others(HKUST),14,197,224640,2946437299,558908410,3505345709
2015-06-30,G,Non-HKUST,18,56,48654,1540410739,198261395,1738672134
2015-06-30,G,Total,722,3824,3325708,168813675468,20453749594,189267425062
2015-06-30,LG1,Staff,82,443,313614,10044235507,980558048,11024793555
2015-06-30,LG1,TPG,94,1069,1234182,193893832075,63934068615,257827900690
2015-06-30,LG1,RPG,126,923,1105194,43739982975,6320639621,50060622596
2015-06-30,LG1,UG,384,3298,3277806,233107219029,38651305002,271758524031
2015-06-30,LG1,Alumni,14,144,233257,4768522602,449171867,5217694469
2015-06-30,LG1,Others(HKUST),13,134,614184,3548095870,725293601,4273389471
2015-06-30,LG1,Non-HKUST,13,36,39144,3039803678,232277067,3272080745
2015-06-30,LG1,Total,726,6047,6817381,492141691736,111293313821,603435005557
2015-06-30,LG3,Staff,79,282,138242,1268571985,230838392,1499410377
2015-06-30,LG3,TPG,41,221,297874,35835442987,12649697965,48485140952
2015-06-30,LG3,RPG,102,718,1031402,73620666291,6765079957,80385746248
2015-06-30,LG3,UG,212,687,554993,33966842832,7505599376,41472442208
2015-06-30,LG3,Alumni,11,62,146404,2160539708,262032673,2422572381
2015-06-30,LG3,Others(HKUST),11,106,95214,4822191281,690419512,5512610793
2015-06-30,LG3,Non-HKUST,7,86,71327,19637281018,872316125,20509597143
2015-06-30,LG3,Total,463,2162,2335456,171311536102,28975984000,200287520102
2015-06-30,LG4,Staff,105,329,214785,6368454907,1585986964,7954441871
2015-06-30,LG4,TPG,32,282,543582,74183460527,8305768271,82489228798
2015-06-30,LG4,RPG,113,493,810930,47755930743,7592523750,55348454493
2015-06-30,LG4,UG,238,969,924832,61044357069,4687057252,65731414321
2015-06-30,LG4,Alumni,10,168,279768,16363091597,1138726666,17501818263
2015-06-30,LG4,Others(HKUST),12,326,306636,12905504083,1199587139,14105091222
2015-06-30,LG4,Non-HKUST,15,109,169185,22369670157,7255243181,29624913338
2015-06-30,LG4,Total,525,2676,3249718,240990469083,31764893223,272755362306
2015-06-30,All-Floors,Staff,265,2106,1934366,52452798561,5523468603,57976267164
2015-06-30,All-Floors,TPG,155,2367,2952814,373343216190,96253479672,469596695862
2015-06-30,All-Floors,RPG,309,3157,4172847,228548982423,26937217194,255486199617
2015-06-30,All-Floors,UG,750,7278,6899995,428114442216,62820459868,490934902084
2015-06-30,All-Floors,Alumni,27,454,714998,28006136761,2233034541,30239171302
2015-06-30,All-Floors,Others(HKUST),26,960,1453565,24808037854,3559826562,28367864416
2015-06-30,All-Floors,Non-HKUST,37,307,350987,48214199650,8685650421,56899850071
2015-06-30,All-Floors,Total,1569,16629,18479572,1183487813655,206013136861,1389500950516
