Date,Floor,User-Group,User-Count,WiFi-Conn,Duration-Sec,Traffic-In-Byte,Traffic-Out-Byte,Traffic-Both-Byte
2016-01-01,1,Staff,5,74,190211,17021057,7909254,24930311
2016-01-01,1,TPG,1,1,844,11489764,2342947,13832711
2016-01-01,1,RPG,10,18,18806,5765210,1807918,7573128
2016-01-01,1,UG,6,7,3134,232487610,35615671,268103281
2016-01-01,1,Alumni,0,0,0,0,0,0
2016-01-01,1,Others(HKUST),3,88,122988,7607492,3364045,10971537
2016-01-01,1,Non-HKUST,0,0,0,0,0,0
2016-01-01,1,Total,25,188,335983,274371133,51039835,325410968
2016-01-01,G,Staff,3,3,2518,268411,52264,320675
2016-01-01,G,TPG,1,1,0,0,0,0
2016-01-01,G,RPG,2,2,1078,590524,63825,654349
2016-01-01,G,UG,13,13,2404,42912993,2048339,44961332
2016-01-01,G,Alumni,1,2,365,90621,4775,95396
2016-01-01,G,Others(HKUST),2,3,87118,184603049,62050201,246653250
2016-01-01,G,Non-HKUST,0,0,0,0,0,0
2016-01-01,G,Total,22,24,93483,228465598,64219404,292685002
2016-01-01,LG1,Staff,3,3,2525,82461,28045,110506
2016-01-01,LG1,TPG,0,0,0,0,0,0
2016-01-01,LG1,RPG,3,3,0,141137,79078,220215
2016-01-01,LG1,UG,3,3,720,35160671,1194301,36354972
2016-01-01,LG1,Alumni,0,0,0,0,0,0
2016-01-01,LG1,Others(HKUST),1,6,431874,231371989,164380379,395752368
2016-01-01,LG1,Non-HKUST,0,0,0,0,0,0
2016-01-01,LG1,Total,10,15,435119,266756258,165681803,432438061
2016-01-01,LG3,Staff,7,20,7567,511781,360188,871969
2016-01-01,LG3,TPG,2,2,839,155736,87659,243395
2016-01-01,LG3,RPG,9,9,4799,7139803,662405,7802208
2016-01-01,LG3,UG,26,33,9972,23488171,2360814,25848985
2016-01-01,LG3,Alumni,1,2,478,33474,27407,60881
2016-01-01,LG3,Others(HKUST),2,3,2393,48675,21612,70287
2016-01-01,LG3,Non-HKUST,1,1,0,0,0,0
2016-01-01,LG3,Total,48,70,26048,31377640,3520085,34897725
2016-01-01,LG4,Staff,12,18,6138,1616892,269570,1886462
2016-01-01,LG4,TPG,6,8,2404,130503,38969,169472
2016-01-01,LG4,RPG,53,62,28953,324298938,204845651,529144589
2016-01-01,LG4,UG,87,185,97102,4618874274,177778872,4796653146
2016-01-01,LG4,Alumni,2,2,962,1042682,75139,1117821
2016-01-01,LG4,Others(HKUST),2,80,172898,8379679780,3639137923,12018817703
2016-01-01,LG4,Non-HKUST,6,7,4455,1977676,466612,2444288
2016-01-01,LG4,Total,168,362,312912,13327620745,4022612736,17350233481
2016-01-01,All-Floors,Staff,28,118,208959,19500602,8619321,28119923
2016-01-01,All-Floors,TPG,9,12,4087,11776003,2469575,14245578
2016-01-01,All-Floors,RPG,72,94,53636,337935612,207458877,545394489
2016-01-01,All-Floors,UG,121,241,113332,4952923719,218997997,5171921716
2016-01-01,All-Floors,Alumni,4,6,1805,1166777,107321,1274098
2016-01-01,All-Floors,Others(HKUST),7,180,817271,8803310985,3868954160,12672265145
2016-01-01,All-Floors,Non-HKUST,7,8,4455,1977676,466612,2444288
2016-01-01,All-Floors,Total,248,659,1203545,14128591374,4307073863,18435665237
2016-01-02,1,Staff,13,133,222136,1710068394,121308979,1831377373
2016-01-02,1,TPG,12,129,229304,14904070550,1830594057,16734664607
2016-01-02,1,RPG,19,126,132217,5717690638,395904946,6113595584
2016-01-02,1,UG,8,22,28406,863814401,48605028,912419429
2016-01-02,1,Alumni,7,27,62429,1324883475,92843712,1417727187
2016-01-02,1,Others(HKUST),3,57,86219,551782985,47309983,599092968
2016-01-02,1,Non-HKUST,5,20,30131,6134741673,114205510,6248947183
2016-01-02,1,Total,67,514,790842,31207052116,2650772215,33857824331
2016-01-02,G,Staff,35,298,297972,3424820302,225599952,3650420254
2016-01-02,G,TPG,45,208,207687,70921608120,2413620979,73335229099
2016-01-02,G,RPG,77,273,255892,20393830976,3461159580,23854990556
2016-01-02,G,UG,74,257,270383,11477460575,1511355958,12988816533
2016-01-02,G,Alumni,27,146,125127,13001422500,731483944,13732906444
2016-01-02,G,Others(HKUST),8,53,154974,37521898165,6320522080,43842420245
2016-01-02,G,Non-HKUST,14,30,25537,8566153622,465759773,9031913395
2016-01-02,G,Total,280,1265,1337572,165307194260,15129502266,180436696526
2016-01-02,LG1,Staff,23,229,238239,14356171449,2636458242,16992629691
2016-01-02,LG1,TPG,50,665,857323,75019618212,6104551547,81124169759
2016-01-02,LG1,RPG,78,615,719271,39978607157,4109872434,44088479591
2016-01-02,LG1,UG,126,1232,1443503,69660264024,10300503839,79960767863
2016-01-02,LG1,Alumni,18,102,148865,9157458367,451902239,9609360606
2016-01-02,LG1,Others(HKUST),5,38,453342,1084252980,695452268,1779705248
2016-01-02,LG1,Non-HKUST,19,97,133806,3971897890,398255371,4370153261
2016-01-02,LG1,Total,319,2978,3994349,213228270079,24696995940,237925266019
2016-01-02,LG3,Staff,24,88,45850,436948753,163440388,600389141
2016-01-02,LG3,TPG,30,144,304084,73556422691,13703747924,87260170615
2016-01-02,LG3,RPG,62,356,432933,28093779491,3575548404,31669327895
2016-01-02,LG3,UG,110,349,179601,12930165391,6103299420,19033464811
2016-01-02,LG3,Alumni,18,100,109993,7108710431,362949740,7471660171
2016-01-02,LG3,Others(HKUST),2,2,1555,20948987,135002864,155951851
2016-01-02,LG3,Non-HKUST,25,58,66289,7089574996,269432547,7359007543
2016-01-02,LG3,Total,271,1097,1140305,129236550740,24313421287,153549972027
2016-01-02,LG4,Staff,38,96,54896,1857274848,81176944,1938451792
2016-01-02,LG4,TPG,29,275,412056,31340419947,1495236253,32835656200
2016-01-02,LG4,RPG,74,311,404812,17252833116,2983376689,20236209805
2016-01-02,LG4,UG,97,455,457082,15196098869,1481338722,16677437591
2016-01-02,LG4,Alumni,13,119,156449,6919463501,16037784859,22957248360
2016-01-02,LG4,Others(HKUST),3,112,268645,20088505923,7584640988,27673146911
2016-01-02,LG4,Non-HKUST,29,89,95991,1650391323,290704005,1941095328
2016-01-02,LG4,Total,283,1457,1849931,94304987527,29954258460,124259245987
2016-01-02,All-Floors,Staff,88,844,859093,21785283746,3227984505,25013268251
2016-01-02,All-Floors,TPG,79,1421,2010454,265742139520,25547750760,291289890280
2016-01-02,All-Floors,RPG,181,1681,1945125,111436741378,14525862053,125962603431
2016-01-02,All-Floors,UG,270,2315,2378975,110127803260,19445102967,129572906227
2016-01-02,All-Floors,Alumni,45,494,602863,37511938274,17676964494,55188902768
2016-01-02,All-Floors,Others(HKUST),12,262,964735,59267389040,14782928183,74050317223
2016-01-02,All-Floors,Non-HKUST,63,294,351754,27412759504,1538357206,28951116710
2016-01-02,All-Floors,Total,738,7311,9112999,633284054722,96744950168,730029004890
2016-01-03,1,Staff,5,52,174453,2078417784,103902809,2182320593
2016-01-03,1,TPG,8,75,124728,9491812459,664409438,10156221897
2016-01-03,1,RPG,12,21,17638,32487930,10190234,42678164
2016-01-03,1,UG,8,19,47157,2818369746,242826667,3061196413
2016-01-03,1,Alumni,3,10,47409,1273839663,108174291,1382013954
2016-01-03,1,Others(HKUST),2,29,42529,2157073,860271,3017344
2016-01-03,1,Non-HKUST,3,12,18732,6931071551,288808273,7219879824
2016-01-03,1,Total,41,218,472646,22628156206,1419171983,24047328189
2016-01-03,G,Staff,23,77,111342,2891779344,177738341,3069517685
2016-01-03,G,TPG,24,90,50929,4682397007,411900100,5094297107
2016-01-03,G,RPG,48,129,116028,8290534608,4170813095,12461347703
2016-01-03,G,UG,71,249,266454,9334802228,1068404949,10403207177
2016-01-03,G,Alumni,22,111,90415,3891295189,966441945,4857737134
2016-01-03,G,Others(HKUST),4,17,88432,1413610259,474030260,1887640519
2016-01-03,G,Non-HKUST,14,64,72233,6283586023,205975217,6489561240
2016-01-03,G,Total,206,737,795833,36788004658,7475303907,44263308565
2016-01-03,LG1,Staff,22,150,181656,8799885609,640780284,9440665893
2016-01-03,LG1,TPG,35,416,411875,61004991406,4194666180,65199657586
2016-01-03,LG1,RPG,43,288,293916,24322131648,1576551079,25898682727
2016-01-03,LG1,UG,67,672,750629,43605912093,10126104702,53732016795
2016-01-03,LG1,Alumni,12,63,70813,6063187299,362575299,6425762598
2016-01-03,LG1,Others(HKUST),5,37,432829,525855332,343646044,869501376
2016-01-03,LG1,Non-HKUST,8,16,9246,374095584,100708070,474803654
2016-01-03,LG1,Total,192,1642,2150964,144696058971,17345031658,162041090629
2016-01-03,LG3,Staff,26,50,51342,903985745,100375846,1004361591
2016-01-03,LG3,TPG,12,35,58093,120311433,24236119,144547552
2016-01-03,LG3,RPG,39,109,139616,14664654044,9696385483,24361039527
2016-01-03,LG3,UG,76,149,88614,2908725450,194236395,3102961845
2016-01-03,LG3,Alumni,16,66,115507,2970144012,251660750,3221804762
2016-01-03,LG3,Others(HKUST),3,9,840,903374,3210748,4114122
2016-01-03,LG3,Non-HKUST,24,65,50542,805150265,107126714,912276979
2016-01-03,LG3,Total,196,483,504554,22373874323,10377232055,32751106378
2016-01-03,LG4,Staff,28,54,59989,879376711,48773231,928149942
2016-01-03,LG4,TPG,22,100,66449,2603045012,1204798288,3807843300
2016-01-03,LG4,RPG,69,186,118139,2042843071,3066823595,5109666666
2016-01-03,LG4,UG,97,265,177632,1105731330,425036117,1530767447
2016-01-03,LG4,Alumni,12,137,116935,71809389376,1230531984,73039921360
2016-01-03,LG4,Others(HKUST),1,71,143022,15213810939,1756609574,16970420513
2016-01-03,LG4,Non-HKUST,46,92,89451,860302017,165497930,1025799947
2016-01-03,LG4,Total,275,905,771617,94514498456,7898070719,102412569175
2016-01-03,All-Floors,Staff,80,383,578782,15553445193,1071570511,16625015704
2016-01-03,All-Floors,TPG,67,716,712074,77902557317,6500010125,84402567442
2016-01-03,All-Floors,RPG,147,733,685337,49352651301,18520763486,67873414787
2016-01-03,All-Floors,UG,239,1354,1330486,59773540847,12056608830,71830149677
2016-01-03,All-Floors,Alumni,35,387,441079,86007855539,2919384269,88927239808
2016-01-03,All-Floors,Others(HKUST),6,163,707652,17156336977,2578356897,19734693874
2016-01-03,All-Floors,Non-HKUST,69,249,240204,15254205440,868116204,16122321644
2016-01-03,All-Floors,Total,643,3985,4695614,321000592614,44514810322,365515402936
2016-01-04,1,Staff,74,708,1045929,9233417437,1026288055,10259705492
2016-01-04,1,TPG,23,200,318106,23518647463,3363800519,26882447982
2016-01-04,1,RPG,31,188,317182,8992312929,2304396890,11296709819
2016-01-04,1,UG,38,343,462021,16414310739,1475659730,17889970469
2016-01-04,1,Alumni,3,26,80388,1750140880,134450415,1884591295
2016-01-04,1,Others(HKUST),4,14,58847,216755852,329592717,546348569
2016-01-04,1,Non-HKUST,6,37,57097,7748856094,603063534,8351919628
2016-01-04,1,Total,179,1516,2339570,67874441394,9237251860,77111693254
2016-01-04,G,Staff,148,913,873308,23807562603,1748414014,25555976617
2016-01-04,G,TPG,87,447,424808,32827209147,5081984625,37909193772
2016-01-04,G,RPG,140,772,682611,36680071869,6131939149,42812011018
2016-01-04,G,UG,218,953,928586,31149598044,6898768363,38048366407
2016-01-04,G,Alumni,6,96,49306,1285391256,277702528,1563093784
2016-01-04,G,Others(HKUST),8,73,139833,4363174842,1264412835,5627587677
2016-01-04,G,Non-HKUST,22,114,98176,9306775722,742196140,10048971862
2016-01-04,G,Total,629,3368,3196628,139419783483,22145417654,161565201137
2016-01-04,LG1,Staff,103,538,485463,12438021670,768667819,13206689489
2016-01-04,LG1,TPG,74,996,822619,98854565286,8463088779,107317654065
2016-01-04,LG1,RPG,122,959,948207,62489887955,6196332471,68686220426
2016-01-04,LG1,UG,230,1889,2206597,102218945302,31219252468,133438197770
2016-01-04,LG1,Alumni,6,43,48576,533670174,67068966,600739140
2016-01-04,LG1,Others(HKUST),9,100,457791,1542384650,929986547,2472371197
2016-01-04,LG1,Non-HKUST,16,78,56500,1287602418,840552344,2128154762
2016-01-04,LG1,Total,560,4603,5025753,279365077455,48484949394,327850026849
2016-01-04,LG3,Staff,74,257,163430,14043179007,610517702,14653696709
2016-01-04,LG3,TPG,38,269,392275,11607618313,768247334,12375865647
2016-01-04,LG3,RPG,89,456,738796,27303632676,4678652319,31982284995
2016-01-04,LG3,UG,184,779,741067,73072713702,4257867152,77330580854
2016-01-04,LG3,Alumni,8,19,43432,487118157,59339742,546457899
2016-01-04,LG3,Others(HKUST),7,13,13826,866431783,25970709,892402492
2016-01-04,LG3,Non-HKUST,20,101,127289,7543834000,4163605097,11707439097
2016-01-04,LG3,Total,420,1894,2220115,134924527638,14564200055,149488727693
2016-01-04,LG4,Staff,119,375,154652,7710693323,348997304,8059690627
2016-01-04,LG4,TPG,40,230,359026,26594297218,10896407497,37490704715
2016-01-04,LG4,RPG,128,565,679843,104606528494,6066063874,110672592368
2016-01-04,LG4,UG,167,617,474638,64432303354,3000709131,67433012485
2016-01-04,LG4,Alumni,4,41,84425,3122246582,640438142,3762684724
2016-01-04,LG4,Others(HKUST),11,158,192961,6772324076,1584934095,8357258171
2016-01-04,LG4,Non-HKUST,44,114,48359,802348783,664236321,1466585104
2016-01-04,LG4,Total,513,2100,1993904,214040741830,23201786364,237242528194
2016-01-04,All-Floors,Staff,313,2791,2722782,67232874040,4502884894,71735758934
2016-01-04,All-Floors,TPG,141,2142,2316834,193402337427,28573528754,221975866181
2016-01-04,All-Floors,RPG,308,2940,3366639,240072433923,25377384703,265449818626
2016-01-04,All-Floors,UG,535,4581,4812909,287287871141,46852256844,334140127985
2016-01-04,All-Floors,Alumni,13,225,306127,7178567049,1178999793,8357566842
2016-01-04,All-Floors,Others(HKUST),27,358,863258,13761071203,4134896903,17895968106
2016-01-04,All-Floors,Non-HKUST,78,444,387421,26689417017,7013653436,33703070453
2016-01-04,All-Floors,Total,1415,13481,14775970,835624571800,117633605327,953258177127
2016-01-05,1,Staff,67,744,988949,11451964893,1276979751,12728944644
2016-01-05,1,TPG,24,144,267090,22966317242,13409181297,36375498539
2016-01-05,1,RPG,29,247,277957,6353314195,541881551,6895195746
2016-01-05,1,UG,41,324,363419,5851955037,955037447,6806992484
2016-01-05,1,Alumni,4,65,121809,5352132369,450256550,5802388919
2016-01-05,1,Others(HKUST),4,19,108242,1565007819,362401853,1927409672
2016-01-05,1,Non-HKUST,4,17,13537,531954837,2675678652,3207633489
2016-01-05,1,Total,173,1560,2141003,54072646392,19671417101,73744063493
2016-01-05,G,Staff,128,826,824947,18101654897,2206665671,20308320568
2016-01-05,G,TPG,101,691,703790,94822461450,4280738821,99103200271
2016-01-05,G,RPG,124,587,523408,19029007158,1875797350,20904804508
2016-01-05,G,UG,191,700,509425,45991304032,5787735297,51779039329
2016-01-05,G,Alumni,12,42,49488,1221412846,148789291,1370202137
2016-01-05,G,Others(HKUST),13,116,150575,14195936068,3446422981,17642359049
2016-01-05,G,Non-HKUST,17,187,166924,15412194817,1392878684,16805073501
2016-01-05,G,Total,586,3149,2928557,208773971268,19139028095,227912999363
2016-01-05,LG1,Staff,87,487,474018,9953176290,3748779107,13701955397
2016-01-05,LG1,TPG,109,1305,1326867,95721197581,5869018299,101590215880
2016-01-05,LG1,RPG,121,1111,1130570,55638925490,9528432077,65167357567
2016-01-05,LG1,UG,227,2128,2330868,158933306443,17502305307,176435611750
2016-01-05,LG1,Alumni,3,38,49205,178212095,25983578,204195673
2016-01-05,LG1,Others(HKUST),9,63,457307,1992963632,1103889310,3096852942
2016-01-05,LG1,Non-HKUST,15,61,109033,4959626478,2316084013,7275710491
2016-01-05,LG1,Total,571,5193,5877868,327377408009,40094491691,367471899700
2016-01-05,LG3,Staff,97,341,335140,16066640688,921224882,16987865570
2016-01-05,LG3,TPG,53,299,368989,18571039287,3062531477,21633570764
2016-01-05,LG3,RPG,92,436,566396,42115592891,6316833781,48432426672
2016-01-05,LG3,UG,208,890,720815,73385331864,4690847998,78076179862
2016-01-05,LG3,Alumni,6,30,42590,3930516980,218145960,4148662940
2016-01-05,LG3,Others(HKUST),8,34,23506,558551917,45526048,604077965
2016-01-05,LG3,Non-HKUST,15,65,49578,6657892600,1022007311,7679899911
2016-01-05,LG3,Total,479,2095,2107014,161285566227,16277117457,177562683684
2016-01-05,LG4,Staff,117,456,163499,21706992304,1263538042,22970530346
2016-01-05,LG4,TPG,40,280,339539,41551787780,1925741746,43477529526
2016-01-05,LG4,RPG,146,568,539367,26305898001,2926416325,29232314326
2016-01-05,LG4,UG,204,641,537005,22097878720,1355173115,23453051835
2016-01-05,LG4,Alumni,4,22,41903,3921802023,174487654,4096289677
2016-01-05,LG4,Others(HKUST),6,151,182857,13020360105,2437962430,15458322535
2016-01-05,LG4,Non-HKUST,29,93,35118,63560648,24396464,87957112
2016-01-05,LG4,Total,546,2211,1839288,128668279581,10107715776,138775995357
2016-01-05,All-Floors,Staff,309,2854,2786553,77280429072,9417187453,86697616525
2016-01-05,All-Floors,TPG,171,2719,3006275,273632803340,28547211640,302180014980
2016-01-05,All-Floors,RPG,325,2949,3037698,149442737735,21189361084,170632098819
2016-01-05,All-Floors,UG,587,4683,4461532,306259776096,30291099164,336550875260
2016-01-05,All-Floors,Alumni,16,197,304995,14604076313,1017663033,15621739346
2016-01-05,All-Floors,Others(HKUST),20,383,922487,31332819541,7396202622,38729022163
2016-01-05,All-Floors,Non-HKUST,58,423,374190,27625229380,7431045124,35056274504
2016-01-05,All-Floors,Total,1486,14208,14893730,880177871477,105289770120,985467641597
2016-01-06,1,Staff,68,751,1154604,12114081083,2089552885,14203633968
2016-01-06,1,TPG,25,280,385914,55300414237,5601352757,60901766994
2016-01-06,1,RPG,32,215,323563,5623619089,895346947,6518966036
2016-01-06,1,UG,46,316,500680,6807478343,2313240088,9120718431
2016-01-06,1,Alumni,2,39,61661,2569818196,206668475,2776486671
2016-01-06,1,Others(HKUST),3,18,39540,172486164,29401100,201887264
2016-01-06,1,Non-HKUST,5,30,51705,20438150456,552835298,20990985754
2016-01-06,1,Total,181,1649,2517667,103026047568,11688397550,114714445118
2016-01-06,G,Staff,129,773,724361,13402617990,2540292205,15942910195
2016-01-06,G,TPG,110,745,648801,71723900098,8607057005,80330957103
2016-01-06,G,RPG,134,627,632805,12448397033,2604279747,15052676780
2016-01-06,G,UG,180,852,623255,51728845155,4625765953,56354611108
2016-01-06,G,Alumni,18,66,37190,1113369040,136337990,1249707030
2016-01-06,G,Others(HKUST),11,70,156443,8062707872,1235825456,9298533328
2016-01-06,G,Non-HKUST,17,93,160794,10033612808,2047601270,12081214078
2016-01-06,G,Total,599,3226,2983649,168513449996,21797159626,190310609622
2016-01-06,LG1,Staff,110,630,491528,13092905613,1660928786,14753834399
2016-01-06,LG1,TPG,104,1266,1002376,121315630444,11900389951,133216020395
2016-01-06,LG1,RPG,118,1093,1117161,374086898446,19382166795,393469065241
2016-01-06,LG1,UG,260,2305,2402828,128050938645,14750550049,142801488694
2016-01-06,LG1,Alumni,14,149,124847,5341632455,380030384,5721662839
2016-01-06,LG1,Others(HKUST),9,55,440607,3264167727,1792322214,5056489941
2016-01-06,LG1,Non-HKUST,16,126,105700,9152968357,816374284,9969342641
2016-01-06,LG1,Total,631,5624,5685047,654305141687,50682762463,704987904150
2016-01-06,LG3,Staff,90,359,286165,13504135047,888649491,14392784538
2016-01-06,LG3,TPG,56,484,631124,57576553718,4801336765,62377890483
2016-01-06,LG3,RPG,96,521,726913,94668551988,4899101931,99567653919
2016-01-06,LG3,UG,180,877,720598,79350385306,16680024132,96030409438
2016-01-06,LG3,Alumni,11,56,33419,737706484,65101272,802807756
2016-01-06,LG3,Others(HKUST),8,31,27975,993876604,50555355,1044431959
2016-01-06,LG3,Non-HKUST,8,62,76636,2095070547,447215887,2542286434
2016-01-06,LG3,Total,449,2390,2502830,248926279694,27831984833,276758264527
2016-01-06,LG4,Staff,122,471,224423,24845475822,1163122676,26008598498
2016-01-06,LG4,TPG,47,357,291560,28911947701,2275119541,31187067242
2016-01-06,LG4,RPG,140,757,851309,45341571992,11378219910,56719791902
2016-01-06,LG4,UG,172,464,272730,23212156877,1242995951,24455152828
2016-01-06,LG4,Alumni,9,85,180284,2884345364,264197427,3148542791
2016-01-06,LG4,Others(HKUST),7,176,248773,9980071034,796250151,10776321185
2016-01-06,LG4,Non-HKUST,8,27,38747,1253840263,47733682,1301573945
2016-01-06,LG4,Total,505,2337,2107826,136429409053,17167639338,153597048391
2016-01-06,All-Floors,Staff,309,2984,2881081,76959215555,8342546043,85301761598
2016-01-06,All-Floors,TPG,180,3132,2959775,334828446198,33185256019,368013702217
2016-01-06,All-Floors,RPG,321,3213,3651751,532169038548,39159115330,571328153878
2016-01-06,All-Floors,UG,557,4814,4520091,289149804326,39612576173,328762380499
2016-01-06,All-Floors,Alumni,25,395,437401,12646871539,1052335548,13699207087
2016-01-06,All-Floors,Others(HKUST),21,350,913338,22473309401,3904354276,26377663677
2016-01-06,All-Floors,Non-HKUST,38,338,433582,42973642431,3911760421,46885402852
2016-01-06,All-Floors,Total,1451,15226,15797019,1311200327998,129167943810,1440368271808
2016-01-07,1,Staff,88,780,1205603,19535462689,1272034950,20807497639
2016-01-07,1,TPG,21,152,229071,13553923641,1258862586,14812786227
2016-01-07,1,RPG,39,302,356448,11794315963,3208447646,15002763609
2016-01-07,1,UG,44,279,446285,10143660925,2976734201,13120395126
2016-01-07,1,Alumni,4,74,157650,7263359020,913107703,8176466723
2016-01-07,1,Others(HKUST),1,1,0,0,0,0
2016-01-07,1,Non-HKUST,7,19,28827,1306539514,82450600,1388990114
2016-01-07,1,Total,204,1607,2423884,63597261752,9711637686,73308899438
2016-01-07,G,Staff,136,861,716594,18920236333,1554500449,20474736782
2016-01-07,G,TPG,95,782,725467,45405897847,15930441890,61336339737
2016-01-07,G,RPG,143,585,562798,22110181574,3806753973,25916935547
2016-01-07,G,UG,157,656,600378,19553003785,3114552897,22667556682
2016-01-07,G,Alumni,11,41,17862,1069448486,330972904,1400421390
2016-01-07,G,Others(HKUST),7,49,149542,8237346885,987996175,9225343060
2016-01-07,G,Non-HKUST,21,83,71472,1451963022,123240020,1575203042
2016-01-07,G,Total,570,3057,2844113,116748077932,25848458308,142596536240
2016-01-07,LG1,Staff,100,636,522282,20566971981,2574109494,23141081475
2016-01-07,LG1,TPG,101,1328,1086657,105071521134,13563781507,118635302641
2016-01-07,LG1,RPG,148,1616,1550844,179781672636,11079586218,190861258854
2016-01-07,LG1,UG,261,3017,3044228,141335481044,16930101191,158265582235
2016-01-07,LG1,Alumni,14,144,121669,3995833607,348313851,4344147458
2016-01-07,LG1,Others(HKUST),12,115,473537,3262000722,1482883366,4744884088
2016-01-07,LG1,Non-HKUST,12,92,73954,1805632562,742930096,2548562658
2016-01-07,LG1,Total,648,6948,6873171,455819113686,46721705723,502540819409
2016-01-07,LG3,Staff,83,389,305130,43663891188,1756802868,45420694056
2016-01-07,LG3,TPG,38,195,223896,19313633169,743641493,20057274662
2016-01-07,LG3,RPG,93,506,596082,44391434001,3036735346,47428169347
2016-01-07,LG3,UG,161,471,253474,16401761235,1140780333,17542541568
2016-01-07,LG3,Alumni,4,42,25215,491213705,80827258,572040963
2016-01-07,LG3,Others(HKUST),10,33,22056,1064074226,44217665,1108291891
2016-01-07,LG3,Non-HKUST,9,27,37273,317557529,462979765,780537294
2016-01-07,LG3,Total,398,1663,1463126,125643565053,7265984728,132909549781
2016-01-07,LG4,Staff,137,474,190290,5951845363,219916858,6171762221
2016-01-07,LG4,TPG,43,280,347995,11627800824,810445601,12438246425
2016-01-07,LG4,RPG,153,899,865354,41936567676,7418680309,49355247985
2016-01-07,LG4,UG,188,553,416539,80027079165,4575269001,84602348166
2016-01-07,LG4,Alumni,9,95,117855,5928811905,462426778,6391238683
2016-01-07,LG4,Others(HKUST),6,127,204730,17746400393,1087998794,18834399187
2016-01-07,LG4,Non-HKUST,9,38,39235,160332249,25116501,185448750
2016-01-07,LG4,Total,545,2466,2181998,163378837575,14599853842,177978691417
2016-01-07,All-Floors,Staff,322,3140,2939899,108638407554,7377364619,116015772173
2016-01-07,All-Floors,TPG,163,2737,2613086,194972776615,32307173077,227279949692
2016-01-07,All-Floors,RPG,336,3908,3931526,300014171850,28550203492,328564375342
2016-01-07,All-Floors,UG,538,4976,4760904,267460986154,28737437623,296198423777
2016-01-07,All-Floors,Alumni,20,396,440251,18748666723,2135648494,20884315217
2016-01-07,All-Floors,Others(HKUST),23,325,849865,30309822226,3603096000,33912918226
2016-01-07,All-Floors,Non-HKUST,34,259,250761,5042024876,1436716982,6478741858
2016-01-07,All-Floors,Total,1436,15741,15786292,925186855998,104147640287,1029334496285
2016-01-08,1,Staff,70,760,1159271,8726065099,1784686131,10510751230
2016-01-08,1,TPG,23,192,348881,26747628818,3002283304,29749912122
2016-01-08,1,RPG,30,250,324280,8895829336,1428383323,10324212659
2016-01-08,1,UG,35,251,235593,1916705127,423477621,2340182748
2016-01-08,1,Alumni,2,2,0,2506391142,53422028,2559813170
2016-01-08,1,Others(HKUST),1,8,71239,79570669,2839502,82410171
2016-01-08,1,Non-HKUST,3,41,36068,4072294629,231264079,4303558708
2016-01-08,1,Total,164,1504,2175332,52944484820,6926355988,59870840808
2016-01-08,G,Staff,125,734,763133,9006640904,1659670875,10666311779
2016-01-08,G,TPG,90,671,657324,47415147698,6482315117,53897462815
2016-01-08,G,RPG,137,725,763938,22375795030,3813953877,26189748907
2016-01-08,G,UG,180,974,722399,101468570337,24972694788,126441265125
2016-01-08,G,Alumni,6,63,36166,7360380519,277685456,7638065975
2016-01-08,G,Others(HKUST),10,39,134086,1893249348,125792773,2019042121
2016-01-08,G,Non-HKUST,13,59,68304,3569816723,9931054963,13500871686
2016-01-08,G,Total,561,3265,3145350,193089600559,47263167849,240352768408
2016-01-08,LG1,Staff,101,555,491706,20333225043,2568339492,22901564535
2016-01-08,LG1,TPG,90,1411,1356864,101677752053,17705925310,119383677363
2016-01-08,LG1,RPG,154,1551,1456383,116444208360,39471380129,155915588489
2016-01-08,LG1,UG,266,2856,2723274,99512207961,27481505993,126993713954
2016-01-08,LG1,Alumni,7,91,114996,976891274,210529574,1187420848
2016-01-08,LG1,Others(HKUST),9,86,476953,3285742383,2047363391,5333105774
2016-01-08,LG1,Non-HKUST,12,84,95131,828308570,1613160390,2441468960
2016-01-08,LG1,Total,639,6634,6715307,343058335644,91098204279,434156539923
2016-01-08,LG3,Staff,89,417,302205,18826165079,1711275557,20537440636
2016-01-08,LG3,TPG,37,324,464068,19547991680,1202830429,20750822109
2016-01-08,LG3,RPG,113,799,827549,36088489995,4090264101,40178754096
2016-01-08,LG3,UG,165,410,251516,19808588101,2059638724,21868226825
2016-01-08,LG3,Alumni,7,30,27992,145019571,70483695,215503266
2016-01-08,LG3,Others(HKUST),10,33,32491,26968007,4738082,31706089
2016-01-08,LG3,Non-HKUST,6,34,35259,1530887378,6551728946,8082616324
2016-01-08,LG3,Total,427,2047,1941080,95974109811,15690959534,111665069345
2016-01-08,LG4,Staff,111,404,222930,8387496330,588126852,8975623182
2016-01-08,LG4,TPG,41,205,206687,28945440395,1932152251,30877592646
2016-01-08,LG4,RPG,153,726,770061,42011572256,2921362595,44932934851
2016-01-08,LG4,UG,190,584,415978,24979879191,2295195049,27275074240
2016-01-08,LG4,Alumni,5,46,94932,367043091,56485781,423528872
2016-01-08,LG4,Others(HKUST),5,165,245151,17322289380,1714230554,19036519934
2016-01-08,LG4,Non-HKUST,8,35,45875,3076869607,395061650,3471931257
2016-01-08,LG4,Total,513,2165,2001614,125090590250,9902614732,134993204982
2016-01-08,All-Floors,Staff,280,2870,2939245,65279592455,8312098907,73591691362
2016-01-08,All-Floors,TPG,150,2803,3033824,224333960644,30325506411,254659467055
2016-01-08,All-Floors,RPG,323,4051,4142211,225815894977,51725344025,277541239002
2016-01-08,All-Floors,UG,570,5075,4348760,247685950717,57232512175,304918462892
2016-01-08,All-Floors,Alumni,14,232,274086,11355725597,668606534,12024332131
2016-01-08,All-Floors,Others(HKUST),18,331,959920,22607819787,3894964302,26502784089
2016-01-08,All-Floors,Non-HKUST,25,253,280637,13078176907,18722270028,31800446935
2016-01-08,All-Floors,Total,1380,15615,15978683,810157121084,170881302382,981038423466
2016-01-09,1,Staff,17,144,320973,1714943916,135940915,1850884831
2016-01-09,1,TPG,27,322,531077,53270090438,3633543618,56903634056
2016-01-09,1,RPG,21,155,174116,3617267066,367145416,3984412482
2016-01-09,1,UG,19,66,114645,2302428361,217551994,2519980355
2016-01-09,1,Alumni,4,11,4303,94984238,53291499,148275737
2016-01-09,1,Others(HKUST),2,24,72239,2741867,1304678,4046545
2016-01-09,1,Non-HKUST,5,49,66433,11390720590,313716809,11704437399
2016-01-09,1,Total,95,771,1283786,72393176476,4722494929,77115671405
2016-01-09,G,Staff,37,280,292917,19489798550,717697078,20207495628
2016-01-09,G,TPG,83,615,665020,64594601602,9117389022,73711990624
2016-01-09,G,RPG,107,406,476129,15016888547,1394868349,16411756896
2016-01-09,G,UG,131,501,401584,31978670209,16552041775,48530711984
2016-01-09,G,Alumni,27,129,159850,20328613282,9134898576,29463511858
2016-01-09,G,Others(HKUST),12,73,188507,29922266795,2019599058,31941865853
2016-01-09,G,Non-HKUST,20,78,61845,5939369744,316882340,6256252084
2016-01-09,G,Total,417,2082,2245852,187270208729,39253376198,226523584927
2016-01-09,LG1,Staff,36,350,387171,14476477511,1285638899,15762116410
2016-01-09,LG1,TPG,107,1294,1301846,126571388474,36008113687,162579502161
2016-01-09,LG1,RPG,126,1179,1301118,91380334650,5925494166,97305828816
2016-01-09,LG1,UG,178,1717,2074073,79439359120,7036909747,86476268867
2016-01-09,LG1,Alumni,33,311,372545,91767891425,11710581456,103478472881
2016-01-09,LG1,Others(HKUST),6,68,444843,2582374772,1612435016,4194809788
2016-01-09,LG1,Non-HKUST,19,81,116220,2553691168,258018195,2811709363
2016-01-09,LG1,Total,505,5000,5997816,408771517120,63837191166,472608708286
2016-01-09,LG3,Staff,29,98,160991,1277481133,197035076,1474516209
2016-01-09,LG3,TPG,55,247,258228,13532333442,9673554361,23205887803
2016-01-09,LG3,RPG,86,425,542333,37991518497,3686550659,41678069156
2016-01-09,LG3,UG,124,403,252981,10145308122,846172951,10991481073
2016-01-09,LG3,Alumni,22,123,210008,6081961447,4865349823,10947311270
2016-01-09,LG3,Others(HKUST),2,11,816,122989,89187,212176
2016-01-09,LG3,Non-HKUST,14,73,174355,8765943258,464601375,9230544633
2016-01-09,LG3,Total,332,1380,1599712,77794668888,19733353432,97528022320
2016-01-09,LG4,Staff,31,74,71924,5524912396,202257030,5727169426
2016-01-09,LG4,TPG,34,314,282805,80965687694,4778757699,85744445393
2016-01-09,LG4,RPG,110,668,694380,84296694099,3799964350,88096658449
2016-01-09,LG4,UG,112,552,520422,23896445761,2442878696,26339324457
2016-01-09,LG4,Alumni,19,132,205854,13329621191,1850585073,15180206264
2016-01-09,LG4,Others(HKUST),2,140,393050,45027532601,3117449913,48144982514
2016-01-09,LG4,Non-HKUST,10,61,103947,6469718763,376606479,6846325242
2016-01-09,LG4,Total,318,1941,2272382,259510612505,16568499240,276079111745
2016-01-09,All-Floors,Staff,92,946,1233976,42483613506,2538568998,45022182504
2016-01-09,All-Floors,TPG,156,2792,3038976,338934101650,63211358387,402145460037
2016-01-09,All-Floors,RPG,252,2833,3188076,232302702859,15174022940,247476725799
2016-01-09,All-Floors,UG,364,3239,3363705,147762211573,27095555163,174857766736
2016-01-09,All-Floors,Alumni,53,706,952560,131603071583,27614706427,159217778010
2016-01-09,All-Floors,Others(HKUST),16,316,1099455,77535039024,6750877852,84285916876
2016-01-09,All-Floors,Non-HKUST,37,342,522800,35119443523,1729825198,36849268721
2016-01-09,All-Floors,Total,970,11174,13399548,1005740183718,144114914965,1149855098683
2016-01-10,1,Staff,12,89,263164,163867921,329473765,493341686
2016-01-10,1,TPG,12,130,131232,21884036391,1573958689,23457995080
2016-01-10,1,RPG,19,107,150420,7764858395,1012118193,8776976588
2016-01-10,1,UG,17,104,141052,37579959330,1008873117,38588832447
2016-01-10,1,Alumni,5,12,10419,219892084,18126669,238018753
2016-01-10,1,Others(HKUST),3,39,71977,3612898,1413198,5026096
2016-01-10,1,Non-HKUST,4,21,24366,8630939382,417949956,9048889338
2016-01-10,1,Total,72,502,792630,76247166401,4361913587,80609079988
2016-01-10,G,Staff,23,106,106431,307921236,219175457,527096693
2016-01-10,G,TPG,53,332,371363,40556496679,3750480722,44306977401
2016-01-10,G,RPG,66,236,160784,3974817429,726167736,4700985165
2016-01-10,G,UG,54,211,147601,6528071024,1880586525,8408657549
2016-01-10,G,Alumni,16,42,61810,11016192872,1356329290,12372522162
2016-01-10,G,Others(HKUST),7,18,96088,332161787,101381585,433543372
2016-01-10,G,Non-HKUST,17,55,17780,432571899,22921632,455493531
2016-01-10,G,Total,236,1000,961857,63148232926,8057042947,71205275873
2016-01-10,LG1,Staff,27,158,119728,7204520197,727649973,7932170170
2016-01-10,LG1,TPG,53,384,340086,151820318597,6546727495,158367046092
2016-01-10,LG1,RPG,60,492,462815,32140176809,2870961451,35011138260
2016-01-10,LG1,UG,81,585,621706,50069167570,6297123714,56366291284
2016-01-10,LG1,Alumni,9,65,62581,5625539659,1182240001,6807779660
2016-01-10,LG1,Others(HKUST),5,67,466613,1432047393,939118691,2371166084
2016-01-10,LG1,Non-HKUST,18,71,58858,4817426768,378271240,5195698008
2016-01-10,LG1,Total,253,1822,2132387,253109196993,18942092565,272051289558
2016-01-10,LG3,Staff,27,73,101276,1837683248,159880399,1997563647
2016-01-10,LG3,TPG,32,147,204951,22458143931,1118554309,23576698240
2016-01-10,LG3,RPG,52,175,170907,4646220470,581198396,5227418866
2016-01-10,LG3,UG,87,227,251814,12998393108,5163817995,18162211103
2016-01-10,LG3,Alumni,11,41,31688,531255169,106949619,638204788
2016-01-10,LG3,Others(HKUST),5,18,8287,452466776,33544590,486011366
2016-01-10,LG3,Non-HKUST,11,88,113092,6771367725,855732692,7627100417
2016-01-10,LG3,Total,225,769,882015,49695530427,8019678000,57715208427
2016-01-10,LG4,Staff,31,67,41086,449771345,62496061,512267406
2016-01-10,LG4,TPG,28,184,177754,29683483997,1705080519,31388564516
2016-01-10,LG4,RPG,91,229,241400,14120556508,997060557,15117617065
2016-01-10,LG4,UG,97,223,160358,3834521877,217177960,4051699837
2016-01-10,LG4,Alumni,14,49,47294,2427484921,129919353,2557404274
2016-01-10,LG4,Others(HKUST),3,86,284771,35957184591,4922021565,40879206156
2016-01-10,LG4,Non-HKUST,12,35,32437,1572756256,95638854,1668395110
2016-01-10,LG4,Total,276,873,985100,88045759495,8129394869,96175154364
2016-01-10,All-Floors,Staff,73,493,631685,9963763947,1498675655,11462439602
2016-01-10,All-Floors,TPG,94,1177,1225386,266402479595,14694801734,281097281329
2016-01-10,All-Floors,RPG,193,1239,1186326,62646629611,6187506333,68834135944
2016-01-10,All-Floors,UG,236,1350,1322531,111010112909,14567579311,125577692220
2016-01-10,All-Floors,Alumni,31,209,213792,19820364705,2793564932,22613929637
2016-01-10,All-Floors,Others(HKUST),12,228,927736,38177473445,5997479629,44174953074
2016-01-10,All-Floors,Non-HKUST,33,270,246533,22225062030,1770514374,23995576404
2016-01-10,All-Floors,Total,672,4966,5753989,530245886242,47510121968,577756008210
2016-01-11,1,Staff,73,704,1234279,11005839467,1519599925,12525439392
2016-01-11,1,TPG,37,392,642716,61023972763,4314073700,65338046463
2016-01-11,1,RPG,42,316,355228,15852728418,14405732829,30258461247
2016-01-11,1,UG,48,431,578462,14496525004,1658069734,16154594738
2016-01-11,1,Alumni,3,35,54055,2167219743,145929299,2313149042
2016-01-11,1,Others(HKUST),3,60,77812,75856904,26088240,101945144
2016-01-11,1,Non-HKUST,3,36,36692,4263147542,273977513,4537125055
2016-01-11,1,Total,209,1974,2979244,108885289841,22343471240,131228761081
2016-01-11,G,Staff,134,811,793850,6234043530,1546681826,7780725356
2016-01-11,G,TPG,120,814,818737,33018650664,9863078458,42881729122
2016-01-11,G,RPG,151,681,490378,16160168700,6250502599,22410671299
2016-01-11,G,UG,208,859,646759,23240974846,1924119887,25165094733
2016-01-11,G,Alumni,6,17,6213,13639105,4565310,18204415
2016-01-11,G,Others(HKUST),9,42,156184,5556239339,741358202,6297597541
2016-01-11,G,Non-HKUST,14,102,54415,1389733851,80325846,1470059697
2016-01-11,G,Total,642,3326,2966536,85613450035,20410632128,106024082163
2016-01-11,LG1,Staff,107,557,412451,8755706218,2024259679,10779965897
2016-01-11,LG1,TPG,123,1722,1524945,99226446778,11581256647,110807703425
2016-01-11,LG1,RPG,135,1342,1183960,52496394901,19183971297,71680366198
2016-01-11,LG1,UG,256,2497,2772502,138865904611,10762769745,149628674356
2016-01-11,LG1,Alumni,3,37,44873,99220770,11859349,111080119
2016-01-11,LG1,Others(HKUST),9,38,431759,1239621423,868824729,2108446152
2016-01-11,LG1,Non-HKUST,21,124,140527,1804850115,23390899711,25195749826
2016-01-11,LG1,Total,654,6317,6511017,302488144816,67823841157,370311985973
2016-01-11,LG3,Staff,86,398,336578,19334983316,1311563906,20646547222
2016-01-11,LG3,TPG,61,393,428298,21403212138,3384145967,24787358105
2016-01-11,LG3,RPG,88,554,705843,31118225323,2251133978,33369359301
2016-01-11,LG3,UG,145,442,310485,17580473026,1493250606,19073723632
2016-01-11,LG3,Alumni,3,42,34532,3075960365,103301103,3179261468
2016-01-11,LG3,Others(HKUST),7,19,7535,905624149,37703163,943327312
2016-01-11,LG3,Non-HKUST,9,35,30551,490006849,1023620220,1513627069
2016-01-11,LG3,Total,399,1883,1853822,93908485166,9604718943,103513204109
2016-01-11,LG4,Staff,114,489,290170,13334760041,696879714,14031639755
2016-01-11,LG4,TPG,56,449,571837,37768054516,3630053663,41398108179
2016-01-11,LG4,RPG,166,784,741543,20163729639,25607860007,45771589646
2016-01-11,LG4,UG,202,527,362103,14113966478,980228923,15094195401
2016-01-11,LG4,Alumni,8,47,85512,2603779321,231034725,2834814046
2016-01-11,LG4,Others(HKUST),10,144,241294,13942229593,695234233,14637463826
2016-01-11,LG4,Non-HKUST,12,55,55010,2678757996,7459296243,10138054239
2016-01-11,LG4,Total,568,2495,2347469,104605277584,39300587508,143905865092
2016-01-11,All-Floors,Staff,300,2959,3067328,58665332572,7098985050,65764317622
2016-01-11,All-Floors,TPG,200,3770,3986533,252440336859,32772608435,285212945294
2016-01-11,All-Floors,RPG,354,3677,3476952,135791246981,67699200710,203490447691
2016-01-11,All-Floors,UG,563,4756,4670311,208297843965,16818438895,225116282860
2016-01-11,All-Floors,Alumni,14,178,225185,7959819304,496689786,8456509090
2016-01-11,All-Floors,Others(HKUST),18,303,914584,21719571408,2369208567,24088779975
2016-01-11,All-Floors,Non-HKUST,39,352,317195,10626496353,32228119533,42854615886
2016-01-11,All-Floors,Total,1488,15995,16658088,695500647442,159483250976,854983898418
2016-01-12,1,Staff,79,836,1370765,26609465639,2298448883,28907914522
2016-01-12,1,TPG,30,267,328559,20667268029,1171698013,21838966042
2016-01-12,1,RPG,59,387,533191,14309423064,2244641603,16554064667
2016-01-12,1,UG,56,497,735244,42379070811,2746115359,45125186170
2016-01-12,1,Alumni,4,35,54064,2532249445,156707814,2688957259
2016-01-12,1,Others(HKUST),4,64,113201,568822357,404229901,973052258
2016-01-12,1,Non-HKUST,4,44,45344,15760294207,222469120,15982763327
2016-01-12,1,Total,236,2130,3180368,122826593552,9244310693,132070904245
2016-01-12,G,Staff,137,907,883521,7829787366,1966369580,9796156946
2016-01-12,G,TPG,108,698,624236,29894369288,5285021759,35179391047
2016-01-12,G,RPG,132,640,756012,28372709528,6103665894,34476375422
2016-01-12,G,UG,223,927,613677,34746401419,3006717070,37753118489
2016-01-12,G,Alumni,7,20,12943,505919079,53034230,558953309
2016-01-12,G,Others(HKUST),11,53,155426,6379295892,493663863,6872959755
2016-01-12,G,Non-HKUST,10,40,42775,1514905611,120604658,1635510269
2016-01-12,G,Total,628,3285,3088590,109243388183,17029077054,126272465237
2016-01-12,LG1,Staff,112,625,612608,12234634806,1782735467,14017370273
2016-01-12,LG1,TPG,119,1513,1545636,102946033906,8795250811,111741284717
2016-01-12,LG1,RPG,164,1566,1715884,128963814174,8285845326,137249659500
2016-01-12,LG1,UG,258,2120,2674717,122390817327,9664232323,132055049650
2016-01-12,LG1,Alumni,7,24,27283,425282207,41349414,466631621
2016-01-12,LG1,Others(HKUST),9,62,452076,2485438293,1360299624,3845737917
2016-01-12,LG1,Non-HKUST,5,40,9625,994475168,259056432,1253531600
2016-01-12,LG1,Total,674,5950,7037829,370440495881,30188769397,400629265278
2016-01-12,LG3,Staff,92,415,232586,3402168357,299842818,3702011175
2016-01-12,LG3,TPG,65,524,532584,38512960694,2919685879,41432646573
2016-01-12,LG3,RPG,108,485,594216,23129340268,2629764197,25759104465
2016-01-12,LG3,UG,156,667,592067,39644818904,9906559421,49551378325
2016-01-12,LG3,Alumni,5,9,15159,411418877,70033734,481452611
2016-01-12,LG3,Others(HKUST),9,32,27448,63023502,6989693,70013195
2016-01-12,LG3,Non-HKUST,5,19,35336,427748807,381932077,809680884
2016-01-12,LG3,Total,440,2151,2029396,105591479409,16214807819,121806287228
2016-01-12,LG4,Staff,115,424,212260,23266576428,37482247485,60748823913
2016-01-12,LG4,TPG,72,512,610060,51531292862,3700446448,55231739310
2016-01-12,LG4,RPG,155,871,793673,25562651903,7201426421,32764078324
2016-01-12,LG4,UG,210,606,476841,17282646228,1559647323,18842293551
2016-01-12,LG4,Alumni,6,42,54832,2336289852,206033203,2542323055
2016-01-12,LG4,Others(HKUST),7,149,205406,24849469769,1350816849,26200286618
2016-01-12,LG4,Non-HKUST,7,62,51655,299656326,68491378,368147704
2016-01-12,LG4,Total,572,2666,2404727,145128583368,51569109107,196697692475
2016-01-12,All-Floors,Staff,311,3207,3311740,73342632596,43829644233,117172276829
2016-01-12,All-Floors,TPG,200,3514,3641075,243551924779,21872102910,265424027689
2016-01-12,All-Floors,RPG,374,3949,4392976,220337938937,26465343441,246803282378
2016-01-12,All-Floors,UG,596,4817,5092546,256443754689,26883271496,283327026185
2016-01-12,All-Floors,Alumni,18,130,164281,6211159460,527158395,6738317855
2016-01-12,All-Floors,Others(HKUST),25,360,953557,34346049813,3615999930,37962049743
2016-01-12,All-Floors,Non-HKUST,18,205,184735,18997080119,1052553665,20049633784
2016-01-12,All-Floors,Total,1542,16182,17740910,853230540393,124246074070,977476614463
2016-01-13,1,Staff,67,808,1244961,9379674239,1949748926,11329423165
2016-01-13,1,TPG,27,308,472790,46159797126,3182004063,49341801189
2016-01-13,1,RPG,39,422,446386,8972219268,3150884207,12123103475
2016-01-13,1,UG,56,387,550215,19729773732,2127410302,21857184034
2016-01-13,1,Alumni,1,37,50378,1666597491,166560282,1833157773
2016-01-13,1,Others(HKUST),4,45,71781,262469477,9092618,271562095
2016-01-13,1,Non-HKUST,9,88,80228,11169556404,641652265,11811208669
2016-01-13,1,Total,203,2095,2916739,97340087737,11227352663,108567440400
2016-01-13,G,Staff,144,912,908624,23381970544,2311518768,25693489312
2016-01-13,G,TPG,116,728,704547,28069448297,3658112626,31727560923
2016-01-13,G,RPG,118,700,805783,40626136930,2753404311,43379541241
2016-01-13,G,UG,197,982,709020,24296564019,9732365619,34028929638
2016-01-13,G,Alumni,5,27,5604,35604434,11202083,46806517
2016-01-13,G,Others(HKUST),11,113,191084,13548358294,1441579226,14989937520
2016-01-13,G,Non-HKUST,15,46,53681,1681604965,133801952,1815406917
2016-01-13,G,Total,606,3508,3378343,131639687483,20041984585,151681672068
2016-01-13,LG1,Staff,127,776,681685,21901678822,1753303754,23654982576
2016-01-13,LG1,TPG,121,1554,1358350,192552876438,29570959116,222123835554
2016-01-13,LG1,RPG,149,1495,1470483,167004421420,28886931326,195891352746
2016-01-13,LG1,UG,247,2570,2655553,173210150434,17567176994,190777327428
2016-01-13,LG1,Alumni,6,37,53370,247883820,60943407,308827227
2016-01-13,LG1,Others(HKUST),7,101,474942,3457348628,1774386694,5231735322
2016-01-13,LG1,Non-HKUST,13,75,95244,7595897246,428467762,8024365008
2016-01-13,LG1,Total,670,6608,6789627,565970256808,80042169053,646012425861
2016-01-13,LG3,Staff,90,411,398007,38533377904,1417830900,39951208804
2016-01-13,LG3,TPG,69,636,901753,51544755409,4233649180,55778404589
2016-01-13,LG3,RPG,96,464,498479,25476837858,2664746526,28141584384
2016-01-13,LG3,UG,162,488,387701,14717794926,2234572975,16952367901
2016-01-13,LG3,Alumni,3,28,24489,982867512,819812006,1802679518
2016-01-13,LG3,Others(HKUST),6,15,9491,526198307,26447976,552646283
2016-01-13,LG3,Non-HKUST,6,26,53633,492145665,71677275,563822940
2016-01-13,LG3,Total,432,2068,2273553,132273977581,11468736838,143742714419
2016-01-13,LG4,Staff,138,487,276150,21960438601,907769941,22868208542
2016-01-13,LG4,TPG,60,454,620145,47920201495,5775302172,53695503667
2016-01-13,LG4,RPG,185,849,729336,35388372831,1955852238,37344225069
2016-01-13,LG4,UG,280,818,559723,13166948490,2073753098,15240701588
2016-01-13,LG4,Alumni,4,12,24982,3671402948,185411737,3856814685
2016-01-13,LG4,Others(HKUST),13,169,252555,30422316219,2984769498,33407085717
2016-01-13,LG4,Non-HKUST,7,29,43200,1087665470,147108781,1234774251
2016-01-13,LG4,Total,687,2818,2506091,153617346054,14029967465,167647313519
2016-01-13,All-Floors,Staff,340,3394,3509427,115157140110,8340172289,123497312399
2016-01-13,All-Floors,TPG,199,3680,4057585,366247078765,46420027157,412667105922
2016-01-13,All-Floors,RPG,362,3930,3950467,277467988307,39411818608,316879806915
2016-01-13,All-Floors,UG,644,5245,4862212,245121231601,33735278988,278856510589
2016-01-13,All-Floors,Alumni,10,141,158823,6604356205,1243929515,7848285720
2016-01-13,All-Floors,Others(HKUST),25,443,999853,48216690925,6236276012,54452966937
2016-01-13,All-Floors,Non-HKUST,29,264,325986,22026869750,1422708035,23449577785
2016-01-13,All-Floors,Total,1609,17097,17864353,1080841355663,136810210604,1217651566267
2016-01-14,1,Staff,85,914,1425253,16885906147,2316241532,19202147679
2016-01-14,1,TPG,32,209,286392,30278095066,2030033359,32308128425
2016-01-14,1,RPG,37,414,557100,29926947008,28396574091,58323521099
2016-01-14,1,UG,59,415,599858,32519502491,2021540180,34541042671
2016-01-14,1,Alumni,4,41,59913,4535861162,765327226,5301188388
2016-01-14,1,Others(HKUST),5,58,69712,26571213,9278727,35849940
2016-01-14,1,Non-HKUST,9,109,147981,13924555494,1981618416,15906173910
2016-01-14,1,Total,231,2160,3146209,128097438581,37520613531,165618052112
2016-01-14,G,Staff,123,785,732625,10025619547,942766192,10968385739
2016-01-14,G,TPG,129,871,766737,57837092167,6091952704,63929044871
2016-01-14,G,RPG,135,765,667597,28562375235,3816864754,32379239989
2016-01-14,G,UG,206,875,701003,38427660724,2895765826,41323426550
2016-01-14,G,Alumni,11,36,9754,849934319,10201576182,11051510501
2016-01-14,G,Others(HKUST),11,87,143624,11672933840,2125785611,13798719451
2016-01-14,G,Non-HKUST,14,36,23507,2479135104,165514829,2644649933
2016-01-14,G,Total,629,3455,3044847,149854750936,26240226098,176094977034
2016-01-14,LG1,Staff,92,595,437286,35102266347,2506914063,37609180410
2016-01-14,LG1,TPG,128,1488,1393746,84344995899,8264505797,92609501696
2016-01-14,LG1,RPG,136,1555,1375142,183412537176,33564257739,216976794915
2016-01-14,LG1,UG,252,2823,2689494,138629281187,14468642415,153097923602
2016-01-14,LG1,Alumni,6,32,57816,531474321,2336207932,2867682253
2016-01-14,LG1,Others(HKUST),10,148,480594,6094853678,2232820824,8327674502
2016-01-14,LG1,Non-HKUST,9,36,34344,768005947,189086562,957092509
2016-01-14,LG1,Total,633,6677,6468422,448883414555,63562435332,512445849887
2016-01-14,LG3,Staff,92,480,504416,14573209459,1089821918,15663031377
2016-01-14,LG3,TPG,67,701,737323,96956656526,13898538877,110855195403
2016-01-14,LG3,RPG,108,503,595411,35388124516,6213705677,41601830193
2016-01-14,LG3,UG,159,587,437114,28697508309,2353402566,31050910875
2016-01-14,LG3,Alumni,3,41,25245,8380803584,10837736242,19218539826
2016-01-14,LG3,Others(HKUST),5,16,9392,1492376376,62222348,1554598724
2016-01-14,LG3,Non-HKUST,10,26,14304,375721650,22175469,397897119
2016-01-14,LG3,Total,444,2354,2323205,185864400420,34477603097,220342003517
2016-01-14,LG4,Staff,135,446,190714,18103630619,776771452,18880402071
2016-01-14,LG4,TPG,76,427,367083,48475473456,5678081365,54153554821
2016-01-14,LG4,RPG,217,1205,939821,41771095676,15882435820,57653531496
2016-01-14,LG4,UG,233,851,728720,23482067928,2868952360,26351020288
2016-01-14,LG4,Alumni,6,72,62164,7036813040,71469029800,78505842840
2016-01-14,LG4,Others(HKUST),15,156,234909,16032774533,1134773573,17167548106
2016-01-14,LG4,Non-HKUST,17,156,183846,3437435164,226451534,3663886698
2016-01-14,LG4,Total,699,3313,2707257,158339290416,98036495904,256375786320
2016-01-14,All-Floors,Staff,313,3220,3290294,94690632119,7632515157,102323147276
2016-01-14,All-Floors,TPG,214,3696,3551281,317892313114,35963112102,353855425216
2016-01-14,All-Floors,RPG,391,4442,4135071,319061079611,87873838081,406934917692
2016-01-14,All-Floors,UG,592,5551,5156189,261756020639,24608303347,286364323986
2016-01-14,All-Floors,Alumni,16,222,214892,21334886426,95609877382,116944763808
2016-01-14,All-Floors,Others(HKUST),24,465,938231,35319509640,5564881083,40884390723
2016-01-14,All-Floors,Non-HKUST,31,363,403982,20984853359,2584846810,23569700169
2016-01-14,All-Floors,Total,1581,17959,17689940,1071039294908,259837373962,1330876668870
2016-01-15,1,Staff,83,856,1086958,10827239326,1424432460,12251671786
2016-01-15,1,TPG,27,206,455587,33723407510,2392664687,36116072197
2016-01-15,1,RPG,42,382,645679,16057420653,1746873161,17804293814
2016-01-15,1,UG,36,392,589686,24083539558,6373223386,30456762944
2016-01-15,1,Alumni,4,25,95273,2398243364,205103047,2603346411
2016-01-15,1,Others(HKUST),3,76,77606,409708510,48484173,458192683
2016-01-15,1,Non-HKUST,4,58,40077,342154009,336696495,678850504
2016-01-15,1,Total,199,1995,2990866,87841712930,12527477409,100369190339
2016-01-15,G,Staff,135,894,770980,9891461844,1872783256,11764245100
2016-01-15,G,TPG,110,630,672004,27883933365,2656640638,30540574003
2016-01-15,G,RPG,132,573,466201,18260772658,2745484041,21006256699
2016-01-15,G,UG,190,869,682290,45093929452,5702025087,50795954539
2016-01-15,G,Alumni,5,11,2287,313624422,35613920,349238342
2016-01-15,G,Others(HKUST),11,33,135228,2425018131,277986149,2703004280
2016-01-15,G,Non-HKUST,11,53,51246,2231589304,389295141,2620884445
2016-01-15,G,Total,594,3063,2780236,106100329176,13679828232,119780157408
2016-01-15,LG1,Staff,99,572,468441,10745748398,1090126093,11835874491
2016-01-15,LG1,TPG,105,1316,1160910,85737525047,11381255615,97118780662
2016-01-15,LG1,RPG,146,1408,1315532,62660362048,26568681688,89229043736
2016-01-15,LG1,UG,257,2801,2670467,132101547241,16653283241,148754830482
2016-01-15,LG1,Alumni,4,45,65713,24746699,7397447,32144146
2016-01-15,LG1,Others(HKUST),7,58,447698,1786785940,1136579082,2923365022
2016-01-15,LG1,Non-HKUST,10,30,40166,4653199803,242888636,4896088439
2016-01-15,LG1,Total,628,6230,6168927,297709915176,57080211802,354790126978
2016-01-15,LG3,Staff,110,378,280031,5358822409,602157927,5960980336
2016-01-15,LG3,TPG,55,371,488648,38427851893,3371079831,41798931724
2016-01-15,LG3,RPG,101,535,550294,30766192199,3877565482,34643757681
2016-01-15,LG3,UG,150,529,380627,15656915360,1503700132,17160615492
2016-01-15,LG3,Alumni,4,15,21499,805862139,82984023,888846162
2016-01-15,LG3,Others(HKUST),6,37,38025,1619550716,114983353,1734534069
2016-01-15,LG3,Non-HKUST,6,43,80407,1766730296,233745906,2000476202
2016-01-15,LG3,Total,432,1908,1839531,94401925012,9786216654,104188141666
2016-01-15,LG4,Staff,137,373,127122,3664275398,309740604,3974016002
2016-01-15,LG4,TPG,58,365,410173,52514135102,3083886287,55598021389
2016-01-15,LG4,RPG,204,769,805422,126583244644,4828108893,131411353537
2016-01-15,LG4,UG,249,768,512090,18824399315,2564647442,21389046757
2016-01-15,LG4,Alumni,3,19,32039,396959043,116209146,513168189
2016-01-15,LG4,Others(HKUST),12,180,253167,12136213428,1424273568,13560486996
2016-01-15,LG4,Non-HKUST,8,36,21061,143489682,29728233,173217915
2016-01-15,LG4,Total,671,2510,2161074,214262716612,12356594173,226619310785
2016-01-15,All-Floors,Staff,330,3073,2733532,40487547375,5299240340,45786787715
2016-01-15,All-Floors,TPG,180,2888,3187322,238286852917,22885527058,261172379975
2016-01-15,All-Floors,RPG,380,3667,3783128,254327992202,39766713265,294094705467
2016-01-15,All-Floors,UG,575,5359,4835160,235760330926,32796879288,268557210214
2016-01-15,All-Floors,Alumni,11,115,216811,3939435667,447307583,4386743250
2016-01-15,All-Floors,Others(HKUST),24,384,951724,18377276725,3002306325,21379583050
2016-01-15,All-Floors,Non-HKUST,24,220,232957,9137163094,1232354411,10369517505
2016-01-15,All-Floors,Total,1524,15706,15940634,800316598906,105430328270,905746927176
2016-01-16,1,Staff,17,161,229158,7843263438,272839916,8116103354
2016-01-16,1,TPG,22,97,173938,19769568876,1874672999,21644241875
2016-01-16,1,RPG,31,242,343520,14858245434,8192148388,23050393822
2016-01-16,1,UG,23,166,342979,12292589672,907326340,13199916012
2016-01-16,1,Alumni,2,13,30568,3157472980,190070064,3347543044
2016-01-16,1,Others(HKUST),2,43,78335,57222867,31221251,88444118
2016-01-16,1,Non-HKUST,6,26,31658,6156432425,190345217,6346777642
2016-01-16,1,Total,103,748,1230156,64134795692,11658624175,75793419867
2016-01-16,G,Staff,52,298,310801,16892431555,884021652,17776453207
2016-01-16,G,TPG,89,513,558607,67124554984,4952595737,72077150721
2016-01-16,G,RPG,85,353,338838,21125288503,1277710692,22402999195
2016-01-16,G,UG,109,444,282128,11243341474,833109633,12076451107
2016-01-16,G,Alumni,19,66,80773,9109418762,423668335,9533087097
2016-01-16,G,Others(HKUST),9,38,157993,1419342077,438398759,1857740836
2016-01-16,G,Non-HKUST,18,86,124234,2448455879,257222517,2705678396
2016-01-16,G,Total,381,1798,1853374,129362833234,9066727325,138429560559
2016-01-16,LG1,Staff,34,281,227639,35413943983,1386115977,36800059960
2016-01-16,LG1,TPG,96,1182,1226333,145227212848,19395090749,164622303597
2016-01-16,LG1,RPG,115,889,983956,77269963856,6982085847,84252049703
2016-01-16,LG1,UG,170,1608,2263823,104522409894,8925797301,113448207195
2016-01-16,LG1,Alumni,19,141,163321,15710687841,4123012348,19833700189
2016-01-16,LG1,Others(HKUST),5,30,436438,479461916,344459060,823920976
2016-01-16,LG1,Non-HKUST,17,87,137441,17421203099,704450128,18125653227
2016-01-16,LG1,Total,456,4218,5438951,396044883437,41861011410,437905894847
2016-01-16,LG3,Staff,33,111,151931,3695128784,2471400030,6166528814
2016-01-16,LG3,TPG,56,380,504533,42361256209,3775164502,46136420711
2016-01-16,LG3,RPG,69,331,376506,15369006083,1687971672,17056977755
2016-01-16,LG3,UG,107,343,341814,17106453823,1290030514,18396484337
2016-01-16,LG3,Alumni,16,127,162198,6492538726,1061116564,7553655290
2016-01-16,LG3,Others(HKUST),6,9,25835,421547256,56416810,477964066
2016-01-16,LG3,Non-HKUST,8,40,70136,7358560429,315847012,7674407441
2016-01-16,LG3,Total,295,1341,1632953,92804491310,10657947104,103462438414
2016-01-16,LG4,Staff,41,87,43251,3531333109,110790591,3642123700
2016-01-16,LG4,TPG,57,409,468912,42501153568,4006594644,46507748212
2016-01-16,LG4,RPG,122,469,505985,35581972424,1855123933,37437096357
2016-01-16,LG4,UG,170,541,418219,16309940038,1865464265,18175404303
2016-01-16,LG4,Alumni,20,170,274006,36172552558,1281964197,37454516755
2016-01-16,LG4,Others(HKUST),5,201,310252,21860133741,1264955070,23125088811
2016-01-16,LG4,Non-HKUST,10,102,115223,3904432466,570925298,4475357764
2016-01-16,LG4,Total,425,1979,2135848,159861517904,10955817998,170817335902
2016-01-16,All-Floors,Staff,114,938,962780,67376100869,5125168166,72501269035
2016-01-16,All-Floors,TPG,154,2581,2932323,316983746485,34004118631,350987865116
2016-01-16,All-Floors,RPG,233,2284,2548805,164204476300,19995040532,184199516832
2016-01-16,All-Floors,UG,376,3102,3648963,161474734901,13821728053,175296462954
2016-01-16,All-Floors,Alumni,41,517,710866,70642670867,7079831508,77722502375
2016-01-16,All-Floors,Others(HKUST),14,321,1008853,24237707857,2135450950,26373158807
2016-01-16,All-Floors,Non-HKUST,35,341,478692,37289084298,2038790172,39327874470
2016-01-16,All-Floors,Total,967,10084,12291282,842208521577,84200128012,926408649589
2016-01-17,1,Staff,7,60,69915,28352892,4361665,32714557
2016-01-17,1,TPG,16,130,174561,7801307336,4503114546,12304421882
2016-01-17,1,RPG,16,51,59994,1448671489,1031511552,2480183041
2016-01-17,1,UG,16,28,42111,1526544313,94617658,1621161971
2016-01-17,1,Alumni,4,8,4085,36388656,46680213,83068869
2016-01-17,1,Others(HKUST),1,37,68908,2951528,1146446,4097974
2016-01-17,1,Non-HKUST,3,5,9457,1496714995,50504767,1547219762
2016-01-17,1,Total,63,319,429031,12340931209,5731936847,18072868056
2016-01-17,G,Staff,24,106,92839,906183800,92113865,998297665
2016-01-17,G,TPG,57,293,318768,32033698508,2028024378,34061722886
2016-01-17,G,RPG,51,174,165296,7268755061,1100906511,8369661572
2016-01-17,G,UG,74,204,193045,11028617103,754637213,11783254316
2016-01-17,G,Alumni,12,49,45565,2816815540,197307937,3014123477
2016-01-17,G,Others(HKUST),3,8,88069,275550563,72771467,348322030
2016-01-17,G,Non-HKUST,9,25,11637,105870854,23609612,129480466
2016-01-17,G,Total,230,859,915219,54435491429,4269370983,58704862412
2016-01-17,LG1,Staff,23,132,98822,4136609608,246995127,4383604735
2016-01-17,LG1,TPG,57,418,413475,27573584808,21727004802,49300589610
2016-01-17,LG1,RPG,59,448,424078,20420823948,4369357011,24790180959
2016-01-17,LG1,UG,118,938,1110882,38331514628,2485538400,40817053028
2016-01-17,LG1,Alumni,13,222,143092,13292623132,1552506192,14845129324
2016-01-17,LG1,Others(HKUST),4,38,441921,1405582068,1099835067,2505417135
2016-01-17,LG1,Non-HKUST,8,53,29623,11098506808,431271807,11529778615
2016-01-17,LG1,Total,282,2249,2661893,116259245000,31912508406,148171753406
2016-01-17,LG3,Staff,25,87,84341,9631955559,3491020836,13122976395
2016-01-17,LG3,TPG,42,162,235706,25741957963,3231450122,28973408085
2016-01-17,LG3,RPG,47,168,153070,13283429805,2209407425,15492837230
2016-01-17,LG3,UG,79,135,71584,7688418418,723761930,8412180348
2016-01-17,LG3,Alumni,11,48,55396,3854120116,774928082,4629048198
2016-01-17,LG3,Others(HKUST),4,11,5530,246818158,28625245,275443403
2016-01-17,LG3,Non-HKUST,6,30,41038,916489291,88053370,1004542661
2016-01-17,LG3,Total,214,641,646665,61363189310,10547247010,71910436320
2016-01-17,LG4,Staff,29,77,36936,2460110750,134283947,2594394697
2016-01-17,LG4,TPG,50,210,259912,38040258778,3170077797,41210336575
2016-01-17,LG4,RPG,113,271,234220,6618357789,888527420,7506885209
2016-01-17,LG4,UG,162,387,219338,10560309698,1072017950,11632327648
2016-01-17,LG4,Alumni,12,48,31331,461796448,38150609,499947057
2016-01-17,LG4,Others(HKUST),3,74,255810,23935125929,5494748325,29429874254
2016-01-17,LG4,Non-HKUST,7,27,19544,166806718,45243769,212050487
2016-01-17,LG4,Total,376,1094,1057091,82242766110,10843049817,93085815927
2016-01-17,All-Floors,Staff,71,462,382853,17163212609,3968775440,21131988049
2016-01-17,All-Floors,TPG,112,1213,1402422,131190807393,34659671645,165850479038
2016-01-17,All-Floors,RPG,192,1112,1036658,49040038092,9599709919,58639748011
2016-01-17,All-Floors,UG,309,1692,1636960,69135404160,5130573151,74265977311
2016-01-17,All-Floors,Alumni,29,375,279469,20461743892,2609573033,23071316925
2016-01-17,All-Floors,Others(HKUST),7,168,860238,25866028246,6697126550,32563154796
2016-01-17,All-Floors,Non-HKUST,20,140,111299,13784388666,638683325,14423071991
2016-01-17,All-Floors,Total,740,5162,5709899,326641623058,63304113063,389945736121
2016-01-18,1,Staff,81,653,977981,10316783280,896359371,11213142651
2016-01-18,1,TPG,32,596,619427,108192214768,7355344502,115547559270
2016-01-18,1,RPG,41,431,539108,27842790596,58342839096,86185629692
2016-01-18,1,UG,60,528,622011,50760772336,10960094076,61720866412
2016-01-18,1,Alumni,3,12,15308,974943921,50346593,1025290514
2016-01-18,1,Others(HKUST),2,47,89774,37995882,312310534,350306416
2016-01-18,1,Non-HKUST,8,85,96545,2067108885,110832255,2177941140
2016-01-18,1,Total,227,2352,2960154,200192609668,78028126427,278220736095
2016-01-18,G,Staff,156,853,662933,8373256259,4902454668,13275710927
2016-01-18,G,TPG,120,846,594581,80731220857,4879216363,85610437220
2016-01-18,G,RPG,147,775,606110,32338818294,7666286189,40005104483
2016-01-18,G,UG,237,1060,862277,43095701974,9972088770,53067790744
2016-01-18,G,Alumni,8,84,93097,1658346298,112581527,1770927825
2016-01-18,G,Others(HKUST),12,39,143177,1526395806,625325596,2151721402
2016-01-18,G,Non-HKUST,23,73,27870,431943730,38674189,470617919
2016-01-18,G,Total,703,3730,2990045,168155683218,28196627302,196352310520
2016-01-18,LG1,Staff,103,513,424243,16306226250,968336767,17274563017
2016-01-18,LG1,TPG,131,1450,1297279,262346601620,28375693824,290722295444
2016-01-18,LG1,RPG,162,1603,1354291,183567224448,16867388992,200434613440
2016-01-18,LG1,UG,313,3545,3456950,116305998201,31883988810,148189987011
2016-01-18,LG1,Alumni,6,59,154892,2311670424,564382451,2876052875
2016-01-18,LG1,Others(HKUST),6,80,451978,3204063911,1894906836,5098970747
2016-01-18,LG1,Non-HKUST,17,58,30778,332460248,42044464,374504712
2016-01-18,LG1,Total,738,7308,7170411,584374245102,80596742144,664970987246
2016-01-18,LG3,Staff,97,409,328066,17339003472,7650093280,24989096752
2016-01-18,LG3,TPG,79,672,897464,80473065836,4660724911,85133790747
2016-01-18,LG3,RPG,97,483,564076,42763157223,3849588925,46612746148
2016-01-18,LG3,UG,176,589,395583,20031824242,2817976816,22849801058
2016-01-18,LG3,Alumni,2,19,28324,1515907029,260914178,1776821207
2016-01-18,LG3,Others(HKUST),2,17,12365,181258036,11570453,192828489
2016-01-18,LG3,Non-HKUST,13,48,77051,1942026237,81057693,2023083930
2016-01-18,LG3,Total,466,2237,2302929,164246242075,19331926256,183578168331
2016-01-18,LG4,Staff,159,720,400473,18805579043,930020109,19735599152
2016-01-18,LG4,TPG,80,785,752637,122667737254,23395089373,146062826627
2016-01-18,LG4,RPG,190,906,879222,56869847266,3212528117,60082375383
2016-01-18,LG4,UG,268,937,671849,42665767721,2913328143,45579095864
2016-01-18,LG4,Alumni,1,1,120,18900,8906,27806
2016-01-18,LG4,Others(HKUST),13,223,295081,26656759911,2075345280,28732105191
2016-01-18,LG4,Non-HKUST,24,334,386845,88177020,45559634,133736654
2016-01-18,LG4,Total,735,3906,3386227,267753887115,32571879562,300325766677
2016-01-18,All-Floors,Staff,343,3148,2793696,71140848304,15347264195,86488112499
2016-01-18,All-Floors,TPG,203,4349,4161388,654410840335,68666068973,723076909308
2016-01-18,All-Floors,RPG,387,4198,3942807,343381837827,89938631319,433320469146
2016-01-18,All-Floors,UG,659,6659,6008670,272860064474,58547476615,331407541089
2016-01-18,All-Floors,Alumni,8,175,291741,6460886572,988233655,7449120227
2016-01-18,All-Floors,Others(HKUST),24,406,992375,31606473546,4919458699,36525932245
2016-01-18,All-Floors,Non-HKUST,42,598,619089,4861716120,318168235,5179884355
2016-01-18,All-Floors,Total,1666,19533,18809766,1384722667178,238725301691,1623447968869
2016-01-19,1,Staff,90,1015,1268143,12817150405,1199228423,14016378828
2016-01-19,1,TPG,53,579,755213,57262324871,6778167166,64040492037
2016-01-19,1,RPG,51,392,609784,9485466118,1213964560,10699430678
2016-01-19,1,UG,48,457,655788,35355273062,2031104813,37386377875
2016-01-19,1,Alumni,4,17,19652,4371478718,146905521,4518384239
2016-01-19,1,Others(HKUST),3,56,81414,31889787,361455138,393344925
2016-01-19,1,Non-HKUST,8,28,40764,190222245,30203335,220425580
2016-01-19,1,Total,257,2544,3430758,119513805206,11761028956,131274834162
2016-01-19,G,Staff,146,857,570767,8170168876,895883413,9066052289
2016-01-19,G,TPG,157,930,854770,68033856805,9830950863,77864807668
2016-01-19,G,RPG,154,703,694101,13958934241,2194190743,16153124984
2016-01-19,G,UG,219,981,846146,49137745982,5656549071,54794295053
2016-01-19,G,Alumni,5,57,73035,709368117,61842094,771210211
2016-01-19,G,Others(HKUST),14,56,150392,8108936450,841891073,8950827523
2016-01-19,G,Non-HKUST,20,64,36816,417305954,82266597,499572551
2016-01-19,G,Total,715,3648,3226027,148536316425,19563573854,168099890279
2016-01-19,LG1,Staff,114,806,751704,21984200698,24095002977,46079203675
2016-01-19,LG1,TPG,134,1359,1338738,64960805994,25175991632,90136797626
2016-01-19,LG1,RPG,221,2443,2237342,93581686023,10883999631,104465685654
2016-01-19,LG1,UG,282,3184,3377275,162112780774,17690485738,179803266512
2016-01-19,LG1,Alumni,4,48,89071,1891581197,956698388,2848279585
2016-01-19,LG1,Others(HKUST),13,90,474763,8002195788,1108436369,9110632157
2016-01-19,LG1,Non-HKUST,21,147,121249,3977205279,3960773615,7937978894
2016-01-19,LG1,Total,789,8077,8390142,356510455753,83871388350,440381844103
2016-01-19,LG3,Staff,75,370,258996,12037475356,731309522,12768784878
2016-01-19,LG3,TPG,68,596,707480,41847352628,4305204445,46152557073
2016-01-19,LG3,RPG,134,733,894591,42231721461,2964300843,45196022304
2016-01-19,LG3,UG,180,628,392571,15087703418,1351777109,16439480527
2016-01-19,LG3,Alumni,5,39,29467,1920391196,19754590258,21674981454
2016-01-19,LG3,Others(HKUST),8,28,30367,224917695,19626128,244543823
2016-01-19,LG3,Non-HKUST,9,39,39760,452844373,1068989464,1521833837
2016-01-19,LG3,Total,479,2433,2353232,113802406127,30195797769,143998203896
2016-01-19,LG4,Staff,128,638,281775,8341822697,587547796,8929370493
2016-01-19,LG4,TPG,72,757,712250,82810168246,31989329636,114799497882
2016-01-19,LG4,RPG,184,1055,988628,54856351674,4242855556,59099207230
2016-01-19,LG4,UG,237,935,634789,30484488969,2830822717,33315311686
2016-01-19,LG4,Alumni,3,12,22920,574733278,114914919,689648197
2016-01-19,LG4,Others(HKUST),8,225,296124,10721909156,617761485,11339670641
2016-01-19,LG4,Non-HKUST,21,308,340290,1499932229,1940950400,3440882629
2016-01-19,LG4,Total,653,3930,3276776,189289406249,42324182509,231613588758
2016-01-19,All-Floors,Staff,317,3686,3131385,63350818032,27508972131,90859790163
2016-01-19,All-Floors,TPG,244,4221,4368451,314914508544,78079643742,392994152286
2016-01-19,All-Floors,RPG,444,5326,5424446,214114159517,21499311333,235613470850
2016-01-19,All-Floors,UG,643,6185,5906569,292177992205,29560739448,321738731653
2016-01-19,All-Floors,Alumni,11,173,234145,9467552506,21034951180,30502503686
2016-01-19,All-Floors,Others(HKUST),23,455,1033060,27089848876,2949170193,30039019069
2016-01-19,All-Floors,Non-HKUST,37,586,578879,6537510080,7083183411,13620693491
2016-01-19,All-Floors,Total,1719,20632,20676935,927652389760,187715971438,1115368361198
2016-01-20,1,Staff,79,722,984380,9231313873,3583829335,12815143208
2016-01-20,1,TPG,37,372,566599,53837941107,4448484647,58286425754
2016-01-20,1,RPG,44,295,513635,8111021274,788703156,8899724430
2016-01-20,1,UG,42,332,457430,12399292574,1807739172,14207031746
2016-01-20,1,Alumni,4,55,75734,3677128997,203814243,3880943240
2016-01-20,1,Others(HKUST),2,57,79738,110866564,38630500,149497064
2016-01-20,1,Non-HKUST,2,30,41951,571562637,86728897,658291534
2016-01-20,1,Total,210,1863,2719467,87939127026,10957929950,98897056976
2016-01-20,G,Staff,160,990,781532,9323123875,4210275237,13533399112
2016-01-20,G,TPG,115,656,613428,25394482775,11627023990,37021506765
2016-01-20,G,RPG,132,527,468520,25161556855,2750836501,27912393356
2016-01-20,G,UG,192,754,595694,29244006278,2322055649,31566061927
2016-01-20,G,Alumni,6,90,58532,2879111639,197301917,3076413556
2016-01-20,G,Others(HKUST),9,27,122942,539783994,135327681,675111675
2016-01-20,G,Non-HKUST,15,59,35247,550231911,52488707,602720618
2016-01-20,G,Total,629,3103,2675895,93092297327,21295309682,114387607009
2016-01-20,LG1,Staff,111,693,477057,8492967527,3667351336,12160318863
2016-01-20,LG1,TPG,124,1099,1097651,86972946895,19679171965,106652118860
2016-01-20,LG1,RPG,159,1503,1421100,93448190076,9813945328,103262135404
2016-01-20,LG1,UG,304,2982,3270864,145748185970,16493339962,162241525932
2016-01-20,LG1,Alumni,7,68,111459,4007449171,385669013,4393118184
2016-01-20,LG1,Others(HKUST),10,49,453905,256863869,172873985,429737854
2016-01-20,LG1,Non-HKUST,22,112,105281,6480198146,486479300,6966677446
2016-01-20,LG1,Total,737,6506,6937317,345406801654,50698830889,396105632543
2016-01-20,LG3,Staff,106,438,370745,20005251999,916275018,20921527017
2016-01-20,LG3,TPG,62,416,556482,46458224283,5422349989,51880574272
2016-01-20,LG3,RPG,105,731,965157,34588044085,4104414993,38692459078
2016-01-20,LG3,UG,172,557,313830,33038741157,1581643663,34620384820
2016-01-20,LG3,Alumni,4,13,5169,1680155,521617,2201772
2016-01-20,LG3,Others(HKUST),7,14,8999,19714138,1108998,20823136
2016-01-20,LG3,Non-HKUST,13,47,80660,1923005592,183339125,2106344717
2016-01-20,LG3,Total,469,2216,2301042,136034661409,12209653403,148244314812
2016-01-20,LG4,Staff,130,699,424892,34093283868,3646651273,37739935141
2016-01-20,LG4,TPG,80,925,990895,70476782735,9150008090,79626790825
2016-01-20,LG4,RPG,185,736,559443,35659047098,6950736857,42609783955
2016-01-20,LG4,UG,244,774,557461,19124635672,1390662728,20515298400
2016-01-20,LG4,Alumni,4,40,53060,734251353,143760779,878012132
2016-01-20,LG4,Others(HKUST),17,196,317572,7122275771,500681335,7622957106
2016-01-20,LG4,Non-HKUST,16,248,264012,913900143,153150348,1067050491
2016-01-20,LG4,Total,676,3618,3167335,168124176640,21935651410,190059828050
2016-01-20,All-Floors,Staff,344,3542,3038606,81145941142,16024382199,97170323341
2016-01-20,All-Floors,TPG,194,3468,3825055,283140377795,50327038681,333467416476
2016-01-20,All-Floors,RPG,371,3792,3927855,196967859388,24408636835,221376496223
2016-01-20,All-Floors,UG,650,5399,5195279,239554861651,23595441174,263150302825
2016-01-20,All-Floors,Alumni,11,266,303954,11299621315,931067569,12230688884
2016-01-20,All-Floors,Others(HKUST),26,343,983156,8049504336,848622499,8898126835
2016-01-20,All-Floors,Non-HKUST,35,496,527151,10438898429,962186377,11401084806
2016-01-20,All-Floors,Total,1631,17306,17801056,830597064056,117097375334,947694439390
2016-01-21,1,Staff,68,648,950427,26883328181,1272972920,28156301101
2016-01-21,1,TPG,31,277,354893,29968079924,2406146810,32374226734
2016-01-21,1,RPG,36,421,575694,19432028608,1460131881,20892160489
2016-01-21,1,UG,49,422,722032,27690781445,2700300344,30391081789
2016-01-21,1,Alumni,3,4,17445,556439290,50692777,607132067
2016-01-21,1,Others(HKUST),3,60,81573,281197902,18637065,299834967
2016-01-21,1,Non-HKUST,7,29,49639,948161197,74034297,1022195494
2016-01-21,1,Total,197,1861,2751703,105760016547,7982916094,113742932641
2016-01-21,G,Staff,149,822,746674,17027285222,1252471194,18279756416
2016-01-21,G,TPG,123,741,513690,52828891865,5165657438,57994549303
2016-01-21,G,RPG,135,694,569340,42316864712,4455546677,46772411389
2016-01-21,G,UG,200,798,535330,23962483510,2353684875,26316168385
2016-01-21,G,Alumni,6,57,61089,792916960,64945543,857862503
2016-01-21,G,Others(HKUST),9,24,129463,2563464215,419852416,2983316631
2016-01-21,G,Non-HKUST,22,69,51228,5947043669,337046651,6284090320
2016-01-21,G,Total,644,3205,2606814,145438950153,14049204794,159488154947
2016-01-21,LG1,Staff,122,760,532631,15695776194,1567472604,17263248798
2016-01-21,LG1,TPG,134,1662,1533732,121982568472,11211700000,133194268472
2016-01-21,LG1,RPG,131,1069,1181609,92200467784,19428805589,111629273373
2016-01-21,LG1,UG,268,2696,2806464,105677873285,8998936520,114676809805
2016-01-21,LG1,Alumni,4,30,72366,4394967784,199935676,4594903460
2016-01-21,LG1,Others(HKUST),9,73,480080,4449758153,1415344078,5865102231
2016-01-21,LG1,Non-HKUST,20,99,72543,8921392944,525982622,9447375566
2016-01-21,LG1,Total,688,6389,6679425,353322804616,43348177089,396670981705
2016-01-21,LG3,Staff,107,384,245990,12352537912,735712016,13088249928
2016-01-21,LG3,TPG,62,406,563293,55945543905,4184303891,60129847796
2016-01-21,LG3,RPG,85,450,543426,27168959318,2543745399,29712704717
2016-01-21,LG3,UG,199,582,425574,36729048047,2309294961,39038343008
2016-01-21,LG3,Alumni,5,51,39751,3497439074,10586342939,14083782013
2016-01-21,LG3,Others(HKUST),8,15,8912,15781634,3380973,19162607
2016-01-21,LG3,Non-HKUST,15,44,59175,1118294522,193826475,1312120997
2016-01-21,LG3,Total,481,1932,1886121,136827604412,20556606654,157384211066
2016-01-21,LG4,Staff,139,582,348582,15707176418,942033179,16649209597
2016-01-21,LG4,TPG,71,561,619100,57334388205,61307028330,118641416535
2016-01-21,LG4,RPG,167,708,717765,46547062037,4276320149,50823382186
2016-01-21,LG4,UG,233,762,592206,23935804854,1595486663,25531291517
2016-01-21,LG4,Alumni,3,11,41426,1038531645,417848803,1456380448
2016-01-21,LG4,Others(HKUST),15,192,238131,6980107648,591736753,7571844401
2016-01-21,LG4,Non-HKUST,28,346,373206,3787761949,468140111,4255902060
2016-01-21,LG4,Total,656,3162,2930416,155330832756,69598593988,224929426744
2016-01-21,All-Floors,Staff,331,3196,2824304,87666103927,5770661913,93436765840
2016-01-21,All-Floors,TPG,217,3647,3584708,318059472371,84274836469,402334308840
2016-01-21,All-Floors,RPG,338,3342,3587834,227665382459,32164549695,259829932154
2016-01-21,All-Floors,UG,643,5260,5081606,217995991141,17957703363,235953694504
2016-01-21,All-Floors,Alumni,10,153,232077,10280294753,11319765738,21600060491
2016-01-21,All-Floors,Others(HKUST),28,364,938159,14290309552,2448951285,16739260837
2016-01-21,All-Floors,Non-HKUST,42,587,605791,20722654281,1599030156,22321684437
2016-01-21,All-Floors,Total,1609,16549,16854479,896680208484,155535498619,1052215707103
2016-01-22,1,Staff,80,879,1145336,20038046922,1346260204,21384307126
2016-01-22,1,TPG,33,340,588940,47821064343,3106362344,50927426687
2016-01-22,1,RPG,31,247,329412,18692569180,1340817093,20033386273
2016-01-22,1,UG,50,450,634093,30347689660,2552471227,32900160887
2016-01-22,1,Alumni,5,45,50323,4046938166,230708498,4277646664
2016-01-22,1,Others(HKUST),4,54,91994,5299635838,625666836,5925302674
2016-01-22,1,Non-HKUST,7,24,33453,1275085496,58120315,1333205811
2016-01-22,1,Total,210,2039,2873551,127521029605,9260406517,136781436122
2016-01-22,G,Staff,144,763,636423,11507297553,1247096791,12754394344
2016-01-22,G,TPG,125,805,640628,43706903864,5119360061,48826263925
2016-01-22,G,RPG,146,668,574472,39340731795,7769885094,47110616889
2016-01-22,G,UG,199,891,672106,45976427994,4347607923,50324035917
2016-01-22,G,Alumni,8,85,79227,5563834483,274793056,5838627539
2016-01-22,G,Others(HKUST),10,43,122316,2377672649,745858957,3123531606
2016-01-22,G,Non-HKUST,25,75,29983,1663928854,400764256,2064693110
2016-01-22,G,Total,657,3330,2755155,150136797192,19905366138,170042163330
2016-01-22,LG1,Staff,105,485,413324,11649095975,1262170341,12911266316
2016-01-22,LG1,TPG,131,1716,1521005,191648877186,10192294857,201841172043
2016-01-22,LG1,RPG,146,1284,1393798,110798764652,20812815822,131611580474
2016-01-22,LG1,UG,279,2579,2823608,184850755532,11529896894,196380652426
2016-01-22,LG1,Alumni,5,49,33277,132925480,18134446,151059926
2016-01-22,LG1,Others(HKUST),10,65,497687,4516858763,615989078,5132847841
2016-01-22,LG1,Non-HKUST,13,49,35579,5399778330,91407551,5491185881
2016-01-22,LG1,Total,689,6227,6718278,508997055918,44522708989,553519764907
2016-01-22,LG3,Staff,96,364,287905,4838787262,443992956,5282780218
2016-01-22,LG3,TPG,63,605,656569,76339727558,11944649882,88284377440
2016-01-22,LG3,RPG,110,685,671561,29664677644,3941912538,33606590182
2016-01-22,LG3,UG,163,528,423728,23689814036,1508658390,25198472426
2016-01-22,LG3,Alumni,8,58,54544,2324244895,181175720,2505420615
2016-01-22,LG3,Others(HKUST),4,20,11804,7283869,3239255,10523124
2016-01-22,LG3,Non-HKUST,14,58,76815,8326900342,312602073,8639502415
2016-01-22,LG3,Total,458,2318,2182926,145191435606,18336230814,163527666420
2016-01-22,LG4,Staff,149,631,399195,8609323695,470148368,9079472063
2016-01-22,LG4,TPG,73,533,654649,76144557344,5518502079,81663059423
2016-01-22,LG4,RPG,162,725,633049,61051998503,9364112514,70416111017
2016-01-22,LG4,UG,248,811,653197,73939688986,10764077849,84703766835
2016-01-22,LG4,Alumni,6,38,44629,3746571786,392189464,4138761250
2016-01-22,LG4,Others(HKUST),10,277,363713,7586916658,846523192,8433439850
2016-01-22,LG4,Non-HKUST,21,407,447603,1838194940,206509698,2044704638
2016-01-22,LG4,Total,669,3422,3196035,232917251912,27562063164,260479315076
2016-01-22,All-Floors,Staff,343,3122,2882183,56642551407,4769668660,61412220067
2016-01-22,All-Floors,TPG,217,3999,4061791,435661130295,35881169223,471542299518
2016-01-22,All-Floors,RPG,352,3609,3602292,259548741774,43229543061,302778284835
2016-01-22,All-Floors,UG,623,5259,5206732,358804376208,30702712283,389507088491
2016-01-22,All-Floors,Alumni,14,275,262000,15814514810,1097001184,16911515994
2016-01-22,All-Floors,Others(HKUST),23,459,1087514,19788367777,2837277318,22625645095
2016-01-22,All-Floors,Non-HKUST,40,613,623433,18503887962,1069403893,19573291855
2016-01-22,All-Floors,Total,1612,17336,17725945,1164763570233,119586775622,1284350345855
2016-01-23,1,Staff,17,127,210769,3694032859,3713949788,7407982647
2016-01-23,1,TPG,34,408,578101,28995690520,11520631433,40516321953
2016-01-23,1,RPG,25,164,273220,11238271595,1514397469,12752669064
2016-01-23,1,UG,19,77,74650,11379623959,749547319,12129171278
2016-01-23,1,Alumni,5,28,58670,1520982694,112925462,1633908156
2016-01-23,1,Others(HKUST),3,48,52552,10693873,2085170,12779043
2016-01-23,1,Non-HKUST,3,26,17657,845185572,43478613,888664185
2016-01-23,1,Total,106,878,1265619,57684481072,17657015254,75341496326
2016-01-23,G,Staff,51,342,281583,8193828573,3349097566,11542926139
2016-01-23,G,TPG,126,689,718712,44540094160,7003001311,51543095471
2016-01-23,G,RPG,96,384,294285,14289294120,1330991008,15620285128
2016-01-23,G,UG,150,463,367491,25866334414,4335403852,30201738266
2016-01-23,G,Alumni,22,66,44260,8299003613,587236244,8886239857
2016-01-23,G,Others(HKUST),4,8,96679,391152909,110424829,501577738
2016-01-23,G,Non-HKUST,14,42,22269,563306002,40779302,604085304
2016-01-23,G,Total,463,1994,1825279,102143013791,16756934112,118899947903
2016-01-23,LG1,Staff,38,272,284850,32738933191,2556878007,35295811198
2016-01-23,LG1,TPG,121,1522,1569177,179931994733,10069854881,190001849614
2016-01-23,LG1,RPG,101,921,1003859,102486333623,16713236025,119199569648
2016-01-23,LG1,UG,205,2364,2687734,136646080724,14521715134,151167795858
2016-01-23,LG1,Alumni,18,99,106353,39755559306,8287813531,48043372837
2016-01-23,LG1,Others(HKUST),5,82,436443,10700372382,909457352,11609829734
2016-01-23,LG1,Non-HKUST,7,10,10924,618836578,39169438,658006016
2016-01-23,LG1,Total,495,5270,6099340,502878110537,53098124368,555976234905
2016-01-23,LG3,Staff,34,104,103461,21787386896,2186162488,23973549384
2016-01-23,LG3,TPG,65,466,655621,74939901369,9758285587,84698186956
2016-01-23,LG3,RPG,76,378,468223,46742797072,7466263136,54209060208
2016-01-23,LG3,UG,129,469,405780,25959626757,2559823291,28519450048
2016-01-23,LG3,Alumni,19,93,132755,32658496709,3298905510,35957402219
2016-01-23,LG3,Others(HKUST),3,7,3969,881780109,21762470,903542579
2016-01-23,LG3,Non-HKUST,7,42,79609,674902830,130321047,805223877
2016-01-23,LG3,Total,333,1559,1849418,203644891742,25421523529,229066415271
2016-01-23,LG4,Staff,46,115,80078,2101534989,362745857,2464280846
2016-01-23,LG4,TPG,68,773,1065500,56956334914,5649705755,62606040669
2016-01-23,LG4,RPG,85,576,698807,37350989898,6501078820,43852068718
2016-01-23,LG4,UG,143,489,390709,34174176256,1897291327,36071467583
2016-01-23,LG4,Alumni,18,242,343284,16026181381,1542901791,17569083172
2016-01-23,LG4,Others(HKUST),3,181,380840,25393646090,1880836246,27274482336
2016-01-23,LG4,Non-HKUST,10,82,101158,2269043655,177665334,2446708989
2016-01-23,LG4,Total,373,2458,3060376,174271907183,18012225130,192284132313
2016-01-23,All-Floors,Staff,115,960,960741,68515716508,12168833706,80684550214
2016-01-23,All-Floors,TPG,192,3858,4587111,385364015696,44001478967,429365494663
2016-01-23,All-Floors,RPG,224,2423,2738394,212107686308,33525966458,245633652766
2016-01-23,All-Floors,UG,425,3862,3926364,234025842110,24063780923,258089623033
2016-01-23,All-Floors,Alumni,37,528,685322,98260223703,13829782538,112090006241
2016-01-23,All-Floors,Others(HKUST),9,326,970483,37377645363,2924566067,40302211430
2016-01-23,All-Floors,Non-HKUST,23,202,231617,4971274637,431413734,5402688371
2016-01-23,All-Floors,Total,1025,12159,14100032,1040622404325,130945822393,1171568226718
2016-01-24,1,Staff,6,86,119864,10803458,4261270,15064728
2016-01-24,1,TPG,21,128,177607,21893333907,1002342352,22895676259
2016-01-24,1,RPG,21,57,128705,20921411328,887248951,21808660279
2016-01-24,1,UG,13,55,74252,1341867376,129128386,1470995762
2016-01-24,1,Alumni,4,12,12020,97692387,12421133,110113520
2016-01-24,1,Others(HKUST),1,44,47065,2432197,942784,3374981
2016-01-24,1,Non-HKUST,4,6,11286,251795512,22045986,273841498
2016-01-24,1,Total,70,388,570799,44519336165,2058390862,46577727027
2016-01-24,G,Staff,23,122,111487,2463172219,124186992,2587359211
2016-01-24,G,TPG,63,360,304490,23327545326,6436602199,29764147525
2016-01-24,G,RPG,59,195,166818,10226157267,517891713,10744048980
2016-01-24,G,UG,91,240,193199,5844768681,729422844,6574191525
2016-01-24,G,Alumni,17,60,43945,2217840473,203030686,2420871159
2016-01-24,G,Others(HKUST),3,10,88195,2949227553,468817432,3418044985
2016-01-24,G,Non-HKUST,8,25,28967,594280918,63221532,657502450
2016-01-24,G,Total,264,1012,937101,47622992437,8543173398,56166165835
2016-01-24,LG1,Staff,13,78,57983,8819331246,1530225667,10349556913
2016-01-24,LG1,TPG,75,751,750780,35909543448,3224698557,39134242005
2016-01-24,LG1,RPG,58,455,475260,14632878817,1777122359,16410001176
2016-01-24,LG1,UG,102,730,817556,32682989725,2082557962,34765547687
2016-01-24,LG1,Alumni,14,65,67436,1530461121,165459068,1695920189
2016-01-24,LG1,Others(HKUST),6,28,440667,3857253549,353034943,4210288492
2016-01-24,LG1,Non-HKUST,10,41,31154,1408508174,75170994,1483679168
2016-01-24,LG1,Total,278,2148,2640836,98840966080,9208269550,108049235630
2016-01-24,LG3,Staff,20,63,34688,290603620,30522063,321125683
2016-01-24,LG3,TPG,33,86,56643,5470701122,468769491,5939470613
2016-01-24,LG3,RPG,43,192,149173,19126242112,1030434554,20156676666
2016-01-24,LG3,UG,89,201,156760,12796532117,1133049206,13929581323
2016-01-24,LG3,Alumni,12,72,98312,4201525511,261797161,4463322672
2016-01-24,LG3,Others(HKUST),6,29,59926,2868604253,367037053,3235641306
2016-01-24,LG3,Non-HKUST,4,6,722,51201960,3360567,54562527
2016-01-24,LG3,Total,207,649,556224,44805410695,3294970095,48100380790
2016-01-24,LG4,Staff,22,60,29272,762620173,64851588,827471761
2016-01-24,LG4,TPG,43,314,333254,10655444435,1261024214,11916468649
2016-01-24,LG4,RPG,69,275,259490,13830187894,2338051294,16168239188
2016-01-24,LG4,UG,109,365,272708,3198442260,363122876,3561565136
2016-01-24,LG4,Alumni,12,108,109630,22945491804,1023311304,23968803108
2016-01-24,LG4,Others(HKUST),4,80,188606,19302617936,1028656301,20331274237
2016-01-24,LG4,Non-HKUST,4,49,28618,1999374823,156535767,2155910590
2016-01-24,LG4,Total,263,1251,1221578,72694179325,6235553344,78929732669
2016-01-24,All-Floors,Staff,60,409,353294,12346530716,1754047580,14100578296
2016-01-24,All-Floors,TPG,123,1639,1622774,97256568238,12393436813,109650005051
2016-01-24,All-Floors,RPG,148,1174,1179446,78736877418,6550748871,85287626289
2016-01-24,All-Floors,UG,278,1591,1514475,55864600159,4437281274,60301881433
2016-01-24,All-Floors,Alumni,31,317,331343,30993011296,1666019352,32659030648
2016-01-24,All-Floors,Others(HKUST),8,191,824459,28980135488,2218488513,31198624001
2016-01-24,All-Floors,Non-HKUST,20,127,100747,4305161387,320334846,4625496233
2016-01-24,All-Floors,Total,668,5448,5926538,308482884702,29340357249,337823241951
2016-01-25,1,Staff,79,833,1024157,14924768575,3090048295,18014816870
2016-01-25,1,TPG,46,639,846575,58536382294,13527810043,72064192337
2016-01-25,1,RPG,53,250,388240,14501482458,1565032018,16066514476
2016-01-25,1,UG,50,419,475739,15598927397,977857851,16576785248
2016-01-25,1,Alumni,4,24,32038,3876666853,1443313510,5319980363
2016-01-25,1,Others(HKUST),4,60,60277,414633375,94480520,509113895
2016-01-25,1,Non-HKUST,4,21,51943,825857405,107797124,933654529
2016-01-25,1,Total,240,2246,2878969,108678718357,20806339361,129485057718
2016-01-25,G,Staff,150,891,766615,10851759057,4311691468,15163450525
2016-01-25,G,TPG,134,864,803212,39479687208,6123989635,45603676843
2016-01-25,G,RPG,153,652,575378,17934719293,3654129809,21588849102
2016-01-25,G,UG,246,1282,981899,106178158511,5918486631,112096645142
2016-01-25,G,Alumni,7,99,84590,3873912714,519305557,4393218271
2016-01-25,G,Others(HKUST),5,24,140633,4726344496,568801418,5295145914
2016-01-25,G,Non-HKUST,11,87,92962,1499516966,327957409,1827474375
2016-01-25,G,Total,706,3899,3445289,184544098245,21424361927,205968460172
2016-01-25,LG1,Staff,120,698,532171,11564969563,4400652678,15965622241
2016-01-25,LG1,TPG,138,1876,1912015,134336883669,24601405404,158938289073
2016-01-25,LG1,RPG,141,1385,1406972,59421190150,18539546487,77960736637
2016-01-25,LG1,UG,335,3233,3348518,142499361613,11381909670,153881271283
2016-01-25,LG1,Alumni,6,17,17222,239389291,51823969,291213260
2016-01-25,LG1,Others(HKUST),10,54,475964,11385993708,1213989794,12599983502
2016-01-25,LG1,Non-HKUST,7,59,81776,6670973214,409238513,7080211727
2016-01-25,LG1,Total,757,7322,7774638,366118761208,60598566515,426717327723
2016-01-25,LG3,Staff,95,413,287755,25980288388,15754759299,41735047687
2016-01-25,LG3,TPG,68,477,662311,52758215852,6093361614,58851577466
2016-01-25,LG3,RPG,101,643,646844,47027329101,3269375442,50296704543
2016-01-25,LG3,UG,173,585,414422,17432967414,1440509253,18873476667
2016-01-25,LG3,Alumni,7,42,76997,1837197223,285455789,2122653012
2016-01-25,LG3,Others(HKUST),4,7,1796,582824,486757,1069581
2016-01-25,LG3,Non-HKUST,4,18,22265,464727943,132246272,596974215
2016-01-25,LG3,Total,452,2185,2112390,145501308745,26976194426,172477503171
2016-01-25,LG4,Staff,124,506,285939,20269577877,1026639207,21296217084
2016-01-25,LG4,TPG,74,883,1103119,50676826071,6314063326,56990889397
2016-01-25,LG4,RPG,151,650,612960,79751291573,4340185439,84091477012
2016-01-25,LG4,UG,242,872,645901,41109889713,7170242940,48280132653
2016-01-25,LG4,Alumni,6,50,56648,839057883,73755381,912813264
2016-01-25,LG4,Others(HKUST),5,117,155979,15628546057,2399375497,18027921554
2016-01-25,LG4,Non-HKUST,7,20,6983,85576945,2929351,88506296
2016-01-25,LG4,Total,609,3098,2867529,208360766119,21327191141,229687957260
2016-01-25,All-Floors,Staff,342,3341,2896637,83591363460,28583790947,112175154407
2016-01-25,All-Floors,TPG,218,4739,5327232,335787995094,56660630022,392448625116
2016-01-25,All-Floors,RPG,352,3580,3630394,218636012575,31368269195,250004281770
2016-01-25,All-Floors,UG,690,6391,5866479,322819304648,26889006345,349708310993
2016-01-25,All-Floors,Alumni,13,232,267495,10666223964,2373654206,13039878170
2016-01-25,All-Floors,Others(HKUST),18,262,834649,32156100460,4277133986,36433234446
2016-01-25,All-Floors,Non-HKUST,25,205,255929,9546652473,980168669,10526821142
2016-01-25,All-Floors,Total,1658,18750,19078815,1013203652674,151132653370,1164336306044
2016-01-26,1,Staff,85,1060,1284162,18672519382,1595293737,20267813119
2016-01-26,1,TPG,51,571,983369,82484812651,9772969291,92257781942
2016-01-26,1,RPG,31,275,404149,8656111407,1386641631,10042753038
2016-01-26,1,UG,68,451,407227,17795459712,1199731835,18995191547
2016-01-26,1,Alumni,4,6,7678,6741900070,410347586,7152247656
2016-01-26,1,Others(HKUST),8,62,79479,894503875,94922287,989426162
2016-01-26,1,Non-HKUST,9,34,54611,11506952213,378880571,11885832784
2016-01-26,1,Total,256,2459,3220675,146752259310,14838786938,161591046248
2016-01-26,G,Staff,150,872,778204,13125415687,2531462076,15656877763
2016-01-26,G,TPG,134,826,718065,54080798402,12726313659,66807112061
2016-01-26,G,RPG,149,653,499208,13533895494,1793791171,15327686665
2016-01-26,G,UG,267,1141,948291,42617053479,5014406141,47631459620
2016-01-26,G,Alumni,3,93,46887,3926028504,216063723,4142092227
2016-01-26,G,Others(HKUST),7,39,116197,4287238103,387004015,4674242118
2016-01-26,G,Non-HKUST,22,115,85647,6908319789,472980688,7381300477
2016-01-26,G,Total,732,3739,3192499,138478749458,23142021473,161620770931
2016-01-26,LG1,Staff,100,495,426911,6301720633,846005945,7147726578
2016-01-26,LG1,TPG,178,2073,1889203,156823429562,18711283180,175534712742
2016-01-26,LG1,RPG,155,1597,1342367,145093357649,44115497216,189208854865
2016-01-26,LG1,UG,331,3489,3812960,137868571224,16346953604,154215524828
2016-01-26,LG1,Alumni,4,50,50517,1936776865,745553328,2682330193
2016-01-26,LG1,Others(HKUST),7,56,443710,21174338990,1370776727,22545115717
2016-01-26,LG1,Non-HKUST,18,66,61557,3331716748,260488140,3592204888
2016-01-26,LG1,Total,793,7826,8027225,472529911671,82396558140,554926469811
2016-01-26,LG3,Staff,94,302,232753,16300597616,888914615,17189512231
2016-01-26,LG3,TPG,102,664,995790,70227207262,5818895752,76046103014
2016-01-26,LG3,RPG,103,583,591824,29630418443,6596250737,36226669180
2016-01-26,LG3,UG,238,702,461561,58631153880,3420762194,62051916074
2016-01-26,LG3,Alumni,3,5,10990,98958195,21436474,120394669
2016-01-26,LG3,Others(HKUST),6,10,21074,1153879500,60552034,1214431534
2016-01-26,LG3,Non-HKUST,12,20,5122,174194787,26404454,200599241
2016-01-26,LG3,Total,558,2286,2319114,176216409683,16833216260,193049625943
2016-01-26,LG4,Staff,125,452,213214,8885348276,904181654,9789529930
2016-01-26,LG4,TPG,92,1025,1364804,107192105547,24546520361,131738625908
2016-01-26,LG4,RPG,154,858,680462,65366260189,6944598863,72310859052
2016-01-26,LG4,UG,290,833,550814,22344529382,1597633872,23942163254
2016-01-26,LG4,Alumni,4,16,22608,227610354,30103068,257713422
2016-01-26,LG4,Others(HKUST),9,136,208439,14880285450,1600768227,16481053677
2016-01-26,LG4,Non-HKUST,11,94,95606,4109564176,443096745,4552660921
2016-01-26,LG4,Total,685,3414,3135947,223005703374,36066902790,259072606164
2016-01-26,All-Floors,Staff,348,3181,2935244,63285601594,6765858027,70051459621
2016-01-26,All-Floors,TPG,257,5159,5951231,470808353424,71575982243,542384335667
2016-01-26,All-Floors,RPG,356,3966,3518010,262280043182,60836779618,323116822800
2016-01-26,All-Floors,UG,780,6616,6180853,279256767677,27579487646,306836255323
2016-01-26,All-Floors,Alumni,9,170,138680,12931273988,1423504179,14354778167
2016-01-26,All-Floors,Others(HKUST),21,303,868899,42390245918,3514023290,45904269208
2016-01-26,All-Floors,Non-HKUST,39,329,302543,26030747713,1581850598,27612598311
2016-01-26,All-Floors,Total,1810,19724,19895460,1156983033496,173277485601,1330260519097
2016-01-27,1,Staff,87,998,1334077,11410178850,2109833660,13520012510
2016-01-27,1,TPG,62,649,1042950,61243304641,5547638973,66790943614
2016-01-27,1,RPG,49,552,577737,27185445606,3742650396,30928096002
2016-01-27,1,UG,56,357,420171,16741651705,1320201622,18061853327
2016-01-27,1,Alumni,4,33,88942,18148047681,485441550,18633489231
2016-01-27,1,Others(HKUST),7,58,90716,3150568508,160396410,3310964918
2016-01-27,1,Non-HKUST,5,13,37195,792796508,56850309,849646817
2016-01-27,1,Total,270,2660,3591788,138671993499,13423012920,152095006419
2016-01-27,G,Staff,148,928,815135,16708374576,2904299441,19612674017
2016-01-27,G,TPG,165,1220,1086376,117996298505,9804143870,127800442375
2016-01-27,G,RPG,142,644,446862,23224909802,3842347478,27067257280
2016-01-27,G,UG,282,1255,928667,33674495468,3427394581,37101890049
2016-01-27,G,Alumni,4,99,38437,6820599433,313730919,7134330352
2016-01-27,G,Others(HKUST),14,50,138459,13788819788,1468450651,15257270439
2016-01-27,G,Non-HKUST,17,74,40438,1126334962,303602793,1429937755
2016-01-27,G,Total,772,4270,3494374,213339832534,22063969733,235403802267
2016-01-27,LG1,Staff,105,553,398631,17073877133,1064086714,18137963847
2016-01-27,LG1,TPG,162,1813,1767944,231829529481,22937750486,254767279967
2016-01-27,LG1,RPG,136,1202,1052943,71938808078,8513100553,80451908631
2016-01-27,LG1,UG,419,4954,4687126,206417296798,30078953766,236496250564
2016-01-27,LG1,Alumni,2,10,2110,9079918,1798140,10878058
2016-01-27,LG1,Others(HKUST),9,97,427897,62212439566,4003191977,66215631543
2016-01-27,LG1,Non-HKUST,19,119,143243,4667925193,366906766,5034831959
2016-01-27,LG1,Total,852,8748,8479894,594148956167,66965788402,661114744569
2016-01-27,LG3,Staff,95,367,231481,17544547282,1268267414,18812814696
2016-01-27,LG3,TPG,80,597,812414,52112061277,3483644933,55595706210
2016-01-27,LG3,RPG,116,634,539035,26524439247,1803460005,28327899252
2016-01-27,LG3,UG,323,887,479741,14371726372,2995054868,17366781240
2016-01-27,LG3,Alumni,3,33,59761,2838401254,156368275,2994769529
2016-01-27,LG3,Others(HKUST),9,33,42967,2652587797,188866329,2841454126
2016-01-27,LG3,Non-HKUST,16,37,33469,143790225,86794743,230584968
2016-01-27,LG3,Total,642,2588,2198868,116187553454,9982456567,126170010021
2016-01-27,LG4,Staff,108,357,170905,8955085864,562489896,9517575760
2016-01-27,LG4,TPG,87,1088,1228056,158603667824,11925318498,170528986322
2016-01-27,LG4,RPG,206,811,791232,41779770199,6895944544,48675714743
2016-01-27,LG4,UG,375,1093,575950,20735553982,1953840309,22689394291
2016-01-27,LG4,Alumni,5,20,12993,722976159,118355748,841331907
2016-01-27,LG4,Others(HKUST),11,194,238852,13064735845,2964072545,16028808390
2016-01-27,LG4,Non-HKUST,19,74,74311,1211718631,158741358,1370459989
2016-01-27,LG4,Total,811,3637,3092299,245073508504,24578762898,269652271402
2016-01-27,All-Floors,Staff,320,3203,2950229,71692063705,7908977125,79601040830
2016-01-27,All-Floors,TPG,252,5367,5937740,621784861728,53698496760,675483358488
2016-01-27,All-Floors,RPG,380,3843,3407809,190653372932,24797502976,215450875908
2016-01-27,All-Floors,UG,915,8546,7091655,291940724325,39775445146,331716169471
2016-01-27,All-Floors,Alumni,11,195,202243,28539104445,1075694632,29614799077
2016-01-27,All-Floors,Others(HKUST),28,432,938891,94869151504,8784977912,103654129416
2016-01-27,All-Floors,Non-HKUST,49,317,328656,7942565519,972895969,8915461488
2016-01-27,All-Floors,Total,1955,21903,20857223,1307421844158,137013990520,1444435834678
2016-01-28,1,Staff,87,884,1290296,18395788380,2691389257,21087177637
2016-01-28,1,TPG,45,484,735232,63273260519,10288975975,73562236494
2016-01-28,1,RPG,53,375,532890,19515538515,8539749643,28055288158
2016-01-28,1,UG,56,296,394288,29306517963,1278827864,30585345827
2016-01-28,1,Alumni,4,19,35387,1830649385,161854021,1992503406
2016-01-28,1,Others(HKUST),3,50,59928,106520600,41431746,147952346
2016-01-28,1,Non-HKUST,4,30,33777,216244095,39860508,256104603
2016-01-28,1,Total,252,2138,3081798,132644519457,23042089014,155686608471
2016-01-28,G,Staff,156,1007,748236,17382846452,5485633027,22868479479
2016-01-28,G,TPG,144,1183,1025542,69762312118,12463117148,82225429266
2016-01-28,G,RPG,149,726,593667,25383883649,2225446513,27609330162
2016-01-28,G,UG,215,982,816466,40788771953,3450323830,44239095783
2016-01-28,G,Alumni,6,98,86129,1187987017,116609830,1304596847
2016-01-28,G,Others(HKUST),7,58,148932,9526582700,1214424613,10741007313
2016-01-28,G,Non-HKUST,14,39,39139,334939820,603999391,938939211
2016-01-28,G,Total,691,4093,3458111,164367323709,25559554352,189926878061
2016-01-28,LG1,Staff,113,699,469044,22603525422,1679972831,24283498253
2016-01-28,LG1,TPG,172,1896,1808922,213600466902,19008249669,232608716571
2016-01-28,LG1,RPG,158,1615,1558438,85057460131,17616892749,102674352880
2016-01-28,LG1,UG,315,3153,3690749,162112868189,18316173474,180429041663
2016-01-28,LG1,Alumni,6,43,81950,266819127,39997057,306816184
2016-01-28,LG1,Others(HKUST),11,108,452867,56918260964,4131076578,61049337542
2016-01-28,LG1,Non-HKUST,10,58,75825,5952832669,384584607,6337417276
2016-01-28,LG1,Total,785,7572,8137795,546512233404,61176946965,607689180369
2016-01-28,LG3,Staff,98,372,276025,20450898907,867897029,21318795936
2016-01-28,LG3,TPG,79,617,785658,66169141553,4818881359,70988022912
2016-01-28,LG3,RPG,104,752,609032,43828464591,9420071902,53248536493
2016-01-28,LG3,UG,257,672,522976,33341046888,2127034468,35468081356
2016-01-28,LG3,Alumni,4,32,71220,12223021,5496458,17719479
2016-01-28,LG3,Others(HKUST),8,17,22166,2321898571,151828218,2473726789
2016-01-28,LG3,Non-HKUST,11,22,8213,1238753638,73772587,1312526225
2016-01-28,LG3,Total,561,2484,2295290,167362427169,17464982021,184827409190
2016-01-28,LG4,Staff,116,454,292352,14364448208,816293319,15180741527
2016-01-28,LG4,TPG,89,954,1214830,63482559081,6889308398,70371867479
2016-01-28,LG4,RPG,200,900,827463,49510357115,3161096524,52671453639
2016-01-28,LG4,UG,380,1127,775620,53029406745,5140124497,58169531242
2016-01-28,LG4,Alumni,4,48,66324,321029419,107173879,428203298
2016-01-28,LG4,Others(HKUST),10,155,146791,10649061514,3174967469,13824028983
2016-01-28,LG4,Non-HKUST,19,150,97979,12252879751,1120636342,13373516093
2016-01-28,LG4,Total,818,3788,3421359,203609741833,20409600428,224019342261
2016-01-28,All-Floors,Staff,312,3416,3075953,93197507369,11541185463,104738692832
2016-01-28,All-Floors,TPG,250,5134,5570184,476287740173,53468532549,529756272722
2016-01-28,All-Floors,RPG,396,4368,4121490,223295704001,40963257331,264258961332
2016-01-28,All-Floors,UG,806,6230,6200099,318578611738,30312484133,348891095871
2016-01-28,All-Floors,Alumni,14,240,341010,3618707969,431131245,4049839214
2016-01-28,All-Floors,Others(HKUST),23,388,830684,79522324349,8713728624,88236052973
2016-01-28,All-Floors,Non-HKUST,39,299,254933,19995649973,2222853435,22218503408
2016-01-28,All-Floors,Total,1840,20075,20394353,1214496245572,147653172780,1362149418352
2016-01-29,1,Staff,88,862,1249532,9257059310,1217434991,10474494301
2016-01-29,1,TPG,51,527,852828,58104282285,8559749466,66664031751
2016-01-29,1,RPG,39,295,343273,9041875523,1163011826,10204887349
2016-01-29,1,UG,53,356,376225,15486053790,2387572253,17873626043
2016-01-29,1,Alumni,3,20,47414,2218638365,168480959,2387119324
2016-01-29,1,Others(HKUST),4,32,36634,3319680,837872,4157552
2016-01-29,1,Non-HKUST,8,49,95050,7373677017,324047011,7697724028
2016-01-29,1,Total,246,2141,3000956,101484905970,13821134378,115306040348
2016-01-29,G,Staff,156,891,731303,11141740910,5574814693,16716555603
2016-01-29,G,TPG,138,1050,958025,65564552321,9127737623,74692289944
2016-01-29,G,RPG,141,604,408210,15822040335,1891339713,17713380048
2016-01-29,G,UG,240,844,711773,44554237300,2773542422,47327779722
2016-01-29,G,Alumni,8,15,9148,844144135,80456097,924600232
2016-01-29,G,Others(HKUST),9,31,151841,4594182218,747892023,5342074241
2016-01-29,G,Non-HKUST,14,34,34800,1635539710,185059365,1820599075
2016-01-29,G,Total,706,3469,3005100,144156436929,20380841936,164537278865
2016-01-29,LG1,Staff,108,591,481217,26763692877,1535484429,28299177306
2016-01-29,LG1,TPG,171,2187,2145662,185902277940,17637226125,203539504065
2016-01-29,LG1,RPG,116,997,902638,43521472419,7271925215,50793397634
2016-01-29,LG1,UG,333,3180,3641130,240623355344,31155096359,271778451703
2016-01-29,LG1,Alumni,8,65,83476,160575365,19225351,179800716
2016-01-29,LG1,Others(HKUST),8,74,429745,11897403779,756346141,12653749920
2016-01-29,LG1,Non-HKUST,14,124,136097,12418068405,798972645,13217041050
2016-01-29,LG1,Total,758,7218,7819965,521286846129,59174276265,580461122394
2016-01-29,LG3,Staff,94,351,270912,11583671494,516284678,12099956172
2016-01-29,LG3,TPG,81,775,833659,87209470314,12511024447,99720494761
2016-01-29,LG3,RPG,92,573,559930,26878209924,2863410774,29741620698
2016-01-29,LG3,UG,314,1037,681626,24690395173,2694534637,27384929810
2016-01-29,LG3,Alumni,7,53,86305,2354714804,135243642,2489958446
2016-01-29,LG3,Others(HKUST),7,26,31926,723084758,1419845600,2142930358
2016-01-29,LG3,Non-HKUST,14,32,40979,313042065,85347634,398389699
2016-01-29,LG3,Total,609,2847,2505337,153752588532,20225691412,173978279944
2016-01-29,LG4,Staff,134,444,255563,19659042171,843431276,20502473447
2016-01-29,LG4,TPG,90,722,908322,53291297475,5825162710,59116460185
2016-01-29,LG4,RPG,152,647,669981,60237829727,2835001994,63072831721
2016-01-29,LG4,UG,363,1059,832501,48138131008,13863223257,62001354265
2016-01-29,LG4,Alumni,7,46,85805,170887265,61125713,232012978
2016-01-29,LG4,Others(HKUST),8,200,223325,25056011158,6413771050,31469782208
2016-01-29,LG4,Non-HKUST,18,106,62156,467534611,71366795,538901406
2016-01-29,LG4,Total,772,3224,3037653,207020733415,29913082795,236933816210
2016-01-29,All-Floors,Staff,348,3139,2988527,78405206762,9687450067,88092656829
2016-01-29,All-Floors,TPG,252,5261,5698496,450071880335,53660900371,503732780706
2016-01-29,All-Floors,RPG,332,3116,2884032,155501427928,16024689522,171526117450
2016-01-29,All-Floors,UG,847,6476,6243255,373492172615,52873968928,426366141543
2016-01-29,All-Floors,Alumni,21,199,312148,5748959934,464531762,6213491696
2016-01-29,All-Floors,Others(HKUST),20,363,873471,42274001593,9338692686,51612694279
2016-01-29,All-Floors,Non-HKUST,37,345,369082,22207861808,1464793450,23672655258
2016-01-29,All-Floors,Total,1857,18899,19369011,1127701510975,143515026786,1271216537761
2016-01-30,1,Staff,17,110,231310,1406363431,195639640,1602003071
2016-01-30,1,TPG,48,659,827064,107865282696,9551287060,117416569756
2016-01-30,1,RPG,28,145,202507,7040682304,474497376,7515179680
2016-01-30,1,UG,43,182,310269,14687508162,1635762804,16323270966
2016-01-30,1,Alumni,3,30,25823,817407025,103971465,921378490
2016-01-30,1,Others(HKUST),2,4,2347,112358278,4929586,117287864
2016-01-30,1,Non-HKUST,6,66,124787,9452235102,366831093,9819066195
2016-01-30,1,Total,147,1196,1724107,141381836998,12332919024,153714756022
2016-01-30,G,Staff,36,222,224153,2882600604,338763822,3221364426
2016-01-30,G,TPG,130,770,667991,36567089264,5941181765,42508271029
2016-01-30,G,RPG,76,413,423804,20303458966,1107638195,21411097161
2016-01-30,G,UG,187,603,494777,25515176476,2239393067,27754569543
2016-01-30,G,Alumni,16,49,27079,6750369668,301529928,7051899596
2016-01-30,G,Others(HKUST),4,15,186843,3016415977,466861048,3483277025
2016-01-30,G,Non-HKUST,18,62,48833,8609890683,508392812,9118283495
2016-01-30,G,Total,467,2134,2073480,103645001638,10903760637,114548762275
2016-01-30,LG1,Staff,32,219,237464,17292083546,3892318203,21184401749
2016-01-30,LG1,TPG,139,1630,2216917,146371699566,19438272729,165809972295
2016-01-30,LG1,RPG,75,645,828786,45402522448,4092508113,49495030561
2016-01-30,LG1,UG,227,1897,2309690,103458403700,10033466694,113491870394
2016-01-30,LG1,Alumni,14,143,133619,6668114390,3557881129,10225995519
2016-01-30,LG1,Others(HKUST),8,53,591070,21054193142,1549909444,22604102586
2016-01-30,LG1,Non-HKUST,9,52,81391,11830896630,1018573481,12849470111
2016-01-30,LG1,Total,504,4639,6398937,352077913422,43582929793,395660843215
2016-01-30,LG3,Staff,27,93,127098,5561556912,1204298818,6765855730
2016-01-30,LG3,TPG,65,467,525803,45371408355,11687625515,57059033870
2016-01-30,LG3,RPG,61,260,330797,7464540336,919540690,8384081026
2016-01-30,LG3,UG,237,1341,1557161,65560252799,8025817577,73586070376
2016-01-30,LG3,Alumni,11,44,66303,1504564537,131671601,1636236138
2016-01-30,LG3,Others(HKUST),4,6,4211,219741124,6366047,226107171
2016-01-30,LG3,Non-HKUST,10,25,34948,1181215707,184828514,1366044221
2016-01-30,LG3,Total,415,2236,2646321,126863279770,22160148762,149023428532
2016-01-30,LG4,Staff,44,106,165600,5717202771,831171612,6548374383
2016-01-30,LG4,TPG,75,384,550461,20693648736,3187490169,23881138905
2016-01-30,LG4,RPG,100,355,409449,37562062962,4420323607,41982386569
2016-01-30,LG4,UG,306,866,784139,22863932181,2531633347,25395565528
2016-01-30,LG4,Alumni,19,99,210923,3143776030,1554813411,4698589441
2016-01-30,LG4,Others(HKUST),5,120,282912,21911837030,1381613041,23293450071
2016-01-30,LG4,Non-HKUST,10,68,30370,1456899682,130143252,1587042934
2016-01-30,LG4,Total,559,1998,2433854,113349359392,14037188439,127386547831
2016-01-30,All-Floors,Staff,105,750,985625,32859807264,6462192095,39321999359
2016-01-30,All-Floors,TPG,237,3910,4788236,356869128617,49805857238,406674985855
2016-01-30,All-Floors,RPG,217,1818,2195343,117773267016,11014507981,128787774997
2016-01-30,All-Floors,UG,667,4889,5456036,232085273318,24466073489,256551346807
2016-01-30,All-Floors,Alumni,36,365,463747,18884231650,5649867534,24534099184
2016-01-30,All-Floors,Others(HKUST),14,198,1067383,46314545551,3409679166,49724224717
2016-01-30,All-Floors,Non-HKUST,37,273,320329,32531137804,2208769152,34739906956
2016-01-30,All-Floors,Total,1313,12203,15276699,837317391220,103016946655,940334337875
2016-01-31,1,Staff,10,112,156974,384193009,390245470,774438479
2016-01-31,1,TPG,40,487,864825,156349109196,10229519385,166578628581
2016-01-31,1,RPG,26,168,303405,18503497132,1604493553,20107990685
2016-01-31,1,UG,67,213,320752,14943320066,839809776,15783129842
2016-01-31,1,Alumni,5,24,42998,523394506,98196357,621590863
2016-01-31,1,Others(HKUST),1,1,0,62310,60396,122706
2016-01-31,1,Non-HKUST,3,5,24365,205205684,19819705,225025389
2016-01-31,1,Total,152,1010,1713319,190908781903,13182144642,204090926545
2016-01-31,G,Staff,35,201,155280,2625046810,374555807,2999602617
2016-01-31,G,TPG,117,742,669642,90038386967,7469555172,97507942139
2016-01-31,G,RPG,71,228,190235,23255436328,1082583409,24338019737
2016-01-31,G,UG,223,755,687923,34157007565,4129074190,38286081755
2016-01-31,G,Alumni,20,72,107350,8186403583,1513625801,9700029384
2016-01-31,G,Others(HKUST),5,33,125085,12014053153,1447289487,13461342640
2016-01-31,G,Non-HKUST,13,49,43594,365788956,85170937,450959893
2016-01-31,G,Total,484,2080,1979109,170642123362,16101854803,186743978165
2016-01-31,LG1,Staff,29,210,179887,9140390793,560250945,9700641738
2016-01-31,LG1,TPG,148,2148,2210509,172840255883,20989470264,193829726147
2016-01-31,LG1,RPG,78,798,986500,53392773502,11652100164,65044873666
2016-01-31,LG1,UG,249,2118,2166303,79803485078,26367325782,106170810860
2016-01-31,LG1,Alumni,21,242,260346,77291379338,34436166877,111727546215
2016-01-31,LG1,Others(HKUST),3,54,428862,20216333378,1589971785,21806305163
2016-01-31,LG1,Non-HKUST,11,79,100278,17331566540,1323632480,18655199020
2016-01-31,LG1,Total,539,5649,6332685,430016184512,96918918297,526935102809
2016-01-31,LG3,Staff,28,100,177252,10178476125,795576770,10974052895
2016-01-31,LG3,TPG,82,482,619350,41982615513,6028213813,48010829326
2016-01-31,LG3,RPG,57,261,303920,31030376081,2368010294,33398386375
2016-01-31,LG3,UG,304,804,597727,31851914816,8044071213,39895986029
2016-01-31,LG3,Alumni,11,81,109899,24764836983,4044879243,28809716226
2016-01-31,LG3,Others(HKUST),3,18,12718,1155758634,114908006,1270666640
2016-01-31,LG3,Non-HKUST,14,39,45356,651033642,169194797,820228439
2016-01-31,LG3,Total,499,1785,1866222,141615011794,21564854136,163179865930
2016-01-31,LG4,Staff,45,102,89588,1537478158,83788414,1621266572
2016-01-31,LG4,TPG,75,498,818554,51941683983,9658596756,61600280739
2016-01-31,LG4,RPG,108,330,302073,29603796299,1761367213,31365163512
2016-01-31,LG4,UG,395,1089,1018807,26895715230,8669773737,35565488967
2016-01-31,LG4,Alumni,14,64,131171,1353722705,1473043462,2826766167
2016-01-31,LG4,Others(HKUST),4,65,217318,15170383319,876029130,16046412449
2016-01-31,LG4,Non-HKUST,12,70,68176,7888314563,436380680,8324695243
2016-01-31,LG4,Total,653,2218,2645687,134391094257,22958979392,157350073649
2016-01-31,All-Floors,Staff,98,725,758981,23865584895,2204417406,26070002301
2016-01-31,All-Floors,TPG,217,4357,5182880,513152051542,54375355390,567527406932
2016-01-31,All-Floors,RPG,225,1785,2086133,155785879342,18468554633,174254433975
2016-01-31,All-Floors,UG,838,4979,4791512,187651442755,48050054698,235701497453
2016-01-31,All-Floors,Alumni,40,483,651764,112119737115,41565911740,153685648855
2016-01-31,All-Floors,Others(HKUST),10,171,783983,48556590794,4028258804,52584849598
2016-01-31,All-Floors,Non-HKUST,37,242,281769,26441909385,2034198599,28476107984
2016-01-31,All-Floors,Total,1465,12742,14537022,1067573195828,170726751270,1238299947098
