Date,Floor,User-Group,User-Count,WiFi-Conn,Duration-Sec,Traffic-In-Byte,Traffic-Out-Byte,Traffic-Both-Byte
2017-07-01,1,Staff,4,96,158200,5114097365,119747797,5233845162
2017-07-01,1,TPG,0,0,0,0,0,0
2017-07-01,1,RPG,1,1,0,30947253,6141800,37089053
2017-07-01,1,UG,4,10,85819,55778058,45020624,100798682
2017-07-01,1,Alumni,0,0,0,0,0,0
2017-07-01,1,Others(HKUST),2,2,0,6706950,1733545,8440495
2017-07-01,1,Non-HKUST,0,0,0,0,0,0
2017-07-01,1,Total,11,109,244019,5207529626,172643766,5380173392
2017-07-01,G,Staff,4,13,2895,5944028,962797,6906825
2017-07-01,G,TPG,1,1,0,594747,174375,769122
2017-07-01,G,RPG,1,1,0,221383,205595,426978
2017-07-01,G,UG,12,12,0,2502921218,95017828,2597939046
2017-07-01,G,Alumni,0,0,0,0,0,0
2017-07-01,G,Others(HKUST),3,3,86399,3039619556,342818362,3382437918
2017-07-01,G,Non-HKUST,0,0,0,0,0,0
2017-07-01,G,Total,21,30,89294,5549300932,439178957,5988479889
2017-07-01,LG1,Staff,5,8,239,3742703,1522666,5265369
2017-07-01,LG1,TPG,0,0,0,0,0,0
2017-07-01,LG1,RPG,1,3,0,28266081,6277644,34543725
2017-07-01,LG1,UG,7,7,0,1940688010,110225143,2050913153
2017-07-01,LG1,Alumni,2,2,0,236106396,11494239,247600635
2017-07-01,LG1,Others(HKUST),3,8,435239,2720896420,593185533,3314081953
2017-07-01,LG1,Non-HKUST,2,2,0,15501912,3537895,19039807
2017-07-01,LG1,Total,20,30,435478,4945201522,726243120,5671444642
2017-07-01,LG3,Staff,13,14,357,440409723,74969023,515378746
2017-07-01,LG3,TPG,2,2,0,82553894,2772353,85326247
2017-07-01,LG3,RPG,13,13,0,3187073614,91430329,3278503943
2017-07-01,LG3,UG,20,21,355,2956603199,216878359,3173481558
2017-07-01,LG3,Alumni,3,3,357,31991803,119141847,151133650
2017-07-01,LG3,Others(HKUST),1,1,0,520813,163177,683990
2017-07-01,LG3,Non-HKUST,4,4,0,186184482,22496737,208681219
2017-07-01,LG3,Total,56,58,1069,6885337528,527851825,7413189353
2017-07-01,LG4,Staff,29,32,1805,1997458246,99841814,2097300060
2017-07-01,LG4,TPG,7,8,239,927456196,56283323,983739519
2017-07-01,LG4,RPG,78,92,2138,8414145412,480259206,8894404618
2017-07-01,LG4,UG,118,361,169207,16401480384,3451095819,19852576203
2017-07-01,LG4,Alumni,8,12,349,406994689,22802802,429797491
2017-07-01,LG4,Others(HKUST),8,25,2984,1833379970,538641250,2372021220
2017-07-01,LG4,Non-HKUST,8,8,0,294365706,27980666,322346372
2017-07-01,LG4,Total,256,538,176722,30275280603,4676904880,34952185483
2017-07-01,All-Floors,Staff,49,163,163496,7561652065,297044097,7858696162
2017-07-01,All-Floors,TPG,10,11,239,1010604837,59230051,1069834888
2017-07-01,All-Floors,RPG,92,110,2138,11660653743,584314574,12244968317
2017-07-01,All-Floors,UG,150,411,255381,23857470869,3918237773,27775708642
2017-07-01,All-Floors,Alumni,12,17,706,675092888,153438888,828531776
2017-07-01,All-Floors,Others(HKUST),13,39,524622,7601123709,1476541867,9077665576
2017-07-01,All-Floors,Non-HKUST,13,14,0,496052100,54015298,550067398
2017-07-01,All-Floors,Total,339,765,946582,52862650211,6542822548,59405472759
2017-07-02,1,Staff,9,121,142477,602578022,43526689,646104711
2017-07-02,1,TPG,12,157,210297,48968425737,2639195319,51607621056
2017-07-02,1,RPG,7,45,52972,1799988293,294154617,2094142910
2017-07-02,1,UG,36,204,296336,34966970234,3445820756,38412790990
2017-07-02,1,Alumni,6,26,20894,2826884306,127912473,2954796779
2017-07-02,1,Others(HKUST),1,1,1429,5914657634,184693009,6099350643
2017-07-02,1,Non-HKUST,5,32,40860,2436503149,394110533,2830613682
2017-07-02,1,Total,76,586,765265,97516007375,7129413396,104645420771
2017-07-02,G,Staff,29,207,148951,5805092300,688318367,6493410667
2017-07-02,G,TPG,33,100,180469,26230137806,1500262984,27730400790
2017-07-02,G,RPG,40,166,161288,8317382697,992118496,9309501193
2017-07-02,G,UG,124,550,665246,108035795814,12959288686,120995084500
2017-07-02,G,Alumni,19,74,70661,5323434124,1309564850,6632998974
2017-07-02,G,Others(HKUST),6,18,91688,35398711670,1779037331,37177749001
2017-07-02,G,Non-HKUST,18,63,111829,6667726735,364547825,7032274560
2017-07-02,G,Total,269,1178,1430132,195778281146,19593138539,215371419685
2017-07-02,LG1,Staff,20,107,127752,11404198679,1287606125,12691804804
2017-07-02,LG1,TPG,38,231,282241,57763949761,8813153960,66577103721
2017-07-02,LG1,RPG,48,297,324138,30490605523,8826411465,39317016988
2017-07-02,LG1,UG,177,1710,2494762,502789430768,175217733369,678007164137
2017-07-02,LG1,Alumni,18,107,167992,20422862790,2608981021,23031843811
2017-07-02,LG1,Others(HKUST),3,15,442406,28886391558,1946078050,30832469608
2017-07-02,LG1,Non-HKUST,16,69,162070,16563658708,1304057049,17867715757
2017-07-02,LG1,Total,320,2536,4001361,668321097787,200004021039,868325118826
2017-07-02,LG3,Staff,19,73,61067,11668869684,1493554794,13162424478
2017-07-02,LG3,TPG,16,176,185661,116948049660,5870036463,122818086123
2017-07-02,LG3,RPG,41,125,139451,10449086047,1648161523,12097247570
2017-07-02,LG3,UG,70,313,429756,178969245692,11561225608,190530471300
2017-07-02,LG3,Alumni,13,66,162643,10892104665,2943556049,13835660714
2017-07-02,LG3,Others(HKUST),2,2,0,5904825545,182105302,6086930847
2017-07-02,LG3,Non-HKUST,9,18,84593,5431291789,282335436,5713627225
2017-07-02,LG3,Total,170,773,1063171,340263473082,23980975175,364244448257
2017-07-02,LG4,Staff,31,64,52331,4014696251,245195133,4259891384
2017-07-02,LG4,TPG,27,178,238719,60421299546,3727001456,64148301002
2017-07-02,LG4,RPG,79,313,262527,36057969944,2773582644,38831552588
2017-07-02,LG4,UG,141,494,525085,97247536470,10262000355,107509536825
2017-07-02,LG4,Alumni,20,122,175362,31282586881,1599470651,32882057532
2017-07-02,LG4,Others(HKUST),5,6,226,2522178,19616358,22138536
2017-07-02,LG4,Non-HKUST,13,13,1087,466150945,174660290,640811235
2017-07-02,LG4,Total,316,1190,1255337,229492762215,18801526887,248294289102
2017-07-02,All-Floors,Staff,73,572,532578,33495434936,3758201108,37253636044
2017-07-02,All-Floors,TPG,75,842,1097387,310331862510,22549650182,332881512692
2017-07-02,All-Floors,RPG,150,946,940376,87115032504,14534428745,101649461249
2017-07-02,All-Floors,UG,337,3271,4411185,922008978978,213446068774,1135455047752
2017-07-02,All-Floors,Alumni,35,395,597552,70747872766,8589485044,79337357810
2017-07-02,All-Floors,Others(HKUST),11,42,535749,76107108585,4111530050,80218638635
2017-07-02,All-Floors,Non-HKUST,44,195,400439,31565331326,2519711133,34085042459
2017-07-02,All-Floors,Total,725,6263,8515266,1531371621605,269509075036,1800880696641
2017-07-03,1,Staff,72,1123,1169924,39153827111,4273658022,43427485133
2017-07-03,1,TPG,20,319,323621,56485448972,2938818579,59424267551
2017-07-03,1,RPG,31,332,508297,23620013229,3096575839,26716589068
2017-07-03,1,UG,81,722,851316,107112261586,4903027500,112015289086
2017-07-03,1,Alumni,2,10,9028,1728391404,115504114,1843895518
2017-07-03,1,Others(HKUST),6,32,39166,2235388336,302266836,2537655172
2017-07-03,1,Non-HKUST,16,130,176327,12825907176,6939611002,19765518178
2017-07-03,1,Total,228,2668,3077679,243161237814,22569461892,265730699706
2017-07-03,G,Staff,158,949,811817,29258125637,7837630136,37095755773
2017-07-03,G,TPG,74,646,586521,128198476665,9510252994,137708729659
2017-07-03,G,RPG,117,642,671852,42403400889,13605339320,56008740209
2017-07-03,G,UG,274,1293,1297010,145975268402,13737637793,159712906195
2017-07-03,G,Alumni,10,21,2643,4122320867,173780361,4296101228
2017-07-03,G,Others(HKUST),13,57,133971,18542115805,881303538,19423419343
2017-07-03,G,Non-HKUST,26,89,66595,4931886645,440775743,5372662388
2017-07-03,G,Total,672,3697,3570409,373431594910,46186719885,419618314795
2017-07-03,LG1,Staff,103,557,431199,33281329856,4074209996,37355539852
2017-07-03,LG1,TPG,81,887,1012557,120329129985,13628050426,133957180411
2017-07-03,LG1,RPG,104,797,959832,85146103473,16051713144,101197816617
2017-07-03,LG1,UG,377,3106,4211470,621701345920,52554058090,674255404010
2017-07-03,LG1,Alumni,7,46,66633,10027968680,369397382,10397366062
2017-07-03,LG1,Others(HKUST),18,143,537368,12919607883,1275506045,14195113928
2017-07-03,LG1,Non-HKUST,24,129,228370,11521088432,6004497343,17525585775
2017-07-03,LG1,Total,714,5665,7447429,894926574229,93957432426,988884006655
2017-07-03,LG3,Staff,82,382,288836,32937385322,3605743436,36543128758
2017-07-03,LG3,TPG,29,329,504116,229636806332,13479800518,243116606850
2017-07-03,LG3,RPG,68,475,637772,42938692734,4183267886,47121960620
2017-07-03,LG3,UG,148,656,778662,147895284060,9048294952,156943579012
2017-07-03,LG3,Alumni,9,58,53645,4688095440,374142918,5062238358
2017-07-03,LG3,Others(HKUST),10,23,16737,1081102726,94524873,1175627599
2017-07-03,LG3,Non-HKUST,10,36,52004,2765939669,231850071,2997789740
2017-07-03,LG3,Total,356,1959,2331772,461943306283,31017624654,492960930937
2017-07-03,LG4,Staff,148,382,210523,31838354986,3513048194,35351403180
2017-07-03,LG4,TPG,39,286,324540,116535060830,24883507049,141418567879
2017-07-03,LG4,RPG,152,595,697376,106227929343,5707356484,111935285827
2017-07-03,LG4,UG,272,928,789801,133796357521,12125451672,145921809193
2017-07-03,LG4,Alumni,9,86,76536,77756333152,3799334063,81555667215
2017-07-03,LG4,Others(HKUST),17,40,23885,7679430407,269471413,7948901820
2017-07-03,LG4,Non-HKUST,18,80,81952,4220052066,381983671,4602035737
2017-07-03,LG4,Total,655,2397,2204613,478053518305,50680152546,528733670851
2017-07-03,All-Floors,Staff,344,3393,2912299,166469022912,23304289784,189773312696
2017-07-03,All-Floors,TPG,138,2467,2751355,651184922784,64440429566,715625352350
2017-07-03,All-Floors,RPG,316,2841,3475129,300336139668,42644252673,342980392341
2017-07-03,All-Floors,UG,731,6705,7928259,1156480517489,92368470007,1248848987496
2017-07-03,All-Floors,Alumni,16,221,208485,98323109543,4832158838,103155268381
2017-07-03,All-Floors,Others(HKUST),36,295,751127,42457645157,2823072705,45280717862
2017-07-03,All-Floors,Non-HKUST,64,464,605248,36264873988,13998717830,50263591818
2017-07-03,All-Floors,Total,1645,16386,18631902,2451516231541,244411391403,2695927622944
2017-07-04,1,Staff,84,1104,1244223,41626897857,6709794673,48336692530
2017-07-04,1,TPG,25,309,376950,44530549832,7265165211,51795715043
2017-07-04,1,RPG,28,268,424707,24161663441,1502455724,25664119165
2017-07-04,1,UG,68,922,1041281,94831901067,22422580177,117254481244
2017-07-04,1,Alumni,3,11,12489,293772800,28633391,322406191
2017-07-04,1,Others(HKUST),4,20,40915,1030856883,263384519,1294241402
2017-07-04,1,Non-HKUST,10,112,205953,10502958886,666436358,11169395244
2017-07-04,1,Total,222,2746,3346518,216978600766,38858450053,255837050819
2017-07-04,G,Staff,160,903,891649,45942426386,7675530081,53617956467
2017-07-04,G,TPG,74,528,533470,97091014658,6729395070,103820409728
2017-07-04,G,RPG,112,573,577325,60140853000,15760440246,75901293246
2017-07-04,G,UG,263,1398,1522714,392665684519,34855500572,427521185091
2017-07-04,G,Alumni,9,80,86665,657541739,96533469,754075208
2017-07-04,G,Others(HKUST),9,67,241665,10800877357,734761806,11535639163
2017-07-04,G,Non-HKUST,28,123,79575,30830377397,1698334471,32528711868
2017-07-04,G,Total,655,3672,3933063,638128775056,67550495715,705679270771
2017-07-04,LG1,Staff,112,690,449582,36821438864,3154481257,39975920121
2017-07-04,LG1,TPG,79,724,1220078,211551611732,18662484499,230214096231
2017-07-04,LG1,RPG,108,910,1069056,74318688016,12732869111,87051557127
2017-07-04,LG1,UG,387,3509,4382724,605115495910,93791833108,698907329018
2017-07-04,LG1,Alumni,7,42,47327,4861451717,249182087,5110633804
2017-07-04,LG1,Others(HKUST),14,80,493947,13995822289,2010455916,16006278205
2017-07-04,LG1,Non-HKUST,19,127,157687,27628900160,2176246465,29805146625
2017-07-04,LG1,Total,726,6082,7820401,974293408688,132777552443,1107070961131
2017-07-04,LG3,Staff,100,366,208474,80767484113,4464040788,85231524901
2017-07-04,LG3,TPG,34,355,372867,81700309183,5053893975,86754203158
2017-07-04,LG3,RPG,72,440,556811,114836053749,7631605814,122467659563
2017-07-04,LG3,UG,144,1278,1232825,330252723964,22787005982,353039729946
2017-07-04,LG3,Alumni,5,51,66420,1323205017,387607175,1710812192
2017-07-04,LG3,Others(HKUST),4,6,0,142648736,12208482,154857218
2017-07-04,LG3,Non-HKUST,9,20,22800,3378559316,209018098,3587577414
2017-07-04,LG3,Total,368,2516,2460197,612400984078,40545380314,652946364392
2017-07-04,LG4,Staff,152,478,294487,51530629993,5342757934,56873387927
2017-07-04,LG4,TPG,35,275,438988,483666202511,23158495455,506824697966
2017-07-04,LG4,RPG,144,551,663661,79146297703,6400423081,85546720784
2017-07-04,LG4,UG,258,936,839625,113689636316,8280644494,121970280810
2017-07-04,LG4,Alumni,6,61,56091,3451820291,179260753,3631081044
2017-07-04,LG4,Others(HKUST),14,45,20591,6459163666,312475862,6771639528
2017-07-04,LG4,Non-HKUST,19,73,73150,4815490974,498279269,5313770243
2017-07-04,LG4,Total,628,2419,2386593,742759241454,44172336848,786931578302
2017-07-04,All-Floors,Staff,377,3541,3088415,256688877213,27346604733,284035481946
2017-07-04,All-Floors,TPG,126,2191,2942353,918539687916,60869434210,979409122126
2017-07-04,All-Floors,RPG,294,2742,3291560,352603555909,44027793976,396631349885
2017-07-04,All-Floors,UG,694,8043,9019169,1536555441776,182137564333,1718693006109
2017-07-04,All-Floors,Alumni,15,245,268992,10587791564,941216875,11529008439
2017-07-04,All-Floors,Others(HKUST),29,218,797118,32429368931,3333286585,35762655516
2017-07-04,All-Floors,Non-HKUST,51,455,539165,77156286733,5248314661,82404601394
2017-07-04,All-Floors,Total,1586,17435,19946772,3184561010042,323904215373,3508465225415
2017-07-05,1,Staff,79,1095,1219252,34919806985,5037936019,39957743004
2017-07-05,1,TPG,19,316,320739,30853281203,9932800376,40786081579
2017-07-05,1,RPG,27,200,391524,18450291894,2685918698,21136210592
2017-07-05,1,UG,72,672,823734,102304895268,6739130375,109044025643
2017-07-05,1,Alumni,2,9,2166,54348656,7361049,61709705
2017-07-05,1,Others(HKUST),6,18,34066,585398649,605483035,1190881684
2017-07-05,1,Non-HKUST,5,18,36362,5037905834,192965319,5230871153
2017-07-05,1,Total,210,2328,2827843,192205928489,25201594871,217407523360
2017-07-05,G,Staff,157,1042,710462,37205739516,7268814191,44474553707
2017-07-05,G,TPG,72,449,484804,70117211366,5100329003,75217540369
2017-07-05,G,RPG,110,619,627639,56795982533,9944282934,66740265467
2017-07-05,G,UG,234,1319,1519192,171380324867,19478072799,190858397666
2017-07-05,G,Alumni,10,101,117931,567623375,67229299,634852674
2017-07-05,G,Others(HKUST),17,85,144804,7175631656,1790222864,8965854520
2017-07-05,G,Non-HKUST,15,70,42428,751793858,125765334,877559192
2017-07-05,G,Total,615,3685,3647260,343994307171,43774716424,387769023595
2017-07-05,LG1,Staff,109,526,378372,41200882340,5252215036,46453097376
2017-07-05,LG1,TPG,76,929,1150868,178406345021,15296435754,193702780775
2017-07-05,LG1,RPG,102,966,1069589,111717183303,8164694660,119881877963
2017-07-05,LG1,UG,370,3623,3783402,579859773385,198881688960,778741462345
2017-07-05,LG1,Alumni,4,42,27783,698702092,160236447,858938539
2017-07-05,LG1,Others(HKUST),16,118,512707,21813247065,1687297354,23500544419
2017-07-05,LG1,Non-HKUST,17,112,180001,14241519965,2267226244,16508746209
2017-07-05,LG1,Total,694,6316,7102722,947937653171,231709794455,1179647447626
2017-07-05,LG3,Staff,103,443,280914,48350227551,2384994155,50735221706
2017-07-05,LG3,TPG,29,328,519877,67044545346,7012601916,74057147262
2017-07-05,LG3,RPG,65,394,509684,53415583566,9325061391,62740644957
2017-07-05,LG3,UG,150,754,797684,103098009199,15369687441,118467696640
2017-07-05,LG3,Alumni,7,61,76560,2326258893,272248362,2598507255
2017-07-05,LG3,Others(HKUST),11,28,22335,315285423,151653417,466938840
2017-07-05,LG3,Non-HKUST,6,12,22788,242036491,26112336,268148827
2017-07-05,LG3,Total,371,2020,2229842,274791946469,34542359018,309334305487
2017-07-05,LG4,Staff,145,355,107582,12752689332,865215257,13617904589
2017-07-05,LG4,TPG,36,190,393747,96044560370,9237812457,105282372827
2017-07-05,LG4,RPG,157,650,677629,82062279610,8325983665,90388263275
2017-07-05,LG4,UG,277,868,836625,116804402023,16524560648,133328962671
2017-07-05,LG4,Alumni,10,88,79856,6762549298,346904829,7109454127
2017-07-05,LG4,Others(HKUST),16,34,3744,1274266682,423251159,1697517841
2017-07-05,LG4,Non-HKUST,27,94,96198,16342020704,971522990,17313543694
2017-07-05,LG4,Total,668,2279,2195381,332042768019,36695251005,368738019024
2017-07-05,All-Floors,Staff,362,3461,2696582,174429345724,20809174658,195238520382
2017-07-05,All-Floors,TPG,126,2212,2870035,442465943306,46579979506,489045922812
2017-07-05,All-Floors,RPG,290,2829,3276065,322441320906,38445941348,360887262254
2017-07-05,All-Floors,UG,716,7236,7760637,1073447404742,256993140223,1330440544965
2017-07-05,All-Floors,Alumni,17,301,304296,10409482314,853979986,11263462300
2017-07-05,All-Floors,Others(HKUST),41,283,717656,31163829475,4657907829,35821737304
2017-07-05,All-Floors,Non-HKUST,50,306,377777,36615276852,3583592223,40198869075
2017-07-05,All-Floors,Total,1602,16628,18003048,2090972603319,371923715773,2462896319092
2017-07-06,1,Staff,78,1178,1319517,40783321601,4972985790,45756307391
2017-07-06,1,TPG,15,228,228119,16575834964,4773476952,21349311916
2017-07-06,1,RPG,20,154,391820,48319851217,2718013205,51037864422
2017-07-06,1,UG,61,503,723633,95229336867,17201583110,112430919977
2017-07-06,1,Alumni,1,2,486,103295,24208,127503
2017-07-06,1,Others(HKUST),8,48,93284,1278228245,188588324,1466816569
2017-07-06,1,Non-HKUST,7,41,64651,2059859483,181604230,2241463713
2017-07-06,1,Total,190,2154,2821510,204246535672,30036275819,234282811491
2017-07-06,G,Staff,143,999,832840,50942718739,14151503032,65094221771
2017-07-06,G,TPG,52,288,326558,38748248243,2969968382,41718216625
2017-07-06,G,RPG,99,456,433077,53890538239,5790995351,59681533590
2017-07-06,G,UG,213,1337,1692443,207966000302,25647361225,233613361527
2017-07-06,G,Alumni,7,66,80566,1163082048,111924053,1275006101
2017-07-06,G,Others(HKUST),13,71,244802,25265057146,1984327228,27249384374
2017-07-06,G,Non-HKUST,18,71,55438,6715536663,852373219,7567909882
2017-07-06,G,Total,545,3288,3665724,384691181380,51508452490,436199633870
2017-07-06,LG1,Staff,116,653,462687,40370472052,4197907212,44568379264
2017-07-06,LG1,TPG,73,1042,1540100,212266763900,35497068663,247763832563
2017-07-06,LG1,RPG,93,879,905156,58929982846,11013936691,69943919537
2017-07-06,LG1,UG,300,2782,3445000,695837880303,74345269082,770183149385
2017-07-06,LG1,Alumni,4,15,6842,131889850,16449478,148339328
2017-07-06,LG1,Others(HKUST),13,82,533749,6214611676,1650971267,7865582943
2017-07-06,LG1,Non-HKUST,19,78,240753,14039757739,1504858279,15544616018
2017-07-06,LG1,Total,618,5531,7134287,1027791358366,128226460672,1156017819038
2017-07-06,LG3,Staff,104,394,172661,30269483171,2384599509,32654082680
2017-07-06,LG3,TPG,20,246,284529,155462464548,20049884105,175512348653
2017-07-06,LG3,RPG,70,391,635569,54833207946,4884855260,59718063206
2017-07-06,LG3,UG,136,852,918567,182215867769,40764642859,222980510628
2017-07-06,LG3,Alumni,4,74,103210,7993038954,463017122,8456056076
2017-07-06,LG3,Others(HKUST),5,69,50951,5286248658,853802243,6140050901
2017-07-06,LG3,Non-HKUST,10,32,40582,2392162533,211188587,2603351120
2017-07-06,LG3,Total,349,2058,2206069,438452473579,69611989685,508064463264
2017-07-06,LG4,Staff,138,459,317248,27407558330,3106119050,30513677380
2017-07-06,LG4,TPG,34,379,506467,314644239606,24038236937,338682476543
2017-07-06,LG4,RPG,142,595,643211,80717084349,19459086028,100176170377
2017-07-06,LG4,UG,256,893,818498,138288838572,75268082254,213556920826
2017-07-06,LG4,Alumni,7,83,68817,18827691118,1324396323,20152087441
2017-07-06,LG4,Others(HKUST),11,52,17006,3007136291,705881347,3713017638
2017-07-06,LG4,Non-HKUST,24,48,36079,2038912987,185372311,2224285298
2017-07-06,LG4,Total,612,2509,2407326,584931461253,124087174250,709018635503
2017-07-06,All-Floors,Staff,343,3683,3104953,189773553893,28813114593,218586668486
2017-07-06,All-Floors,TPG,107,2183,2885773,737697551261,87328635039,825026186300
2017-07-06,All-Floors,RPG,282,2475,3008833,296690664597,43866886535,340557551132
2017-07-06,All-Floors,UG,616,6367,7598141,1319537923813,233226938530,1552764862343
2017-07-06,All-Floors,Alumni,13,240,259921,28115805265,1915811184,30031616449
2017-07-06,All-Floors,Others(HKUST),32,322,939792,41051282016,5383570409,46434852425
2017-07-06,All-Floors,Non-HKUST,54,270,437503,27246229405,2935396626,30181626031
2017-07-06,All-Floors,Total,1447,15540,18234916,2640113010250,403470352916,3043583363166
2017-07-07,1,Staff,72,842,1128033,63400752857,14652320996,78053073853
2017-07-07,1,TPG,16,208,291446,55178396848,3654538434,58832935282
2017-07-07,1,RPG,21,192,354945,24991315452,1707178132,26698493584
2017-07-07,1,UG,72,468,769380,96312247480,6964076663,103276324143
2017-07-07,1,Alumni,2,3,590,50564168,1649244,52213412
2017-07-07,1,Others(HKUST),3,14,18668,961449365,209296410,1170745775
2017-07-07,1,Non-HKUST,4,12,17676,933956072,122592285,1056548357
2017-07-07,1,Total,190,1739,2580738,241828682242,27311652164,269140334406
2017-07-07,G,Staff,160,878,811503,31137837666,6916750172,38054587838
2017-07-07,G,TPG,57,523,535761,108401854849,7412838212,115814693061
2017-07-07,G,RPG,93,440,403303,85790090090,4809789659,90599879749
2017-07-07,G,UG,239,991,1366133,184719644383,15906812991,200626457374
2017-07-07,G,Alumni,11,92,71420,2580574105,1182617207,3763191312
2017-07-07,G,Others(HKUST),14,81,244278,10360662080,1223700991,11584363071
2017-07-07,G,Non-HKUST,19,63,49455,9946009328,534537042,10480546370
2017-07-07,G,Total,593,3068,3481853,432936672501,37987046274,470923718775
2017-07-07,LG1,Staff,108,550,362509,43281207557,5603445269,48884652826
2017-07-07,LG1,TPG,78,1384,1831462,292349893672,24452481160,316802374832
2017-07-07,LG1,RPG,104,954,766057,199323808596,9095944965,208419753561
2017-07-07,LG1,UG,331,3025,3571257,792568180889,113038340703,905606521592
2017-07-07,LG1,Alumni,6,47,60070,4062326956,3673089520,7735416476
2017-07-07,LG1,Others(HKUST),9,139,560759,13485020448,14059674596,27544695044
2017-07-07,LG1,Non-HKUST,21,100,164472,25114199907,2367716441,27481916348
2017-07-07,LG1,Total,657,6199,7316586,1370184638025,172290692654,1542475330679
2017-07-07,LG3,Staff,90,324,239805,16284561294,5849196326,22133757620
2017-07-07,LG3,TPG,24,193,327623,43823903649,9388259635,53212163284
2017-07-07,LG3,RPG,58,415,666882,172159252538,6632104754,178791357292
2017-07-07,LG3,UG,131,544,607062,244036612265,13763093420,257799705685
2017-07-07,LG3,Alumni,6,72,83200,8216008676,239652111,8455660787
2017-07-07,LG3,Others(HKUST),7,35,18837,3083351793,240250666,3323602459
2017-07-07,LG3,Non-HKUST,5,18,17923,213195330,243066444,456261774
2017-07-07,LG3,Total,321,1601,1961332,487816885545,36355623356,524172508901
2017-07-07,LG4,Staff,145,319,145537,23186199629,3595957156,26782156785
2017-07-07,LG4,TPG,33,190,254278,39239756770,4407401436,43647158206
2017-07-07,LG4,RPG,160,610,561542,90363990233,7291816132,97655806365
2017-07-07,LG4,UG,274,967,787282,162558704222,9692835567,172251539789
2017-07-07,LG4,Alumni,6,30,24509,210501344,52378370,262879714
2017-07-07,LG4,Others(HKUST),22,62,29111,5446687565,310436618,5757124183
2017-07-07,LG4,Non-HKUST,29,72,69797,11145739168,643337260,11789076428
2017-07-07,LG4,Total,669,2250,1872056,332151578931,25994162539,358145741470
2017-07-07,All-Floors,Staff,364,2913,2687387,177290559003,36617669919,213908228922
2017-07-07,All-Floors,TPG,118,2498,3240570,538993805788,49315518877,588309324665
2017-07-07,All-Floors,RPG,292,2611,2752729,572628456909,29536833642,602165290551
2017-07-07,All-Floors,UG,687,5995,7101114,1480195389239,159365159344,1639560548583
2017-07-07,All-Floors,Alumni,14,244,239789,15119975249,5149386452,20269361701
2017-07-07,All-Floors,Others(HKUST),36,331,871653,33337171251,16043359281,49380530532
2017-07-07,All-Floors,Non-HKUST,58,265,319323,47353099805,3911249472,51264349277
2017-07-07,All-Floors,Total,1569,14857,17212565,2864918457244,299939176987,3164857634231
2017-07-08,1,Staff,14,190,137200,13867673693,394246012,14261919705
2017-07-08,1,TPG,5,82,109250,5316813954,421114894,5737928848
2017-07-08,1,RPG,22,125,206737,13240563787,1227757087,14468320874
2017-07-08,1,UG,36,219,322400,65530913140,3641853162,69172766302
2017-07-08,1,Alumni,8,90,121565,13798330235,642003558,14440333793
2017-07-08,1,Others(HKUST),2,2,0,8857465,2122812,10980277
2017-07-08,1,Non-HKUST,2,2,1438,17856576,3005812,20862388
2017-07-08,1,Total,89,710,898590,111781008850,6332103337,118113112187
2017-07-08,G,Staff,37,302,333985,20929091876,4369056762,25298148638
2017-07-08,G,TPG,41,245,238045,25012598158,2146214874,27158813032
2017-07-08,G,RPG,45,179,160972,28799401263,6576118070,35375519333
2017-07-08,G,UG,135,673,1054271,98854510692,7093858740,105948369432
2017-07-08,G,Alumni,24,119,129157,56162973200,1619828080,57782801280
2017-07-08,G,Others(HKUST),6,26,221764,5651118559,691691807,6342810366
2017-07-08,G,Non-HKUST,9,37,27455,695712707,122247495,817960202
2017-07-08,G,Total,297,1581,2165649,236105406455,22619015828,258724422283
2017-07-08,LG1,Staff,28,157,145159,16114586420,1214097662,17328684082
2017-07-08,LG1,TPG,57,785,966375,192746729991,14662791384,207409521375
2017-07-08,LG1,RPG,57,435,495427,69784444319,9419895724,79204340043
2017-07-08,LG1,UG,215,1927,2662826,591892024609,51459989779,643352014388
2017-07-08,LG1,Alumni,15,86,185015,18066186677,871592883,18937779560
2017-07-08,LG1,Others(HKUST),5,22,450352,1657782357,454535397,2112317754
2017-07-08,LG1,Non-HKUST,13,55,99906,11600692478,2351369140,13952061618
2017-07-08,LG1,Total,390,3467,5005060,901862446851,80434271969,982296718820
2017-07-08,LG3,Staff,37,183,152244,18349501405,1727506477,20077007882
2017-07-08,LG3,TPG,18,166,192933,38325677288,2037027471,40362704759
2017-07-08,LG3,RPG,37,220,343322,47823597240,4263330056,52086927296
2017-07-08,LG3,UG,105,558,953020,140776585413,10222989960,150999575373
2017-07-08,LG3,Alumni,11,66,101615,35843446218,3650533189,39493979407
2017-07-08,LG3,Others(HKUST),3,7,2151,40044889,41372905,81417794
2017-07-08,LG3,Non-HKUST,9,64,44990,1065468216,106703991,1172172207
2017-07-08,LG3,Total,220,1264,1790275,282224320669,22049464049,304273784718
2017-07-08,LG4,Staff,45,85,113523,9697243725,897657387,10594901112
2017-07-08,LG4,TPG,26,114,196558,15183819448,2595646876,17779466324
2017-07-08,LG4,RPG,82,314,354417,62931771311,6684514658,69616285969
2017-07-08,LG4,UG,155,606,476902,89516365078,8292199035,97808564113
2017-07-08,LG4,Alumni,14,74,92840,15107390330,402558540,15509948870
2017-07-08,LG4,Others(HKUST),6,27,32913,24991906659,1959288510,26951195169
2017-07-08,LG4,Non-HKUST,9,27,10325,176185059,24898133,201083192
2017-07-08,LG4,Total,337,1247,1277478,217604681610,20856763139,238461444749
2017-07-08,All-Floors,Staff,110,917,882111,78958097119,8602564300,87560661419
2017-07-08,All-Floors,TPG,89,1392,1703161,276585638839,21862795499,298448434338
2017-07-08,All-Floors,RPG,160,1273,1560875,222579777920,28171615595,250751393515
2017-07-08,All-Floors,UG,428,3983,5469419,986570398932,80710890676,1067281289608
2017-07-08,All-Floors,Alumni,43,435,630192,138978326660,7186516250,146164842910
2017-07-08,All-Floors,Others(HKUST),13,84,707180,32349709929,3149011431,35498721360
2017-07-08,All-Floors,Non-HKUST,26,185,184114,13555915036,2608224571,16164139607
2017-07-08,All-Floors,Total,869,8269,11137052,1749577864435,152291618322,1901869482757
2017-07-09,1,Staff,14,120,115498,1725060544,234438315,1959498859
2017-07-09,1,TPG,6,60,57964,5502894283,463309810,5966204093
2017-07-09,1,RPG,38,93,109580,8785026937,568952274,9353979211
2017-07-09,1,UG,38,311,356136,61077992721,3534468540,64612461261
2017-07-09,1,Alumni,1,3,12849,9458177674,295079017,9753256691
2017-07-09,1,Others(HKUST),3,18,12274,313626398,63000436,376626834
2017-07-09,1,Non-HKUST,8,99,118103,9726894351,790105096,10516999447
2017-07-09,1,Total,108,704,782404,96589672908,5949353488,102539026396
2017-07-09,G,Staff,28,141,103691,4459594674,319563719,4779158393
2017-07-09,G,TPG,31,154,216682,68666914521,2258466779,70925381300
2017-07-09,G,RPG,29,152,116940,36289650452,4037021099,40326671551
2017-07-09,G,UG,110,491,1057197,145718159022,14920512996,160638672018
2017-07-09,G,Alumni,20,63,71041,4065074316,626745907,4691820223
2017-07-09,G,Others(HKUST),8,17,186588,3715639695,471250350,4186890045
2017-07-09,G,Non-HKUST,5,34,29413,2447613395,236290456,2683903851
2017-07-09,G,Total,231,1052,1781552,265362646075,22869851306,288232497381
2017-07-09,LG1,Staff,24,98,92012,4701116709,2234669360,6935786069
2017-07-09,LG1,TPG,37,276,482449,18995867840,10873159633,29869027473
2017-07-09,LG1,RPG,41,322,389043,227479330965,8700449847,236179780812
2017-07-09,LG1,UG,170,1461,2082120,318854944734,30345556475,349200501209
2017-07-09,LG1,Alumni,11,35,79075,4968676980,464622438,5433299418
2017-07-09,LG1,Others(HKUST),7,23,449977,2455981186,518798837,2974780023
2017-07-09,LG1,Non-HKUST,12,44,106705,9233842596,772944733,10006787329
2017-07-09,LG1,Total,302,2259,3681381,586689761010,53910201323,640599962333
2017-07-09,LG3,Staff,26,64,13426,1477486601,131812740,1609299341
2017-07-09,LG3,TPG,15,109,162256,29655817619,4888749496,34544567115
2017-07-09,LG3,RPG,22,77,132248,31596405076,2353752828,33950157904
2017-07-09,LG3,UG,68,287,374565,79230059620,10004885050,89234944670
2017-07-09,LG3,Alumni,14,118,131330,10678842631,1335269123,12014111754
2017-07-09,LG3,Others(HKUST),3,22,32505,366294642,33900514,400195156
2017-07-09,LG3,Non-HKUST,12,30,29190,1608685762,76225077,1684910839
2017-07-09,LG3,Total,160,707,875520,154613591951,18824594828,173438186779
2017-07-09,LG4,Staff,27,69,67590,12237170616,569469285,12806639901
2017-07-09,LG4,TPG,21,115,114940,14749400090,3084435325,17833835415
2017-07-09,LG4,RPG,61,187,155033,47477834031,7750131223,55227965254
2017-07-09,LG4,UG,115,377,318867,47035856399,25578940405,72614796804
2017-07-09,LG4,Alumni,12,72,97190,6242653232,421951965,6664605197
2017-07-09,LG4,Others(HKUST),5,13,5859,2922591443,274528748,3197120191
2017-07-09,LG4,Non-HKUST,11,19,29607,3546961989,246069461,3793031450
2017-07-09,LG4,Total,252,852,789086,134212467800,37925526412,172137994212
2017-07-09,All-Floors,Staff,76,492,392217,24600429144,3489953419,28090382563
2017-07-09,All-Floors,TPG,71,714,1034291,137570894353,21568121043,159139015396
2017-07-09,All-Floors,RPG,136,831,902844,351628247461,23410307271,375038554732
2017-07-09,All-Floors,UG,344,2927,4188885,651917012496,84384363466,736301375962
2017-07-09,All-Floors,Alumni,30,291,391485,35413424833,3143668450,38557093283
2017-07-09,All-Floors,Others(HKUST),15,93,687203,9774133364,1361478885,11135612249
2017-07-09,All-Floors,Non-HKUST,39,226,313018,26563998093,2121634823,28685632916
2017-07-09,All-Floors,Total,711,5574,7909943,1237468139744,139479527357,1376947667101
2017-07-10,1,Staff,86,1006,1265481,30735503075,5162036972,35897540047
2017-07-10,1,TPG,13,249,209272,79469315223,8435983464,87905298687
2017-07-10,1,RPG,39,270,359860,34646807355,3027155336,37673962691
2017-07-10,1,UG,83,752,1163858,471431044779,13672714572,485103759351
2017-07-10,1,Alumni,1,5,2030,156756,76776,233532
2017-07-10,1,Others(HKUST),8,142,113187,9208281837,3812997499,13021279336
2017-07-10,1,Non-HKUST,13,64,62001,4683417014,300023524,4983440538
2017-07-10,1,Total,243,2488,3175689,630174526039,34410988143,664585514182
2017-07-10,G,Staff,145,942,737103,23114700938,4608805751,27723506689
2017-07-10,G,TPG,97,626,488460,58887539309,13789585124,72677124433
2017-07-10,G,RPG,96,567,578323,54367527107,6436895171,60804422278
2017-07-10,G,UG,278,1182,1631995,228216501946,30869999659,259086501605
2017-07-10,G,Alumni,15,95,106037,3077073784,103064008,3180137792
2017-07-10,G,Others(HKUST),12,302,259219,14062535399,7515408447,21577943846
2017-07-10,G,Non-HKUST,28,130,51489,4294779494,535127353,4829906847
2017-07-10,G,Total,671,3844,3852626,386020657977,63858885513,449879543490
2017-07-10,LG1,Staff,113,618,517958,139828600064,9261174125,149089774189
2017-07-10,LG1,TPG,103,988,1075128,104384279558,14231647184,118615926742
2017-07-10,LG1,RPG,122,961,825204,124762820393,36781036485,161543856878
2017-07-10,LG1,UG,407,3774,3893253,640963972824,67985788460,708949761284
2017-07-10,LG1,Alumni,8,41,39812,1840135278,296649450,2136784728
2017-07-10,LG1,Others(HKUST),18,296,532490,16649224941,9753336246,26402561187
2017-07-10,LG1,Non-HKUST,34,138,235224,31432025377,6397907934,37829933311
2017-07-10,LG1,Total,805,6816,7119069,1059861058435,144707539884,1204568598319
2017-07-10,LG3,Staff,79,383,294707,45510379941,2536450390,48046830331
2017-07-10,LG3,TPG,32,304,408250,69049061640,3447162056,72496223696
2017-07-10,LG3,RPG,69,372,613203,46009142671,4487270033,50496412704
2017-07-10,LG3,UG,139,794,837925,168775569586,12520911560,181296481146
2017-07-10,LG3,Alumni,4,76,62939,42511898705,782033557,43293932262
2017-07-10,LG3,Others(HKUST),8,62,14908,371831053,905299548,1277130601
2017-07-10,LG3,Non-HKUST,13,29,13384,2156166528,179415248,2335581776
2017-07-10,LG3,Total,344,2020,2245316,374384050124,24858542392,399242592516
2017-07-10,LG4,Staff,143,464,307654,20776278341,8010407446,28786685787
2017-07-10,LG4,TPG,45,269,472530,56747080940,11942675973,68689756913
2017-07-10,LG4,RPG,142,575,620492,136217848476,18656210068,154874058544
2017-07-10,LG4,UG,275,1103,1107863,181257881136,17189994847,198447875983
2017-07-10,LG4,Alumni,5,37,18798,2943145864,604375720,3547521584
2017-07-10,LG4,Others(HKUST),15,179,63165,8364196811,4666043765,13030240576
2017-07-10,LG4,Non-HKUST,27,67,52194,3377571312,320385856,3697957168
2017-07-10,LG4,Total,652,2694,2642696,409684002880,61390093675,471074096555
2017-07-10,All-Floors,Staff,351,3413,3122903,259965462359,29578874684,289544337043
2017-07-10,All-Floors,TPG,159,2436,2653640,368537276670,51847053801,420384330471
2017-07-10,All-Floors,RPG,301,2745,2997082,396004146002,69388567093,465392713095
2017-07-10,All-Floors,UG,756,7605,8634894,1690644970271,142239409098,1832884379369
2017-07-10,All-Floors,Alumni,19,254,229616,50372410387,1786199511,52158609898
2017-07-10,All-Floors,Others(HKUST),36,981,982969,48656070041,26653085505,75309155546
2017-07-10,All-Floors,Non-HKUST,61,428,414292,45943959725,7732859915,53676819640
2017-07-10,All-Floors,Total,1683,17862,19035396,2860124295455,329226049607,3189350345062
2017-07-11,1,Staff,83,1004,1293991,42836418486,6508518966,49344937452
2017-07-11,1,TPG,13,174,151287,35889416176,1745101537,37634517713
2017-07-11,1,RPG,46,263,346428,37371643941,2029578627,39401222568
2017-07-11,1,UG,80,756,1059113,215933519735,12802962436,228736482171
2017-07-11,1,Alumni,1,1,0,754214907,56459406,810674313
2017-07-11,1,Others(HKUST),8,67,82314,13899475766,1617003339,15516479105
2017-07-11,1,Non-HKUST,15,112,140758,9779061964,1012597136,10791659100
2017-07-11,1,Total,246,2377,3073891,356463750975,25772221447,382235972422
2017-07-11,G,Staff,163,958,784665,59654158190,3980190197,63634348387
2017-07-11,G,TPG,64,459,527297,76620260589,7015753699,83636014288
2017-07-11,G,RPG,119,621,579552,70519774992,6533591012,77053366004
2017-07-11,G,UG,218,1095,1741888,194851485728,19631575088,214483060816
2017-07-11,G,Alumni,6,44,45492,3196501605,268035904,3464537509
2017-07-11,G,Others(HKUST),19,209,374280,23365447316,4569236646,27934683962
2017-07-11,G,Non-HKUST,34,153,140301,8584004747,1432809405,10016814152
2017-07-11,G,Total,623,3539,4193475,436791633167,43431191951,480222825118
2017-07-11,LG1,Staff,122,838,696021,55523947101,5938717982,61462665083
2017-07-11,LG1,TPG,60,552,685981,89949257892,7893656754,97842914646
2017-07-11,LG1,RPG,124,1207,1290878,141869742218,20837927094,162707669312
2017-07-11,LG1,UG,385,3854,4860423,1152875736760,100005992773,1252881729533
2017-07-11,LG1,Alumni,4,123,136861,4824456886,421664890,5246121776
2017-07-11,LG1,Others(HKUST),18,214,570236,10642214782,1748411679,12390626461
2017-07-11,LG1,Non-HKUST,37,240,291440,39387804953,3466519134,42854324087
2017-07-11,LG1,Total,750,7028,8531840,1495073160592,140312890306,1635386050898
2017-07-11,LG3,Staff,97,458,360151,21255785005,1827406320,23083191325
2017-07-11,LG3,TPG,28,275,534916,123361907203,7504049502,130865956705
2017-07-11,LG3,RPG,63,514,767729,103584866941,10133321830,113718188771
2017-07-11,LG3,UG,153,907,1055981,387423695352,19991728363,407415423715
2017-07-11,LG3,Alumni,7,50,73305,5871034125,329587195,6200621320
2017-07-11,LG3,Others(HKUST),10,64,51419,1826799932,618873775,2445673707
2017-07-11,LG3,Non-HKUST,8,26,27718,2238251803,281943841,2520195644
2017-07-11,LG3,Total,366,2294,2871219,645562340361,40686910826,686249251187
2017-07-11,LG4,Staff,134,480,260429,86086491864,5444385696,91530877560
2017-07-11,LG4,TPG,35,300,377157,169860897621,10678247310,180539144931
2017-07-11,LG4,RPG,141,462,440799,103654464144,5909410591,109563874735
2017-07-11,LG4,UG,250,868,932949,312093435502,35950196541,348043632043
2017-07-11,LG4,Alumni,6,41,48066,1992373872,198262359,2190636231
2017-07-11,LG4,Others(HKUST),16,64,3512,2084660279,1254306478,3338966757
2017-07-11,LG4,Non-HKUST,22,55,76342,2035828652,262386527,2298215179
2017-07-11,LG4,Total,604,2270,2139254,677808151934,59697195502,737505347436
2017-07-11,All-Floors,Staff,360,3738,3395257,265356800646,23699219161,289056019807
2017-07-11,All-Floors,TPG,103,1760,2276638,495681739481,34836808802,530518548283
2017-07-11,All-Floors,RPG,307,3067,3425386,457000492236,45443829154,502444321390
2017-07-11,All-Floors,UG,696,7480,9650354,2263177873077,188382455201,2451560328278
2017-07-11,All-Floors,Alumni,13,259,303724,16638581395,1274009754,17912591149
2017-07-11,All-Floors,Others(HKUST),34,618,1081761,51818598075,9807831917,61626429992
2017-07-11,All-Floors,Non-HKUST,72,586,676559,62024952119,6456256043,68481208162
2017-07-11,All-Floors,Total,1585,17508,20809679,3611699037029,309900410032,3921599447061
2017-07-12,1,Staff,86,1106,1147159,61420515345,4996270195,66416785540
2017-07-12,1,TPG,18,187,233934,13063458875,1401784710,14465243585
2017-07-12,1,RPG,31,321,409876,83858220893,15120364664,98978585557
2017-07-12,1,UG,85,636,943817,105776620799,7344504781,113121125580
2017-07-12,1,Alumni,1,5,1062,424460,126423,550883
2017-07-12,1,Others(HKUST),9,57,83155,4123781432,776035942,4899817374
2017-07-12,1,Non-HKUST,7,72,148142,3298640312,597583565,3896223877
2017-07-12,1,Total,237,2384,2967145,271541662116,30236670280,301778332396
2017-07-12,G,Staff,145,845,619474,25061618732,3380530900,28442149632
2017-07-12,G,TPG,60,450,616193,59405023650,7801661188,67206684838
2017-07-12,G,RPG,127,624,534885,148442986864,11183876175,159626863039
2017-07-12,G,UG,264,1230,1434842,290859526775,35166225999,326025752774
2017-07-12,G,Alumni,11,75,131385,659332472,304227436,963559908
2017-07-12,G,Others(HKUST),29,293,426963,30551367417,3569203315,34120570732
2017-07-12,G,Non-HKUST,17,47,21544,3204876153,345236532,3550112685
2017-07-12,G,Total,653,3564,3785286,558184732063,61750961545,619935693608
2017-07-12,LG1,Staff,101,575,494034,32931689732,3288374022,36220063754
2017-07-12,LG1,TPG,63,582,777475,167689440123,9787425486,177476865609
2017-07-12,LG1,RPG,112,872,968949,161385244622,15125844510,176511089132
2017-07-12,LG1,UG,416,3816,4585926,587129919456,69364435442,656494354898
2017-07-12,LG1,Alumni,6,22,24270,803592424,181553296,985145720
2017-07-12,LG1,Others(HKUST),24,150,467846,11179729319,2024157666,13203886985
2017-07-12,LG1,Non-HKUST,18,83,172749,10751949190,1189794750,11941743940
2017-07-12,LG1,Total,740,6100,7491249,971871564866,100961585172,1072833150038
2017-07-12,LG3,Staff,97,446,397641,41904759988,3933209410,45837969398
2017-07-12,LG3,TPG,24,215,273451,51384130444,7939879693,59324010137
2017-07-12,LG3,RPG,63,368,649361,54824659329,5503992226,60328651555
2017-07-12,LG3,UG,159,978,1044298,190300019497,16631474039,206931493536
2017-07-12,LG3,Alumni,6,71,89244,9597169758,493373669,10090543427
2017-07-12,LG3,Others(HKUST),9,135,116422,5571431968,401399070,5972831038
2017-07-12,LG3,Non-HKUST,9,15,8253,961233418,53310352,1014543770
2017-07-12,LG3,Total,367,2228,2578670,354543404402,34956638459,389500042861
2017-07-12,LG4,Staff,138,365,169741,14326089145,1620968574,15947057719
2017-07-12,LG4,TPG,33,335,479789,44950889684,2780483926,47731373610
2017-07-12,LG4,RPG,142,488,643440,93305783393,29907579695,123213363088
2017-07-12,LG4,UG,327,1215,1296023,195612815779,13280230548,208893046327
2017-07-12,LG4,Alumni,7,39,35374,3488338888,147024656,3635363544
2017-07-12,LG4,Others(HKUST),27,89,38721,2363706006,215467975,2579173981
2017-07-12,LG4,Non-HKUST,19,30,73052,6057626228,495827076,6553453304
2017-07-12,LG4,Total,693,2561,2736140,360105249123,48447582450,408552831573
2017-07-12,All-Floors,Staff,341,3337,2828049,175644672942,17219353101,192864026043
2017-07-12,All-Floors,TPG,106,1769,2380842,336492942776,29711235003,366204177779
2017-07-12,All-Floors,RPG,300,2673,3206511,541816895101,76841657270,618658552371
2017-07-12,All-Floors,UG,784,7875,9304906,1369678902306,141786870809,1511465773115
2017-07-12,All-Floors,Alumni,14,212,281335,14548858002,1126305480,15675163482
2017-07-12,All-Floors,Others(HKUST),52,724,1133107,53790016142,6986263968,60776280110
2017-07-12,All-Floors,Non-HKUST,53,247,423740,24274325301,2681752275,26956077576
2017-07-12,All-Floors,Total,1650,16837,19558490,2516246612570,276353437906,2792600050476
2017-07-13,1,Staff,76,934,1297699,102479992541,6432404241,108912396782
2017-07-13,1,TPG,10,152,164831,30527670891,1776875849,32304546740
2017-07-13,1,RPG,35,303,473860,100270226756,12196900088,112467126844
2017-07-13,1,UG,70,620,627678,89092305809,9352927247,98445233056
2017-07-13,1,Alumni,2,8,5768,481737827,71596774,553334601
2017-07-13,1,Others(HKUST),12,84,69165,6673080810,556266438,7229347248
2017-07-13,1,Non-HKUST,6,19,20040,718518075,44037719,762555794
2017-07-13,1,Total,211,2120,2659041,330243532709,30431008356,360674541065
2017-07-13,G,Staff,147,881,840188,32328896889,3167305321,35496202210
2017-07-13,G,TPG,63,520,519937,220382257728,11578411515,231960669243
2017-07-13,G,RPG,108,472,490709,40886035249,3138201477,44024236726
2017-07-13,G,UG,254,1405,1842858,352048055643,36322773915,388370829558
2017-07-13,G,Alumni,8,80,73207,541479216,51545235,593024451
2017-07-13,G,Others(HKUST),21,231,451320,31621285573,3146216172,34767501745
2017-07-13,G,Non-HKUST,14,75,61062,1663543124,576506144,2240049268
2017-07-13,G,Total,615,3664,4279281,679471553422,57980959779,737452513201
2017-07-13,LG1,Staff,112,637,539169,41011979459,2640771670,43652751129
2017-07-13,LG1,TPG,65,680,854471,148754303009,43458320407,192212623416
2017-07-13,LG1,RPG,101,782,959275,111814799072,10503594600,122318393672
2017-07-13,LG1,UG,377,3653,4127753,598825898820,68338982009,667164880829
2017-07-13,LG1,Alumni,6,41,54258,1282012776,106757122,1388769898
2017-07-13,LG1,Others(HKUST),21,215,554517,44577124205,4423195463,49000319668
2017-07-13,LG1,Non-HKUST,17,80,156893,5379322831,1281949876,6661272707
2017-07-13,LG1,Total,699,6088,7246336,951645440172,130753571147,1082399011319
2017-07-13,LG3,Staff,101,305,181248,8634072457,904147103,9538219560
2017-07-13,LG3,TPG,33,333,375094,53382964773,9267470664,62650435437
2017-07-13,LG3,RPG,57,291,525513,34604973172,3521160371,38126133543
2017-07-13,LG3,UG,151,811,771492,160357764892,9811435768,170169200660
2017-07-13,LG3,Alumni,6,28,64092,3809961121,2172696502,5982657623
2017-07-13,LG3,Others(HKUST),14,180,119570,19851191385,2710153976,22561345361
2017-07-13,LG3,Non-HKUST,7,19,41909,728673074,112421819,841094893
2017-07-13,LG3,Total,369,1967,2078918,281369600874,28499486203,309869087077
2017-07-13,LG4,Staff,140,371,182200,166324259919,4364706900,170688966819
2017-07-13,LG4,TPG,40,334,521148,67009484951,6635268839,73644753790
2017-07-13,LG4,RPG,106,505,632273,79151264558,7714963681,86866228239
2017-07-13,LG4,UG,218,839,719551,130328091400,10545302478,140873393878
2017-07-13,LG4,Alumni,6,22,25053,783241421,132432710,915674131
2017-07-13,LG4,Others(HKUST),26,104,60893,5945373190,716570288,6661943478
2017-07-13,LG4,Non-HKUST,13,22,21717,269190686,32692454,301883140
2017-07-13,LG4,Total,549,2197,2162835,449810906125,30141937350,479952843475
2017-07-13,All-Floors,Staff,365,3128,3040504,350779201265,17509335235,368288536500
2017-07-13,All-Floors,TPG,104,2019,2435481,520056681352,72716347274,592773028626
2017-07-13,All-Floors,RPG,257,2353,3081630,366727298807,37074820217,403802119024
2017-07-13,All-Floors,UG,695,7328,8089332,1330652116564,134371421417,1465023537981
2017-07-13,All-Floors,Alumni,13,179,222378,6898432361,2535028343,9433460704
2017-07-13,All-Floors,Others(HKUST),42,814,1255465,108668055163,11552402337,120220457500
2017-07-13,All-Floors,Non-HKUST,45,215,301621,8759247790,2047608012,10806855802
2017-07-13,All-Floors,Total,1521,16036,18426411,2692541033302,277806962835,2970347996137
2017-07-14,1,Staff,65,792,1075806,27080556171,2731835709,29812391880
2017-07-14,1,TPG,15,200,279124,51963198437,2674118359,54637316796
2017-07-14,1,RPG,17,149,263113,29451046520,30821439461,60272485981
2017-07-14,1,UG,73,512,748164,103120648623,11573307529,114693956152
2017-07-14,1,Alumni,2,32,39659,5125982083,175306660,5301288743
2017-07-14,1,Others(HKUST),10,54,70790,4486365454,474469699,4960835153
2017-07-14,1,Non-HKUST,8,37,88043,10231410232,1068714647,11300124879
2017-07-14,1,Total,190,1776,2564699,231459207520,49519192064,280978399584
2017-07-14,G,Staff,142,791,740895,32692439083,5503116591,38195555674
2017-07-14,G,TPG,51,275,407476,46796982220,5225797527,52022779747
2017-07-14,G,RPG,98,354,430390,27808812185,2594274228,30403086413
2017-07-14,G,UG,241,931,1381820,217490833568,33451917016,250942750584
2017-07-14,G,Alumni,11,76,116773,555494907,898694478,1454189385
2017-07-14,G,Others(HKUST),21,173,491316,31604969453,2512210416,34117179869
2017-07-14,G,Non-HKUST,16,68,56839,8968582734,782604597,9751187331
2017-07-14,G,Total,580,2668,3625509,365918114150,50968614853,416886729003
2017-07-14,LG1,Staff,97,641,556349,66712265958,5980489657,72692755615
2017-07-14,LG1,TPG,68,726,1069694,112838605003,11206586681,124045191684
2017-07-14,LG1,RPG,100,768,822154,109570773259,11308741115,120879514374
2017-07-14,LG1,UG,395,3104,4037497,608095049212,68074427556,676169476768
2017-07-14,LG1,Alumni,11,57,52496,1853580243,1729329598,3582909841
2017-07-14,LG1,Others(HKUST),27,230,636808,23691526134,2382268998,26073795132
2017-07-14,LG1,Non-HKUST,21,104,142156,18200187316,1584868045,19785055361
2017-07-14,LG1,Total,719,5630,7317154,940961987125,102266711650,1043228698775
2017-07-14,LG3,Staff,82,356,287176,11633676035,928039959,12561715994
2017-07-14,LG3,TPG,30,152,398203,39749344355,2948342675,42697687030
2017-07-14,LG3,RPG,53,326,539708,66249037723,4095896734,70344934457
2017-07-14,LG3,UG,128,550,697171,139725546800,25517085073,165242631873
2017-07-14,LG3,Alumni,11,81,77298,5711061450,1711835069,7422896519
2017-07-14,LG3,Others(HKUST),18,100,54020,19498423181,3543246012,23041669193
2017-07-14,LG3,Non-HKUST,10,19,15590,622318597,325824916,948143513
2017-07-14,LG3,Total,332,1584,2069166,283189408141,39070270438,322259678579
2017-07-14,LG4,Staff,103,323,202935,37596210561,4005661511,41601872072
2017-07-14,LG4,TPG,37,272,409789,189035177896,9033550843,198068728739
2017-07-14,LG4,RPG,121,446,604015,103933646856,10076748133,114010394989
2017-07-14,LG4,UG,236,736,798642,128141243235,7208948560,135350191795
2017-07-14,LG4,Alumni,8,36,65892,7555643597,233858337,7789501934
2017-07-14,LG4,Others(HKUST),15,88,32029,15626571146,2247096261,17873667407
2017-07-14,LG4,Non-HKUST,25,53,20660,1254504265,502306473,1756810738
2017-07-14,LG4,Total,545,1954,2133962,483142997556,33308170118,516451167674
2017-07-14,All-Floors,Staff,300,2903,2863161,175715147808,19149143427,194864291235
2017-07-14,All-Floors,TPG,103,1625,2564286,440383307911,31088396085,471471703996
2017-07-14,All-Floors,RPG,254,2043,2659380,337013316543,58897099671,395910416214
2017-07-14,All-Floors,UG,737,5833,7663294,1196573321438,145825685734,1342399007172
2017-07-14,All-Floors,Alumni,20,282,352118,20801762280,4749024142,25550786422
2017-07-14,All-Floors,Others(HKUST),50,645,1284963,94907855368,11159291386,106067146754
2017-07-14,All-Floors,Non-HKUST,57,281,323288,39277003144,4264318678,43541321822
2017-07-14,All-Floors,Total,1521,13612,17710490,2304671714492,275132959123,2579804673615
2017-07-15,1,Staff,15,205,301989,3032644868,280280696,3312925564
2017-07-15,1,TPG,7,155,117809,20653775848,1484386942,22138162790
2017-07-15,1,RPG,21,102,142965,12530810152,881885781,13412695933
2017-07-15,1,UG,45,210,285959,42256227383,2606890316,44863117699
2017-07-15,1,Alumni,9,61,119057,4447539823,290010422,4737550245
2017-07-15,1,Others(HKUST),8,72,95796,12667530822,2180073048,14847603870
2017-07-15,1,Non-HKUST,2,61,36509,2158323010,152109332,2310432342
2017-07-15,1,Total,107,866,1100084,97746851906,7875636537,105622488443
2017-07-15,G,Staff,44,161,165312,20677334027,799716100,21477050127
2017-07-15,G,TPG,59,288,406966,45320197346,3584854854,48905052200
2017-07-15,G,RPG,59,157,166011,19712145613,2193843409,21905989022
2017-07-15,G,UG,164,680,1288682,143088792649,13448743986,156537536635
2017-07-15,G,Alumni,23,106,152845,4207484123,482340342,4689824465
2017-07-15,G,Others(HKUST),14,106,344907,33578330754,3393437906,36971768660
2017-07-15,G,Non-HKUST,15,46,25157,3185065027,108867048,3293932075
2017-07-15,G,Total,378,1544,2549880,269769349539,24011803645,293781153184
2017-07-15,LG1,Staff,30,202,150851,9458433483,1544729957,11003163440
2017-07-15,LG1,TPG,72,559,698149,82935438704,18437356817,101372795521
2017-07-15,LG1,RPG,60,493,580276,239387213995,29567372401,268954586396
2017-07-15,LG1,UG,242,2249,3072655,549540956112,58637248744,608178204856
2017-07-15,LG1,Alumni,13,95,107037,10442573782,1045228212,11487801994
2017-07-15,LG1,Others(HKUST),12,77,500366,10876055128,1147474892,12023530020
2017-07-15,LG1,Non-HKUST,12,67,132026,18348456182,1155554464,19504010646
2017-07-15,LG1,Total,441,3742,5241360,920989127386,111534965487,1032524092873
2017-07-15,LG3,Staff,46,192,287752,21003749589,5974804526,26978554115
2017-07-15,LG3,TPG,26,258,398159,42827972770,3774021062,46601993832
2017-07-15,LG3,RPG,42,189,326281,21825438008,8430429239,30255867247
2017-07-15,LG3,UG,115,514,635110,108891554848,6691776848,115583331696
2017-07-15,LG3,Alumni,10,37,35147,3452474771,668559135,4121033906
2017-07-15,LG3,Others(HKUST),3,8,5637,133116936,14944754,148061690
2017-07-15,LG3,Non-HKUST,5,7,711,223731659,21070553,244802212
2017-07-15,LG3,Total,247,1205,1688797,198358038581,25575606117,223933644698
2017-07-15,LG4,Staff,38,77,60509,9992624030,895689048,10888313078
2017-07-15,LG4,TPG,32,310,469366,89136906489,12850836152,101987742641
2017-07-15,LG4,RPG,88,313,477398,42377615773,3448372743,45825988516
2017-07-15,LG4,UG,178,705,697765,84735580174,11899105597,96634685771
2017-07-15,LG4,Alumni,12,85,136918,31460550076,1060237312,32520787388
2017-07-15,LG4,Others(HKUST),12,69,41359,10322816280,561179349,10883995629
2017-07-15,LG4,Non-HKUST,14,110,98475,11213743682,578886906,11792630588
2017-07-15,LG4,Total,374,1669,1981790,279239836504,31294307107,310534143611
2017-07-15,All-Floors,Staff,125,837,966413,64164785997,9495220327,73660006324
2017-07-15,All-Floors,TPG,102,1570,2090449,280874291157,40131455827,321005746984
2017-07-15,All-Floors,RPG,174,1254,1692931,335833223541,44521903573,380355127114
2017-07-15,All-Floors,UG,477,4358,5980171,928513111166,93283765491,1021796876657
2017-07-15,All-Floors,Alumni,40,384,551004,54010622575,3546375423,57556997998
2017-07-15,All-Floors,Others(HKUST),29,332,988065,67577849920,7297109949,74874959869
2017-07-15,All-Floors,Non-HKUST,32,291,292878,35129319560,2016488303,37145807863
2017-07-15,All-Floors,Total,979,9026,12561911,1766103203916,200292318893,1966395522809
2017-07-16,1,Staff,13,203,231535,338898639,29181911,368080550
2017-07-16,1,TPG,9,157,185689,52074215667,2509661459,54583877126
2017-07-16,1,RPG,16,52,37791,6130404314,546708039,6677112353
2017-07-16,1,UG,38,255,491814,40524484760,3767290985,44291775745
2017-07-16,1,Alumni,3,16,18710,5480007635,163012580,5643020215
2017-07-16,1,Others(HKUST),5,7,359,1289028,440846,1729874
2017-07-16,1,Non-HKUST,7,33,105475,6343931772,333225077,6677156849
2017-07-16,1,Total,91,723,1071373,110893231815,7349520897,118242752712
2017-07-16,G,Staff,24,124,111709,3230148136,272575412,3502723548
2017-07-16,G,TPG,43,233,346160,58533512270,4439334557,62972846827
2017-07-16,G,RPG,31,75,52861,16288832943,4361260462,20650093405
2017-07-16,G,UG,133,565,1070899,148192367139,18001685313,166194052452
2017-07-16,G,Alumni,11,37,44382,19302167485,444091269,19746258754
2017-07-16,G,Others(HKUST),9,38,335553,14811394589,771852181,15583246770
2017-07-16,G,Non-HKUST,9,20,29631,409646455,79748861,489395316
2017-07-16,G,Total,260,1092,1991195,260768069017,28370548055,289138617072
2017-07-16,LG1,Staff,24,139,110017,2660049721,278556264,2938605985
2017-07-16,LG1,TPG,43,298,278075,36972293177,17667260591,54639553768
2017-07-16,LG1,RPG,44,250,377681,58592613861,13663113414,72255727275
2017-07-16,LG1,UG,206,1782,2711418,380369919342,57647182046,438017101388
2017-07-16,LG1,Alumni,12,71,132505,13300877375,722306548,14023183923
2017-07-16,LG1,Others(HKUST),8,26,461514,3663669948,535080607,4198750555
2017-07-16,LG1,Non-HKUST,15,136,170649,17852094019,3485641943,21337735962
2017-07-16,LG1,Total,352,2702,4241859,513411517443,93999141413,607410658856
2017-07-16,LG3,Staff,25,96,210663,16399578144,473214567,16872792711
2017-07-16,LG3,TPG,12,121,165419,9655539697,4425759377,14081299074
2017-07-16,LG3,RPG,32,144,228090,42079314045,9869614694,51948928739
2017-07-16,LG3,UG,92,461,584173,120352266374,8638849255,128991115629
2017-07-16,LG3,Alumni,10,66,79095,7558499707,1204490324,8762990031
2017-07-16,LG3,Others(HKUST),4,14,17769,3547897097,187567372,3735464469
2017-07-16,LG3,Non-HKUST,3,14,35174,2233169413,116978831,2350148244
2017-07-16,LG3,Total,178,916,1320383,201826264477,24916474420,226742738897
2017-07-16,LG4,Staff,25,55,27721,912707903,63551954,976259857
2017-07-16,LG4,TPG,23,134,280801,49858361239,2369764440,52228125679
2017-07-16,LG4,RPG,74,199,259430,33327307560,6503156138,39830463698
2017-07-16,LG4,UG,175,530,455282,92040036992,11850456371,103890493363
2017-07-16,LG4,Alumni,8,26,52028,5888285081,2141850464,8030135545
2017-07-16,LG4,Others(HKUST),13,23,1667,5603694561,355127056,5958821617
2017-07-16,LG4,Non-HKUST,13,40,25314,3515003621,200010636,3715014257
2017-07-16,LG4,Total,331,1007,1102243,191145396957,23483917059,214629314016
2017-07-16,All-Floors,Staff,74,617,691645,23541382543,1117080108,24658462651
2017-07-16,All-Floors,TPG,74,943,1256144,207093922050,31411780424,238505702474
2017-07-16,All-Floors,RPG,145,720,955853,156418472723,34943852747,191362325470
2017-07-16,All-Floors,UG,441,3593,5313586,781479074607,99905463970,881384538577
2017-07-16,All-Floors,Alumni,22,216,326720,51529837283,4675751185,56205588468
2017-07-16,All-Floors,Others(HKUST),26,108,816862,27627945223,1850068062,29478013285
2017-07-16,All-Floors,Non-HKUST,34,243,366243,30353845280,4215605348,34569450628
2017-07-16,All-Floors,Total,816,6440,9727053,1278044479709,178119601844,1456164081553
2017-07-17,1,Staff,73,852,1228448,30621024433,7400738707,38021763140
2017-07-17,1,TPG,13,222,252841,25372033371,1562516540,26934549911
2017-07-17,1,RPG,25,225,287952,69677893216,7895962929,77573856145
2017-07-17,1,UG,89,771,935748,133876070183,15591839347,149467909530
2017-07-17,1,Alumni,2,7,15929,623920300,129636585,753556885
2017-07-17,1,Others(HKUST),9,78,60535,14286048683,1436036620,15722085303
2017-07-17,1,Non-HKUST,4,21,18307,824068476,63556688,887625164
2017-07-17,1,Total,215,2176,2799760,275281058662,34080287416,309361346078
2017-07-17,G,Staff,155,848,717697,26895350658,3826704950,30722055608
2017-07-17,G,TPG,64,428,617345,63091535073,8184947028,71276482101
2017-07-17,G,RPG,104,546,530886,115241868728,14289312637,129531181365
2017-07-17,G,UG,257,1198,1649497,202328929804,24578752427,226907682231
2017-07-17,G,Alumni,8,86,64536,2891371831,840021188,3731393019
2017-07-17,G,Others(HKUST),25,114,371015,12408602421,958559196,13367161617
2017-07-17,G,Non-HKUST,17,42,38324,2635835250,410555652,3046390902
2017-07-17,G,Total,630,3262,3989300,425493493765,53088853078,478582346843
2017-07-17,LG1,Staff,115,674,408551,46446698204,4244231892,50690930096
2017-07-17,LG1,TPG,58,503,601190,95347379900,6914406873,102261786773
2017-07-17,LG1,RPG,104,744,748428,101776025556,8801571226,110577596782
2017-07-17,LG1,UG,400,3539,4196040,523458106934,154685223514,678143330448
2017-07-17,LG1,Alumni,5,27,30057,763256614,85935224,849191838
2017-07-17,LG1,Others(HKUST),21,124,568774,9814188637,1088343759,10902532396
2017-07-17,LG1,Non-HKUST,22,148,142529,9431015028,987568184,10418583212
2017-07-17,LG1,Total,725,5759,6695569,787036670873,176807280672,963843951545
2017-07-17,LG3,Staff,86,410,316925,45694289876,2007206200,47701496076
2017-07-17,LG3,TPG,33,387,568666,81151724558,18779075432,99930799990
2017-07-17,LG3,RPG,62,547,910100,66176157446,6817187632,72993345078
2017-07-17,LG3,UG,129,723,908466,178459904466,16461451092,194921355558
2017-07-17,LG3,Alumni,3,62,80749,7515094383,901836476,8416930859
2017-07-17,LG3,Others(HKUST),9,44,47499,5707757740,243269124,5951026864
2017-07-17,LG3,Non-HKUST,9,38,55199,3965741941,587080174,4552822115
2017-07-17,LG3,Total,331,2211,2887604,388670670410,45797106130,434467776540
2017-07-17,LG4,Staff,171,473,223737,30983623618,11523800535,42507424153
2017-07-17,LG4,TPG,33,189,245868,39945203486,6764600543,46709804029
2017-07-17,LG4,RPG,180,778,667984,98731609283,9913276950,108644886233
2017-07-17,LG4,UG,349,850,561807,104842167507,25273744739,130115912246
2017-07-17,LG4,Alumni,10,47,35709,1039164294,61603306,1100767600
2017-07-17,LG4,Others(HKUST),29,85,23307,7783325278,325964603,8109289881
2017-07-17,LG4,Non-HKUST,31,77,59378,6457394724,401351587,6858746311
2017-07-17,LG4,Total,803,2499,1817790,289782488190,54264342263,344046830453
2017-07-17,All-Floors,Staff,360,3257,2895358,180640986789,29002682284,209643669073
2017-07-17,All-Floors,TPG,99,1729,2285910,304907876388,42205546416,347113422804
2017-07-17,All-Floors,RPG,317,2840,3145350,451603554229,47717311374,499320865603
2017-07-17,All-Floors,UG,799,7081,8251558,1142965178894,236591011119,1379556190013
2017-07-17,All-Floors,Alumni,14,229,226980,12832807422,2019032779,14851840201
2017-07-17,All-Floors,Others(HKUST),59,445,1071130,49999922759,4052173302,54052096061
2017-07-17,All-Floors,Non-HKUST,61,326,313737,23314055419,2450112285,25764167704
2017-07-17,All-Floors,Total,1709,15907,18190023,2166264381900,364037869559,2530302251459
2017-07-18,1,Staff,73,927,1094675,58965406740,9438103502,68403510242
2017-07-18,1,TPG,17,309,394930,27592471487,1330650896,28923122383
2017-07-18,1,RPG,23,90,205271,8779663269,513048879,9292712148
2017-07-18,1,UG,78,689,971395,72331589256,6056313391,78387902647
2017-07-18,1,Alumni,1,1,0,80143,100668,180811
2017-07-18,1,Others(HKUST),39,174,60416,8743008138,3134335727,11877343865
2017-07-18,1,Non-HKUST,8,59,83702,2008515800,103767454,2112283254
2017-07-18,1,Total,239,2249,2810389,178420734833,20576320517,198997055350
2017-07-18,G,Staff,143,826,780517,23858538866,5181425529,29039964395
2017-07-18,G,TPG,57,396,527728,103369954583,5519344925,108889299508
2017-07-18,G,RPG,98,401,449364,35865728183,3541924049,39407652232
2017-07-18,G,UG,253,1235,1641939,319222632639,27508437611,346731070250
2017-07-18,G,Alumni,6,51,50814,1819731524,411292453,2231023977
2017-07-18,G,Others(HKUST),61,683,467624,49714139271,9460842673,59174981944
2017-07-18,G,Non-HKUST,22,83,68346,19859063647,700327374,20559391021
2017-07-18,G,Total,640,3675,3986332,553709788713,52323594614,606033383327
2017-07-18,LG1,Staff,114,636,450753,25377676582,8644413419,34022090001
2017-07-18,LG1,TPG,58,507,504768,71490711261,9076528132,80567239393
2017-07-18,LG1,RPG,99,816,664338,157255031868,17238379269,174493411137
2017-07-18,LG1,UG,372,3594,4413101,643362809512,80056131852,723418941364
2017-07-18,LG1,Alumni,3,28,39479,307259910,64779103,372039013
2017-07-18,LG1,Others(HKUST),46,291,526622,8797925329,3920644829,12718570158
2017-07-18,LG1,Non-HKUST,22,176,275336,31659439790,2627846098,34287285888
2017-07-18,LG1,Total,714,6048,6874397,938250854252,121628722702,1059879576954
2017-07-18,LG3,Staff,95,462,298968,53397512543,3854117060,57251629603
2017-07-18,LG3,TPG,23,322,536251,55132403634,6075490035,61207893669
2017-07-18,LG3,RPG,52,492,763956,65025437772,8312510045,73337947817
2017-07-18,LG3,UG,154,938,1234183,232898890529,38014796261,270913686790
2017-07-18,LG3,Alumni,2,15,76076,1721591933,146507550,1868099483
2017-07-18,LG3,Others(HKUST),21,47,20143,1674456952,169066473,1843523425
2017-07-18,LG3,Non-HKUST,5,20,37151,22207139561,6237784380,28444923941
2017-07-18,LG3,Total,352,2296,2966728,432057432924,62810271804,494867704728
2017-07-18,LG4,Staff,172,380,102820,24165312299,3406407036,27571719335
2017-07-18,LG4,TPG,33,292,358061,46663501986,3894840356,50558342342
2017-07-18,LG4,RPG,183,601,649326,58444056701,6671742084,65115798785
2017-07-18,LG4,UG,335,1016,770567,196176867397,23183315104,219360182501
2017-07-18,LG4,Alumni,5,37,47965,1637889178,107434644,1745323822
2017-07-18,LG4,Others(HKUST),58,201,11517,5343141499,2502100240,7845241739
2017-07-18,LG4,Non-HKUST,27,53,48601,7004956292,360896778,7365853070
2017-07-18,LG4,Total,813,2580,1988857,339435725352,40126736242,379562461594
2017-07-18,All-Floors,Staff,359,3231,2727733,185764447030,30524466546,216288913576
2017-07-18,All-Floors,TPG,106,1826,2321738,304249042951,25896854344,330145897295
2017-07-18,All-Floors,RPG,306,2400,2732255,325369917793,36277604326,361647522119
2017-07-18,All-Floors,UG,751,7472,9031185,1463992789333,174818994219,1638811783552
2017-07-18,All-Floors,Alumni,14,132,214334,5486552688,730114418,6216667106
2017-07-18,All-Floors,Others(HKUST),90,1396,1086322,74272671189,19186989942,93459661131
2017-07-18,All-Floors,Non-HKUST,65,391,513136,82739115090,10030622084,92769737174
2017-07-18,All-Floors,Total,1691,16848,18626703,2441874536074,297465645879,2739340181953
2017-07-19,1,Staff,95,1036,1300630,28170408762,3371719719,31542128481
2017-07-19,1,TPG,22,350,504915,83332411252,7724189367,91056600619
2017-07-19,1,RPG,31,136,233863,17193494078,1321636156,18515130234
2017-07-19,1,UG,89,541,715938,76999644435,5773398082,82773042517
2017-07-19,1,Alumni,0,0,0,0,0,0
2017-07-19,1,Others(HKUST),13,78,57862,3873350435,537553571,4410904006
2017-07-19,1,Non-HKUST,4,32,64470,5032227917,555133772,5587361689
2017-07-19,1,Total,254,2173,2877678,214601536879,19283630667,233885167546
2017-07-19,G,Staff,149,891,652681,14695170723,2308200501,17003371224
2017-07-19,G,TPG,76,607,895427,114185759992,6685314493,120871074485
2017-07-19,G,RPG,96,567,560884,69962139802,6510917596,76473057398
2017-07-19,G,UG,307,1323,1427496,159428598879,14102726881,173531325760
2017-07-19,G,Alumni,12,52,22242,1552986657,588103537,2141090194
2017-07-19,G,Others(HKUST),38,170,429593,23452340845,2330325571,25782666416
2017-07-19,G,Non-HKUST,12,58,73987,7707052316,562750188,8269802504
2017-07-19,G,Total,690,3668,4062310,390984049214,33088338767,424072387981
2017-07-19,LG1,Staff,117,590,375371,23919441798,3155386980,27074828778
2017-07-19,LG1,TPG,76,773,836565,112980261927,21680142432,134660404359
2017-07-19,LG1,RPG,118,820,646275,128545673041,26831386676,155377059717
2017-07-19,LG1,UG,426,3581,4284271,628200174306,69946197567,698146371873
2017-07-19,LG1,Alumni,6,24,26575,559633647,85438138,645071785
2017-07-19,LG1,Others(HKUST),24,119,547677,21037899143,20114367387,41152266530
2017-07-19,LG1,Non-HKUST,11,32,48997,5693173794,433239487,6126413281
2017-07-19,LG1,Total,778,5939,6765731,920936257656,142246158667,1063182416323
2017-07-19,LG3,Staff,91,442,261362,37691412355,2545868953,40237281308
2017-07-19,LG3,TPG,29,256,521259,95448391889,9180375593,104628767482
2017-07-19,LG3,RPG,91,629,919308,63609334139,8629777860,72239111999
2017-07-19,LG3,UG,147,604,678769,118233568526,6825005814,125058574340
2017-07-19,LG3,Alumni,6,88,114013,7543487129,955166779,8498653908
2017-07-19,LG3,Others(HKUST),17,68,41066,3042113252,1303552804,4345666056
2017-07-19,LG3,Non-HKUST,4,17,41967,1109468715,105840147,1215308862
2017-07-19,LG3,Total,385,2104,2577744,326677776005,29545587950,356223363955
2017-07-19,LG4,Staff,169,455,225047,20397933822,4489281492,24887215314
2017-07-19,LG4,TPG,44,263,451821,37870387551,4761591826,42631979377
2017-07-19,LG4,RPG,197,663,712845,73909082206,9982708229,83891790435
2017-07-19,LG4,UG,415,1217,797175,142112059307,13104659818,155216719125
2017-07-19,LG4,Alumni,8,84,44724,3708026668,379829518,4087856186
2017-07-19,LG4,Others(HKUST),36,130,72689,3111391650,697285142,3808676792
2017-07-19,LG4,Non-HKUST,13,44,46886,2776189466,1144579289,3920768755
2017-07-19,LG4,Total,882,2856,2351187,283885070670,34559935314,318445005984
2017-07-19,All-Floors,Staff,390,3414,2815091,124874367460,15870457645,140744825105
2017-07-19,All-Floors,TPG,135,2249,3209987,443817212611,50031613711,493848826322
2017-07-19,All-Floors,RPG,332,2815,3073175,353219723266,53276426517,406496149783
2017-07-19,All-Floors,UG,933,7266,7903649,1124974045453,109751988162,1234726033615
2017-07-19,All-Floors,Alumni,16,248,207554,13364134101,2008537972,15372672073
2017-07-19,All-Floors,Others(HKUST),71,565,1148887,54517095325,24983084475,79500179800
2017-07-19,All-Floors,Non-HKUST,28,183,276307,22318112208,2801542883,25119655091
2017-07-19,All-Floors,Total,1905,16740,18634650,2137084690424,258723651365,2395808341789
2017-07-20,1,Staff,72,809,1188082,19462375737,3941573489,23403949226
2017-07-20,1,TPG,20,329,537960,69779524624,3550208328,73329732952
2017-07-20,1,RPG,46,248,384287,22505444191,11228842710,33734286901
2017-07-20,1,UG,67,605,703306,168167754060,11726599210,179894353270
2017-07-20,1,Alumni,2,28,49338,2256399901,143807893,2400207794
2017-07-20,1,Others(HKUST),15,84,122673,5217195684,430970477,5648166161
2017-07-20,1,Non-HKUST,4,12,7544,461507861,24994012,486501873
2017-07-20,1,Total,226,2115,2993190,287850202058,31046996119,318897198177
2017-07-20,G,Staff,127,742,576743,113079439378,5201419779,118280859157
2017-07-20,G,TPG,60,312,378315,27142978845,1771600219,28914579064
2017-07-20,G,RPG,106,640,757470,140490879568,26074468193,166565347761
2017-07-20,G,UG,208,1195,1620778,382271685359,24332566816,406604252175
2017-07-20,G,Alumni,8,32,10213,5696283296,2101356232,7797639528
2017-07-20,G,Others(HKUST),36,128,358523,21051260603,2434071189,23485331792
2017-07-20,G,Non-HKUST,13,52,49491,4209294754,197417051,4406711805
2017-07-20,G,Total,558,3101,3751533,693941821803,62112899479,756054721282
2017-07-20,LG1,Staff,123,627,470759,34351745159,3012163194,37363908353
2017-07-20,LG1,TPG,50,414,516790,67526564124,6250387471,73776951595
2017-07-20,LG1,RPG,97,719,757556,107263219693,20810125901,128073345594
2017-07-20,LG1,UG,325,2964,3743051,655972546461,57094874011,713067420472
2017-07-20,LG1,Alumni,8,30,27357,7509955765,3148057369,10658013134
2017-07-20,LG1,Others(HKUST),21,73,511835,4337407010,848808183,5186215193
2017-07-20,LG1,Non-HKUST,9,68,34590,820303456,421952748,1242256204
2017-07-20,LG1,Total,633,4895,6061938,877781741668,91586368877,969368110545
2017-07-20,LG3,Staff,91,432,310707,33836578185,2770539897,36607118082
2017-07-20,LG3,TPG,27,257,442232,66579682677,2961245803,69540928480
2017-07-20,LG3,RPG,62,496,603529,62695878730,8693194527,71389073257
2017-07-20,LG3,UG,119,747,863434,189966083458,23760619496,213726702954
2017-07-20,LG3,Alumni,7,97,188149,27709008963,2003603405,29712612368
2017-07-20,LG3,Others(HKUST),19,95,131430,16755556284,759540682,17515096966
2017-07-20,LG3,Non-HKUST,3,5,237,65697100,82825751,148522851
2017-07-20,LG3,Total,328,2129,2539718,397608485397,41031569561,438640054958
2017-07-20,LG4,Staff,139,354,163758,16005445215,1349601097,17355046312
2017-07-20,LG4,TPG,32,201,255633,51469184481,6124255202,57593439683
2017-07-20,LG4,RPG,110,551,668673,78208520428,8445214649,86653735077
2017-07-20,LG4,UG,190,663,562716,96211761795,10139439220,106351201015
2017-07-20,LG4,Alumni,8,37,32367,33498112127,389256254,33887368381
2017-07-20,LG4,Others(HKUST),26,67,16235,6455550281,391435405,6846985686
2017-07-20,LG4,Non-HKUST,9,30,38338,1158999333,86218675,1245218008
2017-07-20,LG4,Total,514,1903,1737720,283007573660,26925420502,309932994162
2017-07-20,All-Floors,Staff,342,2964,2710049,216735583674,16275297456,233010881130
2017-07-20,All-Floors,TPG,101,1513,2130930,282497934751,20657697023,303155631774
2017-07-20,All-Floors,RPG,266,2654,3171515,411163942610,75251845980,486415788590
2017-07-20,All-Floors,UG,582,6174,7493285,1492589831133,127054098753,1619643929886
2017-07-20,All-Floors,Alumni,14,224,307424,76669760052,7786081153,84455841205
2017-07-20,All-Floors,Others(HKUST),65,447,1140696,53816969862,4864825936,58681795798
2017-07-20,All-Floors,Non-HKUST,28,167,130200,6715802504,813408237,7529210741
2017-07-20,All-Floors,Total,1398,14143,17084099,2540189824586,252703254538,2792893079124
2017-07-21,1,Staff,71,854,1113046,45368594370,3162266592,48530860962
2017-07-21,1,TPG,38,717,915974,82280300808,29560739388,111841040196
2017-07-21,1,RPG,40,248,291298,14974867645,1774859925,16749727570
2017-07-21,1,UG,71,551,679395,126792807820,8007264692,134800072512
2017-07-21,1,Alumni,1,13,50547,2824372440,159027154,2983399594
2017-07-21,1,Others(HKUST),9,45,84683,8551906748,482709467,9034616215
2017-07-21,1,Non-HKUST,5,32,45691,15577269544,2568275191,18145544735
2017-07-21,1,Total,235,2460,3180634,296370119375,45715142409,342085261784
2017-07-21,G,Staff,120,856,632726,42390302172,5809709188,48200011360
2017-07-21,G,TPG,80,615,734475,57958090177,14263831040,72221921217
2017-07-21,G,RPG,101,513,569704,37709025251,3320053467,41029078718
2017-07-21,G,UG,202,850,1331690,152541344414,15939790044,168481134458
2017-07-21,G,Alumni,9,62,40352,814390805,1875197467,2689588272
2017-07-21,G,Others(HKUST),26,147,375534,20251033747,1588660953,21839694700
2017-07-21,G,Non-HKUST,12,33,30161,10352647349,1712908189,12065555538
2017-07-21,G,Total,550,3076,3714642,322016833915,44510150348,366526984263
2017-07-21,LG1,Staff,83,537,356056,22151461016,1747825902,23899286918
2017-07-21,LG1,TPG,84,722,874837,192156619463,21092447216,213249066679
2017-07-21,LG1,RPG,97,839,848745,103882059163,7998393328,111880452491
2017-07-21,LG1,UG,296,2776,3713415,629385971233,38407183014,667793154247
2017-07-21,LG1,Alumni,4,28,46789,2465823670,3963308015,6429131685
2017-07-21,LG1,Others(HKUST),15,54,496848,1953461648,815490005,2768951653
2017-07-21,LG1,Non-HKUST,7,32,27754,200687041,41425105,242112146
2017-07-21,LG1,Total,586,4988,6364444,952196083234,74066072585,1026262155819
2017-07-21,LG3,Staff,64,291,313001,17378693497,1516005300,18894698797
2017-07-21,LG3,TPG,28,317,493212,41988849348,2349015498,44337864846
2017-07-21,LG3,RPG,59,462,546257,108624797427,13262642343,121887439770
2017-07-21,LG3,UG,108,453,624792,115569877395,4946081043,120515958438
2017-07-21,LG3,Alumni,2,21,34830,1431292496,62287315,1493579811
2017-07-21,LG3,Others(HKUST),16,72,60139,5533768090,353919820,5887687910
2017-07-21,LG3,Non-HKUST,3,5,2391,149331737,12310068,161641805
2017-07-21,LG3,Total,280,1621,2074622,290676609990,22502261387,313178871377
2017-07-21,LG4,Staff,115,300,177875,25388226753,6176043133,31564269886
2017-07-21,LG4,TPG,36,221,354945,42631748452,11202968258,53834716710
2017-07-21,LG4,RPG,121,564,642064,59671214588,4489494130,64160708718
2017-07-21,LG4,UG,199,682,640609,128562233633,47196490594,175758724227
2017-07-21,LG4,Alumni,4,19,19051,441875471,50818882,492694353
2017-07-21,LG4,Others(HKUST),14,59,25042,3094815549,211094817,3305910366
2017-07-21,LG4,Non-HKUST,14,38,43178,1180482188,151416547,1331898735
2017-07-21,LG4,Total,503,1883,1902764,260970596634,69478326361,330448922995
2017-07-21,All-Floors,Staff,277,2838,2592704,152677277808,18411850115,171089127923
2017-07-21,All-Floors,TPG,137,2592,3373443,417015608248,78469001400,495484609648
2017-07-21,All-Floors,RPG,261,2626,2898068,324861964074,30845443193,355707407267
2017-07-21,All-Floors,UG,592,5312,6989901,1152852234495,114496809387,1267349043882
2017-07-21,All-Floors,Alumni,13,143,191569,7977754882,6110638833,14088393715
2017-07-21,All-Floors,Others(HKUST),46,377,1042246,39384985782,3451875062,42836860844
2017-07-21,All-Floors,Non-HKUST,29,140,149175,27460417859,4486335100,31946752959
2017-07-21,All-Floors,Total,1355,14028,17237106,2122230243148,256271953090,2378502196238
2017-07-22,1,Staff,14,141,96906,7296259663,521465687,7817725350
2017-07-22,1,TPG,29,221,374357,63784502833,6017067116,69801569949
2017-07-22,1,RPG,29,119,217165,16236852320,1795158164,18032010484
2017-07-22,1,UG,35,305,489163,96407981991,4339506930,100747488921
2017-07-22,1,Alumni,11,86,107357,10381279510,881567141,11262846651
2017-07-22,1,Others(HKUST),2,2,2161,41915005,4853073,46768078
2017-07-22,1,Non-HKUST,5,13,33206,4512257804,194082665,4706340469
2017-07-22,1,Total,125,887,1320315,198661049126,13753700776,212414749902
2017-07-22,G,Staff,47,224,234802,38650155765,4418397874,43068553639
2017-07-22,G,TPG,55,387,424651,40856986727,8385619149,49242605876
2017-07-22,G,RPG,59,253,434010,38724050025,9318993709,48043043734
2017-07-22,G,UG,108,452,734184,138599412844,11187528955,149786941799
2017-07-22,G,Alumni,29,135,150625,6649898186,654668683,7304566869
2017-07-22,G,Others(HKUST),11,98,376810,13460692552,1031929577,14492622129
2017-07-22,G,Non-HKUST,12,37,32628,401234812,178056292,579291104
2017-07-22,G,Total,321,1586,2387710,277342430911,35175194239,312517625150
2017-07-22,LG1,Staff,37,213,222700,24196999482,2065272943,26262272425
2017-07-22,LG1,TPG,50,327,381773,64715000371,4028661926,68743662297
2017-07-22,LG1,RPG,53,543,632213,78151764389,18792903385,96944667774
2017-07-22,LG1,UG,153,1594,1932382,363762011238,40039829994,403801841232
2017-07-22,LG1,Alumni,16,94,130593,16725743843,2464410640,19190154483
2017-07-22,LG1,Others(HKUST),10,25,456717,1853107843,707947994,2561055837
2017-07-22,LG1,Non-HKUST,5,21,10181,1226547977,249636244,1476184221
2017-07-22,LG1,Total,324,2817,3766559,550631175143,68348663126,618979838269
2017-07-22,LG3,Staff,29,137,77091,13306802136,843003258,14149805394
2017-07-22,LG3,TPG,18,213,209498,28452304598,1680341064,30132645662
2017-07-22,LG3,RPG,34,189,374380,44821027345,3255689915,48076717260
2017-07-22,LG3,UG,72,307,435475,64812494338,4640280008,69452774346
2017-07-22,LG3,Alumni,14,92,182268,17752677317,2395055422,20147732739
2017-07-22,LG3,Others(HKUST),5,16,720,157227317,70668715,227896032
2017-07-22,LG3,Non-HKUST,4,14,24247,1703218591,115089625,1818308216
2017-07-22,LG3,Total,176,968,1303679,171005751642,13000128007,184005879649
2017-07-22,LG4,Staff,40,87,76996,12624961102,3524469343,16149430445
2017-07-22,LG4,TPG,23,38,78767,3827219283,195527098,4022746381
2017-07-22,LG4,RPG,69,296,345538,37131409362,8111533605,45242942967
2017-07-22,LG4,UG,111,452,512977,224522722009,11947497090,236470219099
2017-07-22,LG4,Alumni,14,72,46281,2979384035,266388129,3245772164
2017-07-22,LG4,Others(HKUST),11,25,1637,3091941520,111512191,3203453711
2017-07-22,LG4,Non-HKUST,10,23,68589,1543758920,151029518,1694788438
2017-07-22,LG4,Total,278,993,1130785,285721396231,24307956974,310029353205
2017-07-22,All-Floors,Staff,102,802,708495,96075178148,11372609105,107447787253
2017-07-22,All-Floors,TPG,105,1186,1469046,201636013812,20307216353,221943230165
2017-07-22,All-Floors,RPG,157,1400,2003306,215065103441,41274278778,256339382219
2017-07-22,All-Floors,UG,306,3110,4104181,888104622420,72154642977,960259265397
2017-07-22,All-Floors,Alumni,46,479,617124,54488982891,6662090015,61151072906
2017-07-22,All-Floors,Others(HKUST),25,166,838045,18604884237,1926911550,20531795787
2017-07-22,All-Floors,Non-HKUST,26,108,168851,9387018104,887894344,10274912448
2017-07-22,All-Floors,Total,767,7251,9909048,1483361803053,154585643122,1637947446175
2017-07-23,1,Staff,9,89,50874,424908375,24273385,449181760
2017-07-23,1,TPG,9,72,104176,15854773140,2180497237,18035270377
2017-07-23,1,RPG,12,12,9850,187025020,57904138,244929158
2017-07-23,1,UG,14,100,152193,18585350444,1954512192,20539862636
2017-07-23,1,Alumni,2,17,16680,943115712,44595323,987711035
2017-07-23,1,Others(HKUST),1,1,0,1251018,2265917,3516935
2017-07-23,1,Non-HKUST,2,2,0,111900057,2255278,114155335
2017-07-23,1,Total,49,293,333773,36108323766,4266303470,40374627236
2017-07-23,G,Staff,12,64,75034,942524767,64807997,1007332764
2017-07-23,G,TPG,13,60,51743,16647909874,1964047767,18611957641
2017-07-23,G,RPG,19,54,116071,10727822643,694424821,11422247464
2017-07-23,G,UG,56,187,481651,40240030967,4426636875,44666667842
2017-07-23,G,Alumni,9,39,29996,8855766731,375481007,9231247738
2017-07-23,G,Others(HKUST),6,26,189008,24053484649,2672579631,26726064280
2017-07-23,G,Non-HKUST,3,12,2268,278464144,469001061,747465205
2017-07-23,G,Total,118,442,945771,101746003775,10666979159,112412982934
2017-07-23,LG1,Staff,13,64,80524,10715219303,979204150,11694423453
2017-07-23,LG1,TPG,18,72,85487,6255380548,668908526,6924289074
2017-07-23,LG1,RPG,23,127,145382,21388418690,2981415228,24369833918
2017-07-23,LG1,UG,81,517,936037,152859435190,14110341246,166969776436
2017-07-23,LG1,Alumni,1,7,120,4087668,3247554,7335222
2017-07-23,LG1,Others(HKUST),6,29,384482,4273776151,846133010,5119909161
2017-07-23,LG1,Non-HKUST,2,9,9955,41532018,5867610,47399628
2017-07-23,LG1,Total,144,825,1641987,195537849568,19595117324,215132966892
2017-07-23,LG3,Staff,13,26,355,744272109,52283954,796556063
2017-07-23,LG3,TPG,11,50,84966,5305781983,333714886,5639496869
2017-07-23,LG3,RPG,15,48,118825,6570870289,769729056,7340599345
2017-07-23,LG3,UG,37,87,43089,11118384491,1096152194,12214536685
2017-07-23,LG3,Alumni,7,15,16186,912081591,67488143,979569734
2017-07-23,LG3,Others(HKUST),3,6,17170,1020060871,47213479,1067274350
2017-07-23,LG3,Non-HKUST,2,2,361,5519872,1436716,6956588
2017-07-23,LG3,Total,88,234,280952,25676971206,2368018428,28044989634
2017-07-23,LG4,Staff,26,54,4563,560444909,173281391,733726300
2017-07-23,LG4,TPG,12,35,54135,5252251180,964683882,6216935062
2017-07-23,LG4,RPG,51,89,107088,21141174447,3938440392,25079614839
2017-07-23,LG4,UG,73,193,91321,30417503433,2312950349,32730453782
2017-07-23,LG4,Alumni,5,66,99958,8359556306,1389307396,9748863702
2017-07-23,LG4,Others(HKUST),7,17,29184,945346674,53905540,999252214
2017-07-23,LG4,Non-HKUST,2,2,721,67532863,4689280,72222143
2017-07-23,LG4,Total,176,456,386970,66743809812,8837258230,75581068042
2017-07-23,All-Floors,Staff,51,297,211350,13387369463,1293850877,14681220340
2017-07-23,All-Floors,TPG,41,289,380507,49316096725,6111852298,55427949023
2017-07-23,All-Floors,RPG,94,330,497216,60015311089,8441913635,68457224724
2017-07-23,All-Floors,UG,194,1084,1704291,253220704525,23900592856,277121297381
2017-07-23,All-Floors,Alumni,15,144,162940,19074608008,1880119423,20954727431
2017-07-23,All-Floors,Others(HKUST),15,79,619844,30293919363,3622097577,33916016940
2017-07-23,All-Floors,Non-HKUST,11,27,13305,504948954,483249945,988198899
2017-07-23,All-Floors,Total,421,2250,3589453,425812958127,45733676611,471546634738
2017-07-24,1,Staff,72,823,1090791,50903854595,3521609311,54425463906
2017-07-24,1,TPG,34,458,757054,62608793155,36098551007,98707344162
2017-07-24,1,RPG,26,214,455920,16658663510,3400900976,20059564486
2017-07-24,1,UG,57,455,730480,89632357222,17290594192,106922951414
2017-07-24,1,Alumni,2,21,45329,2678333615,146095410,2824429025
2017-07-24,1,Others(HKUST),8,27,73132,3159574862,1941182404,5100757266
2017-07-24,1,Non-HKUST,3,6,8844,1353124943,49109234,1402234177
2017-07-24,1,Total,202,2004,3161550,226994701902,62448042534,289442744436
2017-07-24,G,Staff,153,1043,1035067,73248742199,9066348845,82315091044
2017-07-24,G,TPG,82,407,509374,57424879586,10675193859,68100073445
2017-07-24,G,RPG,135,491,550626,47377243210,5334951778,52712194988
2017-07-24,G,UG,253,1095,1406477,162299198781,17284388569,179583587350
2017-07-24,G,Alumni,11,101,126308,1375723254,386749581,1762472835
2017-07-24,G,Others(HKUST),30,150,245911,13490188656,1083828756,14574017412
2017-07-24,G,Non-HKUST,11,44,70977,13847588627,753943984,14601532611
2017-07-24,G,Total,675,3331,3944740,369063564313,44585405372,413648969685
2017-07-24,LG1,Staff,122,511,440856,34633360992,12478496496,47111857488
2017-07-24,LG1,TPG,52,321,596736,72390963296,5414726898,77805690194
2017-07-24,LG1,RPG,118,611,679794,77854947640,6736865288,84591812928
2017-07-24,LG1,UG,340,2336,3210209,431172189279,50102228813,481274418092
2017-07-24,LG1,Alumni,7,30,50317,1193345880,172629091,1365974971
2017-07-24,LG1,Others(HKUST),20,109,340388,4923046416,385031293,5308077709
2017-07-24,LG1,Non-HKUST,12,36,62122,3058105278,139535685,3197640963
2017-07-24,LG1,Total,671,3954,5380422,625225958781,75429513564,700655472345
2017-07-24,LG3,Staff,85,462,272693,33864068595,7886011204,41750079799
2017-07-24,LG3,TPG,24,250,389729,42629493499,2333166627,44962660126
2017-07-24,LG3,RPG,79,477,649950,56141360645,5167573812,61308934457
2017-07-24,LG3,UG,125,665,853536,195940616454,14271492818,210212109272
2017-07-24,LG3,Alumni,4,28,64675,6826969481,383388082,7210357563
2017-07-24,LG3,Others(HKUST),13,80,66745,2083505731,380577820,2464083551
2017-07-24,LG3,Non-HKUST,5,5,0,575430687,42842320,618273007
2017-07-24,LG3,Total,335,1967,2297328,338061445092,30465052683,368526497775
2017-07-24,LG4,Staff,114,366,246352,32054885119,3998279681,36053164800
2017-07-24,LG4,TPG,28,130,232355,18889615521,1923834635,20813450156
2017-07-24,LG4,RPG,114,611,766307,85892910267,7598705645,93491615912
2017-07-24,LG4,UG,205,825,856675,113658062716,8691212840,122349275556
2017-07-24,LG4,Alumni,8,55,98643,13889077775,660188416,14549266191
2017-07-24,LG4,Others(HKUST),26,138,23351,7232020217,395057862,7627078079
2017-07-24,LG4,Non-HKUST,9,56,64202,4651095715,507656437,5158752152
2017-07-24,LG4,Total,504,2181,2287885,276267667330,23774935516,300042602846
2017-07-24,All-Floors,Staff,317,3205,3085759,224704911500,36950745537,261655657037
2017-07-24,All-Floors,TPG,118,1566,2485248,253943745057,56445473026,310389218083
2017-07-24,All-Floors,RPG,290,2404,3102597,283925125272,28238997499,312164122771
2017-07-24,All-Floors,UG,594,5376,7057377,992702424452,107639917232,1100342341684
2017-07-24,All-Floors,Alumni,18,235,385272,25963450005,1749050580,27712500585
2017-07-24,All-Floors,Others(HKUST),55,504,749527,30888335882,4185678135,35074014017
2017-07-24,All-Floors,Non-HKUST,24,147,206145,23485345250,1493087660,24978432910
2017-07-24,All-Floors,Total,1416,13437,17071925,1835613337418,236702949669,2072316287087
2017-07-25,1,Staff,78,856,1311930,39592617709,4185431792,43778049501
2017-07-25,1,TPG,22,327,358702,43700137071,5055794662,48755931733
2017-07-25,1,RPG,41,269,409153,25746805630,6943920323,32690725953
2017-07-25,1,UG,63,422,683010,82283405693,12784635978,95068041671
2017-07-25,1,Alumni,3,44,66122,3441054399,214925417,3655979816
2017-07-25,1,Others(HKUST),12,43,62254,3124590250,313766901,3438357151
2017-07-25,1,Non-HKUST,2,9,7784,179717015,26739616,206456631
2017-07-25,1,Total,221,1970,2898955,198068327767,29525214689,227593542456
2017-07-25,G,Staff,148,821,1043323,29014910942,4298332665,33313243607
2017-07-25,G,TPG,61,318,339760,46173404549,4737249497,50910654046
2017-07-25,G,RPG,98,478,592000,50831214940,3338294983,54169509923
2017-07-25,G,UG,189,834,1125815,124733106273,12127138701,136860244974
2017-07-25,G,Alumni,18,94,102848,11645815144,1930273814,13576088958
2017-07-25,G,Others(HKUST),25,151,317906,21254662384,1850300080,23104962464
2017-07-25,G,Non-HKUST,8,31,15351,670561841,64965690,735527531
2017-07-25,G,Total,547,2727,3537003,284323676073,28346555430,312670231503
2017-07-25,LG1,Staff,122,707,609908,112808885923,6047677283,118856563206
2017-07-25,LG1,TPG,40,315,455487,43323110763,4094790179,47417900942
2017-07-25,LG1,RPG,92,511,514338,48203739656,4306450306,52510189962
2017-07-25,LG1,UG,334,2554,3491862,488670105312,48733757090,537403862402
2017-07-25,LG1,Alumni,10,46,55909,1694829211,232629598,1927458809
2017-07-25,LG1,Others(HKUST),20,139,599122,14080201635,520188782,14600390417
2017-07-25,LG1,Non-HKUST,9,79,33345,6143433393,311096620,6454530013
2017-07-25,LG1,Total,627,4351,5759971,714924305893,64246589858,779170895751
2017-07-25,LG3,Staff,66,365,258819,29117286942,1605536735,30722823677
2017-07-25,LG3,TPG,18,189,365187,39263495844,2576288045,41839783889
2017-07-25,LG3,RPG,65,485,523275,31858212818,2948038827,34806251645
2017-07-25,LG3,UG,101,712,1006376,86831408675,13088740693,99920149368
2017-07-25,LG3,Alumni,5,31,65501,8410388542,414264889,8824653431
2017-07-25,LG3,Others(HKUST),14,53,39490,7173614936,307570288,7481185224
2017-07-25,LG3,Non-HKUST,2,6,705,2610406,1139646,3750052
2017-07-25,LG3,Total,271,1841,2259353,202657018163,20941579123,223598597286
2017-07-25,LG4,Staff,107,406,223382,31935987353,6028015509,37964002862
2017-07-25,LG4,TPG,30,220,364097,27975308093,2364656864,30339964957
2017-07-25,LG4,RPG,135,732,817671,86175354788,8005238590,94180593378
2017-07-25,LG4,UG,175,619,576488,104564937458,15731232603,120296170061
2017-07-25,LG4,Alumni,10,137,238370,13063334300,925302189,13988636489
2017-07-25,LG4,Others(HKUST),21,209,66177,9187086314,520309747,9707396061
2017-07-25,LG4,Non-HKUST,8,50,39005,375016315,39752677,414768992
2017-07-25,LG4,Total,486,2373,2325190,273277024621,33614508179,306891532800
2017-07-25,All-Floors,Staff,322,3155,3447362,242469688869,22164993984,264634682853
2017-07-25,All-Floors,TPG,96,1369,1883233,200435456320,18828779247,219264235567
2017-07-25,All-Floors,RPG,260,2475,2856437,242815327832,25541943029,268357270861
2017-07-25,All-Floors,UG,568,5141,6883551,887082963411,102465505065,989548468476
2017-07-25,All-Floors,Alumni,20,352,528750,38255421596,3717395907,41972817503
2017-07-25,All-Floors,Others(HKUST),56,595,1084949,54820155519,3512135798,58332291317
2017-07-25,All-Floors,Non-HKUST,18,175,96190,7371338970,443694249,7815033219
2017-07-25,All-Floors,Total,1340,13262,16780472,1673250352517,176674447279,1849924799796
2017-07-26,1,Staff,69,831,1272539,19988821165,3382621935,23371443100
2017-07-26,1,TPG,24,295,481626,37294690413,3945047343,41239737756
2017-07-26,1,RPG,41,216,394503,44075706606,4442320397,48518027003
2017-07-26,1,UG,57,450,784523,117398740591,21293905017,138692645608
2017-07-26,1,Alumni,1,8,479,2106644,667409,2774053
2017-07-26,1,Others(HKUST),9,70,86933,8797819521,2871429737,11669249258
2017-07-26,1,Non-HKUST,6,18,26109,4896496530,203171807,5099668337
2017-07-26,1,Total,207,1888,3046712,232454381470,36139163645,268593545115
2017-07-26,G,Staff,131,873,839960,68263635481,6341890297,74605525778
2017-07-26,G,TPG,76,468,420427,43791665057,3759166183,47550831240
2017-07-26,G,RPG,120,547,684151,45086845589,4804469565,49891315154
2017-07-26,G,UG,169,735,1142587,120310461020,12920307443,133230768463
2017-07-26,G,Alumni,11,109,90651,4176343449,764768159,4941111608
2017-07-26,G,Others(HKUST),36,169,338031,16968100678,1035137811,18003238489
2017-07-26,G,Non-HKUST,14,35,39512,2187650771,687257420,2874908191
2017-07-26,G,Total,557,2936,3555319,300784702045,30312996878,331097698923
2017-07-26,LG1,Staff,114,592,522743,34100796757,3546940007,37647736764
2017-07-26,LG1,TPG,56,408,641108,77148768309,5379888374,82528656683
2017-07-26,LG1,RPG,126,875,917410,160158307624,10815680737,170973988361
2017-07-26,LG1,UG,326,2687,3771654,511204298556,54610867863,565815166419
2017-07-26,LG1,Alumni,3,18,30785,5239601393,648721929,5888323322
2017-07-26,LG1,Others(HKUST),29,194,584464,9575265625,1162533694,10737799319
2017-07-26,LG1,Non-HKUST,7,64,73751,5232521752,664238016,5896759768
2017-07-26,LG1,Total,661,4838,6541915,802659560016,76828870620,879488430636
2017-07-26,LG3,Staff,81,372,281232,23527463059,1826111951,25353575010
2017-07-26,LG3,TPG,21,159,238150,19901664113,1268300727,21169964840
2017-07-26,LG3,RPG,60,613,699768,44394504676,5953860093,50348364769
2017-07-26,LG3,UG,92,586,734229,131173100204,9470361222,140643461426
2017-07-26,LG3,Alumni,3,7,1806,110168356,22403484,132571840
2017-07-26,LG3,Others(HKUST),14,54,42965,9124354230,720198416,9844552646
2017-07-26,LG3,Non-HKUST,3,3,0,639733870,81011323,720745193
2017-07-26,LG3,Total,274,1794,1998150,228870988508,19342247216,248213235724
2017-07-26,LG4,Staff,125,458,253783,39052414472,2325240389,41377654861
2017-07-26,LG4,TPG,35,257,341711,42783785224,3963848671,46747633895
2017-07-26,LG4,RPG,124,672,745521,95771952581,9728726694,105500679275
2017-07-26,LG4,UG,216,735,741324,123888468319,10027265845,133915734164
2017-07-26,LG4,Alumni,12,102,184327,34021142217,1498426754,35519568971
2017-07-26,LG4,Others(HKUST),26,226,62315,17283923952,1579228023,18863151975
2017-07-26,LG4,Non-HKUST,8,22,26935,2366720438,245197970,2611918408
2017-07-26,LG4,Total,546,2472,2355916,355168407203,29367934346,384536341549
2017-07-26,All-Floors,Staff,328,3126,3170257,184933130934,17422804579,202355935513
2017-07-26,All-Floors,TPG,127,1587,2123022,220920573116,18316251298,239236824414
2017-07-26,All-Floors,RPG,298,2923,3441353,389487317076,35745057486,425232374562
2017-07-26,All-Floors,UG,561,5193,7174317,1003975068690,108322707390,1112297776080
2017-07-26,All-Floors,Alumni,17,244,308048,43549362059,2934987735,46484349794
2017-07-26,All-Floors,Others(HKUST),62,713,1114708,61749464006,7368527681,69117991687
2017-07-26,All-Floors,Non-HKUST,30,142,166307,15323123361,1880876536,17203999897
2017-07-26,All-Floors,Total,1423,13928,17498012,1919938039242,191991212705,2111929251947
2017-07-27,1,Staff,77,1036,1308100,29912915753,3770108275,33683024028
2017-07-27,1,TPG,24,358,495216,56518004439,5931578259,62449582698
2017-07-27,1,RPG,46,170,349560,34512977892,3392513464,37905491356
2017-07-27,1,UG,58,484,792627,64878920075,7698858496,72577778571
2017-07-27,1,Alumni,1,1,0,15723150,5583187,21306337
2017-07-27,1,Others(HKUST),8,57,50754,7988532489,761069457,8749601946
2017-07-27,1,Non-HKUST,6,40,64271,9231626043,576505471,9808131514
2017-07-27,1,Total,220,2146,3060528,203058699841,22136216609,225194916450
2017-07-27,G,Staff,129,934,940794,34676191779,5405128242,40081320021
2017-07-27,G,TPG,63,451,446618,111244546118,5806582017,117051128135
2017-07-27,G,RPG,110,528,606521,63018259360,9140067357,72158326717
2017-07-27,G,UG,208,864,1219052,154516011134,19672260571,174188271705
2017-07-27,G,Alumni,10,70,107946,2531095016,223616606,2754711622
2017-07-27,G,Others(HKUST),18,213,522215,28683239367,1770420133,30453659500
2017-07-27,G,Non-HKUST,16,107,141391,5327036246,453992206,5781028452
2017-07-27,G,Total,554,3167,3984537,399996379020,42472067132,442468446152
2017-07-27,LG1,Staff,110,504,316595,31164281328,2008640808,33172922136
2017-07-27,LG1,TPG,32,226,337179,57148569563,6228232635,63376802198
2017-07-27,LG1,RPG,99,767,862728,134518542992,7993449312,142511992304
2017-07-27,LG1,UG,318,2634,3678224,554770142692,44008457109,598778599801
2017-07-27,LG1,Alumni,7,16,7641,2587260132,91309441,2678569573
2017-07-27,LG1,Others(HKUST),18,122,531661,16711593610,2412575043,19124168653
2017-07-27,LG1,Non-HKUST,8,26,23541,17385631584,861146901,18246778485
2017-07-27,LG1,Total,592,4295,5757569,814286021901,63603811249,877889833150
2017-07-27,LG3,Staff,65,256,245131,14466522373,1262337926,15728860299
2017-07-27,LG3,TPG,17,188,196718,25943986102,13277133600,39221119702
2017-07-27,LG3,RPG,51,394,548334,35347467184,3910312635,39257779819
2017-07-27,LG3,UG,109,1065,1165575,184606260010,18888517672,203494777682
2017-07-27,LG3,Alumni,7,72,55855,13345548672,1238548578,14584097250
2017-07-27,LG3,Others(HKUST),6,28,55410,795133300,677830108,1472963408
2017-07-27,LG3,Non-HKUST,3,9,33993,487367343,29261179,516628522
2017-07-27,LG3,Total,258,2012,2301016,274992284984,39283941698,314276226682
2017-07-27,LG4,Staff,129,431,183725,29752625116,2101754523,31854379639
2017-07-27,LG4,TPG,22,153,315603,71595918494,3632148522,75228067016
2017-07-27,LG4,RPG,148,520,631399,209834372944,8754500827,218588873771
2017-07-27,LG4,UG,196,802,787507,145839566066,12174098646,158013664712
2017-07-27,LG4,Alumni,7,75,71503,5913577864,269696809,6183274673
2017-07-27,LG4,Others(HKUST),18,143,42015,8638688546,341838132,8980526678
2017-07-27,LG4,Non-HKUST,9,42,39639,2223414359,92558366,2315972725
2017-07-27,LG4,Total,529,2166,2071391,473798163389,27366595825,501164759214
2017-07-27,All-Floors,Staff,315,3161,2994345,139972536349,14547969774,154520506123
2017-07-27,All-Floors,TPG,96,1376,1791334,322451024716,34875675033,357326699749
2017-07-27,All-Floors,RPG,299,2379,2998542,477231620372,33190843595,510422463967
2017-07-27,All-Floors,UG,563,5849,7642985,1104610899977,102442192494,1207053092471
2017-07-27,All-Floors,Alumni,16,234,242945,24393204834,1828754621,26221959455
2017-07-27,All-Floors,Others(HKUST),43,563,1202055,62817187312,5963732873,68780920185
2017-07-27,All-Floors,Non-HKUST,29,224,302835,34655075575,2013464123,36668539698
2017-07-27,All-Floors,Total,1361,13786,17175041,2166131549135,194862632513,2360994181648
2017-07-28,1,Staff,80,811,1229992,32607518663,2503599812,35111118475
2017-07-28,1,TPG,38,479,520237,103411406708,10186065314,113597472022
2017-07-28,1,RPG,41,187,332330,29760343018,3522949271,33283292289
2017-07-28,1,UG,62,341,644599,57305685242,6774337950,64080023192
2017-07-28,1,Alumni,1,12,12826,140361614,24821717,165183331
2017-07-28,1,Others(HKUST),11,73,69149,7726823283,1491218494,9218041777
2017-07-28,1,Non-HKUST,5,13,30963,3995660379,237338250,4232998629
2017-07-28,1,Total,238,1916,2840096,234947798907,24740330808,259688129715
2017-07-28,G,Staff,136,840,863220,52144023052,5321573037,57465596089
2017-07-28,G,TPG,77,447,419765,73383461817,4689692018,78073153835
2017-07-28,G,RPG,95,456,645506,72099012062,7812843443,79911855505
2017-07-28,G,UG,213,967,1294653,190570838297,14095627851,204666466148
2017-07-28,G,Alumni,10,79,111917,724369675,3199875437,3924245112
2017-07-28,G,Others(HKUST),32,288,463728,34347894500,3382934363,37730828863
2017-07-28,G,Non-HKUST,13,62,40039,2281153441,495740394,2776893835
2017-07-28,G,Total,576,3139,3838828,425550752844,38998286543,464549039387
2017-07-28,LG1,Staff,99,417,265047,16016774954,2391603978,18408378932
2017-07-28,LG1,TPG,42,341,489766,68086869647,3866160377,71953030024
2017-07-28,LG1,RPG,94,605,710222,120628133750,12545519964,133173653714
2017-07-28,LG1,UG,333,2849,3872687,700800920978,103446141075,804247062053
2017-07-28,LG1,Alumni,7,33,41374,953228319,5129843779,6083072098
2017-07-28,LG1,Others(HKUST),23,163,615434,28251744081,1424112957,29675857038
2017-07-28,LG1,Non-HKUST,10,33,34570,800366814,69444637,869811451
2017-07-28,LG1,Total,608,4441,6029100,935538038543,128872826767,1064410865310
2017-07-28,LG3,Staff,73,354,291512,41261327906,1947659910,43208987816
2017-07-28,LG3,TPG,26,193,247152,19399364733,1631140559,21030505292
2017-07-28,LG3,RPG,51,356,471642,70335495520,8147169564,78482665084
2017-07-28,LG3,UG,96,569,744997,90275568763,39178511627,129454080390
2017-07-28,LG3,Alumni,1,2,0,356191698,266888726,623080424
2017-07-28,LG3,Others(HKUST),10,55,66081,20852284523,990264656,21842549179
2017-07-28,LG3,Non-HKUST,3,7,3576,479731831,17828510,497560341
2017-07-28,LG3,Total,260,1536,1824960,242959964974,52179463552,295139428526
2017-07-28,LG4,Staff,124,383,199510,14439395529,1448801347,15888196876
2017-07-28,LG4,TPG,42,162,207416,10388309162,1523187971,11911497133
2017-07-28,LG4,RPG,142,449,532238,86478900985,7618734900,94097635885
2017-07-28,LG4,UG,194,675,479088,81146113064,9545914727,90692027791
2017-07-28,LG4,Alumni,7,42,82686,4662687263,1254814443,5917501706
2017-07-28,LG4,Others(HKUST),22,155,18663,4653151914,414483281,5067635195
2017-07-28,LG4,Non-HKUST,12,43,52834,1310574894,302762657,1613337551
2017-07-28,LG4,Total,543,1909,1572435,203079132811,22108699326,225187832137
2017-07-28,All-Floors,Staff,323,2805,2849281,156469040104,13613238084,170082278188
2017-07-28,All-Floors,TPG,128,1622,1884336,274669412067,21896246239,296565658306
2017-07-28,All-Floors,RPG,291,2053,2691938,379301885335,39647217142,418949102477
2017-07-28,All-Floors,UG,603,5401,7036024,1120099126344,173040533230,1293139659574
2017-07-28,All-Floors,Alumni,15,168,248803,6836838569,9876244102,16713082671
2017-07-28,All-Floors,Others(HKUST),61,734,1233055,95831898301,7703013751,103534912052
2017-07-28,All-Floors,Non-HKUST,30,158,161982,8867487359,1123114448,9990601807
2017-07-28,All-Floors,Total,1451,12941,16105419,2042075688079,266899606996,2308975295075
2017-07-29,1,Staff,20,133,200628,1125195970,110635623,1235831593
2017-07-29,1,TPG,16,102,186328,28413367285,2807349068,31220716353
2017-07-29,1,RPG,30,102,185648,16897893679,671082814,17568976493
2017-07-29,1,UG,42,313,595798,73818651106,8507666911,82326318017
2017-07-29,1,Alumni,7,34,78343,13245344652,614800955,13860145607
2017-07-29,1,Others(HKUST),5,18,22822,2128924140,509018225,2637942365
2017-07-29,1,Non-HKUST,4,20,29387,3083375601,286006582,3369382183
2017-07-29,1,Total,124,722,1298954,138712752433,13506560178,152219312611
2017-07-29,G,Staff,51,342,335789,21001873391,14612529524,35614402915
2017-07-29,G,TPG,42,283,384903,34165801660,33884363931,68050165591
2017-07-29,G,RPG,61,221,270259,18516740507,1545344519,20062085026
2017-07-29,G,UG,122,560,978427,185572040404,16135264766,201707305170
2017-07-29,G,Alumni,26,149,169236,5206227527,1306366806,6512594333
2017-07-29,G,Others(HKUST),11,94,381665,8425351646,625598693,9050950339
2017-07-29,G,Non-HKUST,7,31,4322,348127885,204945578,553073463
2017-07-29,G,Total,320,1680,2524601,273236163020,68314413817,341550576837
2017-07-29,LG1,Staff,51,297,333284,103269523282,5401917698,108671440980
2017-07-29,LG1,TPG,26,176,388197,39168943714,2795745565,41964689279
2017-07-29,LG1,RPG,56,334,530056,155529484066,16465541647,171995025713
2017-07-29,LG1,UG,212,1565,2430881,339805741790,27425384547,367231126337
2017-07-29,LG1,Alumni,20,93,205831,8109329076,1398837400,9508166476
2017-07-29,LG1,Others(HKUST),11,32,485441,7473622764,2016198181,9489820945
2017-07-29,LG1,Non-HKUST,7,25,5646,359466260,89443309,448909569
2017-07-29,LG1,Total,383,2522,4379336,653716110952,55593068347,709309179299
2017-07-29,LG3,Staff,27,182,195697,19661905867,2766746009,22428651876
2017-07-29,LG3,TPG,15,45,42824,8933872079,1047828812,9981700891
2017-07-29,LG3,RPG,28,179,236512,38301593816,3121252873,41422846689
2017-07-29,LG3,UG,57,372,335946,119846943764,4588242295,124435186059
2017-07-29,LG3,Alumni,14,84,169446,14351326706,2235244716,16586571422
2017-07-29,LG3,Others(HKUST),3,5,363,7801090,1882707,9683797
2017-07-29,LG3,Non-HKUST,4,44,34183,3904782465,263296727,4168079192
2017-07-29,LG3,Total,148,911,1014971,205008225787,14024494139,219032719926
2017-07-29,LG4,Staff,37,63,39211,2884358868,618831996,3503190864
2017-07-29,LG4,TPG,23,97,236686,32835012196,4411718733,37246730929
2017-07-29,LG4,RPG,80,352,266816,63128327663,13867312080,76995639743
2017-07-29,LG4,UG,138,513,540634,94411009974,7920193908,102331203882
2017-07-29,LG4,Alumni,18,81,155188,13878219975,745462316,14623682291
2017-07-29,LG4,Others(HKUST),7,123,4250,2877461412,255851881,3133313293
2017-07-29,LG4,Non-HKUST,9,20,16805,524314796,207483007,731797803
2017-07-29,LG4,Total,312,1249,1259590,210538704884,28026853921,238565558805
2017-07-29,All-Floors,Staff,114,1017,1104609,147942857378,23510660850,171453518228
2017-07-29,All-Floors,TPG,77,703,1238938,143516996934,44947006109,188464003043
2017-07-29,All-Floors,RPG,178,1188,1489291,292374039731,35670533933,328044573664
2017-07-29,All-Floors,UG,376,3323,4881686,813454387038,64576752427,878031139465
2017-07-29,All-Floors,Alumni,48,441,778044,54790447936,6300712193,61091160129
2017-07-29,All-Floors,Others(HKUST),29,272,894541,20913161052,3408549687,24321710739
2017-07-29,All-Floors,Non-HKUST,20,140,90343,8220067007,1051175203,9271242210
2017-07-29,All-Floors,Total,842,7084,10477452,1481211957076,179465390402,1660677347478
2017-07-30,1,Staff,14,142,125532,2592516932,353781624,2946298556
2017-07-30,1,TPG,31,269,361626,52769440006,12864836435,65634276441
2017-07-30,1,RPG,30,51,25796,7838457601,933826174,8772283775
2017-07-30,1,UG,24,111,134239,18230267304,6386001974,24616269278
2017-07-30,1,Alumni,4,14,25928,590364350,380604657,970969007
2017-07-30,1,Others(HKUST),5,20,16673,4024280720,96928606,4121209326
2017-07-30,1,Non-HKUST,2,7,10312,259633567,160397206,420030773
2017-07-30,1,Total,110,614,700106,86304960480,21176376676,107481337156
2017-07-30,G,Staff,27,239,164823,9737008633,1479973512,11216982145
2017-07-30,G,TPG,49,233,248881,23682899778,2769968955,26452868733
2017-07-30,G,RPG,27,88,116395,11201999345,1043764461,12245763806
2017-07-30,G,UG,115,440,890689,178545849668,22435155560,200981005228
2017-07-30,G,Alumni,20,108,215788,7375373983,1249192189,8624566172
2017-07-30,G,Others(HKUST),9,29,255189,8251612950,418307941,8669920891
2017-07-30,G,Non-HKUST,10,38,23891,5507589333,839520387,6347109720
2017-07-30,G,Total,257,1175,1915656,244302333690,30235883005,274538216695
2017-07-30,LG1,Staff,29,135,136451,16492102616,920533199,17412635815
2017-07-30,LG1,TPG,27,148,203634,21052550344,1523193260,22575743604
2017-07-30,LG1,RPG,44,202,310087,33629517527,2053504013,35683021540
2017-07-30,LG1,UG,193,1356,2261444,340817984629,44086705552,384904690181
2017-07-30,LG1,Alumni,16,102,173660,11109307086,1658475852,12767782938
2017-07-30,LG1,Others(HKUST),9,35,458878,3641598096,248816695,3890414791
2017-07-30,LG1,Non-HKUST,6,35,54117,14347437644,871683714,15219121358
2017-07-30,LG1,Total,324,2013,3598271,441090497942,51362912285,492453410227
2017-07-30,LG3,Staff,18,48,38294,14716328863,711410432,15427739295
2017-07-30,LG3,TPG,15,75,102513,14823190224,1201518196,16024708420
2017-07-30,LG3,RPG,24,89,125146,9630656475,661433090,10292089565
2017-07-30,LG3,UG,61,309,492462,82951004813,9513104504,92464109317
2017-07-30,LG3,Alumni,12,37,75287,9838955772,461002621,10299958393
2017-07-30,LG3,Others(HKUST),6,6,721,3144372473,163297444,3307669917
2017-07-30,LG3,Non-HKUST,3,4,723,425009264,82489547,507498811
2017-07-30,LG3,Total,139,568,835146,135529517884,12794255834,148323773718
2017-07-30,LG4,Staff,30,64,52568,6061477628,526420103,6587897731
2017-07-30,LG4,TPG,25,100,88160,12028210781,1175195086,13203405867
2017-07-30,LG4,RPG,65,113,124813,18374093809,1802446343,20176540152
2017-07-30,LG4,UG,128,408,431190,102760073943,21555952536,124316026479
2017-07-30,LG4,Alumni,12,84,124269,46071861505,2298364791,48370226296
2017-07-30,LG4,Others(HKUST),8,123,3721,1948665223,95133292,2043798515
2017-07-30,LG4,Non-HKUST,5,10,12122,276618469,175557959,452176428
2017-07-30,LG4,Total,273,902,836843,187521001358,27629070110,215150071468
2017-07-30,All-Floors,Staff,78,628,517668,49599434672,3992118870,53591553542
2017-07-30,All-Floors,TPG,95,825,1004814,124356291133,19534711932,143891003065
2017-07-30,All-Floors,RPG,149,543,702237,80674724757,6494974081,87169698838
2017-07-30,All-Floors,UG,358,2624,4210024,723305180357,103976920126,827282100483
2017-07-30,All-Floors,Alumni,38,345,614932,74985862696,6047640110,81033502806
2017-07-30,All-Floors,Others(HKUST),22,213,735182,21010529462,1022483978,22033013440
2017-07-30,All-Floors,Non-HKUST,17,94,101165,20816288277,2129648813,22945937090
2017-07-30,All-Floors,Total,757,5272,7886022,1094748311354,143198497910,1237946809264
2017-07-31,1,Staff,84,1068,1371670,51023602749,8659148363,59682751112
2017-07-31,1,TPG,29,285,496455,23521971911,1999563933,25521535844
2017-07-31,1,RPG,46,278,455860,48126675783,6581605317,54708281100
2017-07-31,1,UG,56,397,598427,267766797642,8628354683,276395152325
2017-07-31,1,Alumni,3,36,73869,8502213986,514340103,9016554089
2017-07-31,1,Others(HKUST),11,79,115769,5508666011,841371469,6350037480
2017-07-31,1,Non-HKUST,3,3,3688,5171134,2291067,7462201
2017-07-31,1,Total,232,2146,3115738,404455099216,27226674935,431681774151
2017-07-31,G,Staff,150,1012,918981,56033532617,9010507239,65044039856
2017-07-31,G,TPG,67,273,205135,22625645573,2193593539,24819239112
2017-07-31,G,RPG,103,382,416289,55521493358,5536738419,61058231777
2017-07-31,G,UG,196,864,1479479,194226292035,27408740056,221635032091
2017-07-31,G,Alumni,9,85,99618,1039612980,598835953,1638448933
2017-07-31,G,Others(HKUST),21,128,322899,16856502332,1772174188,18628676520
2017-07-31,G,Non-HKUST,11,41,68807,1622593713,2420908832,4043502545
2017-07-31,G,Total,557,2785,3511208,347925672608,48941498226,396867170834
2017-07-31,LG1,Staff,126,623,555513,42125574589,6304780942,48430355531
2017-07-31,LG1,TPG,46,207,353315,83043549677,5055056073,88098605750
2017-07-31,LG1,RPG,98,635,601791,119324224477,12597077666,131921302143
2017-07-31,LG1,UG,352,2944,3811777,533057039267,75070338310,608127377577
2017-07-31,LG1,Alumni,6,29,42665,1549075953,519458803,2068534756
2017-07-31,LG1,Others(HKUST),19,140,598807,32135298904,4090603318,36225902222
2017-07-31,LG1,Non-HKUST,11,26,51923,3925763773,278194214,4203957987
2017-07-31,LG1,Total,658,4604,6015791,815160526640,103915509326,919076035966
2017-07-31,LG3,Staff,65,365,384885,80315245426,4007948341,84323193767
2017-07-31,LG3,TPG,18,109,131405,59381712217,1311552651,60693264868
2017-07-31,LG3,RPG,42,245,422853,29360286156,4117953987,33478240143
2017-07-31,LG3,UG,82,527,708423,148672582768,21593595083,170266177851
2017-07-31,LG3,Alumni,4,7,13616,182060934,25067769,207128703
2017-07-31,LG3,Others(HKUST),8,29,32615,13098179910,457899767,13556079677
2017-07-31,LG3,Non-HKUST,2,5,362,18407693,3381464,21789157
2017-07-31,LG3,Total,221,1287,1694159,331028475104,31517399062,362545874166
2017-07-31,LG4,Staff,131,380,259301,28943559651,2010637864,30954197515
2017-07-31,LG4,TPG,34,217,394763,69435986835,6893518867,76329505702
2017-07-31,LG4,RPG,120,501,439237,62972879610,5160532196,68133411806
2017-07-31,LG4,UG,170,715,677870,95344314452,32284676942,127628991394
2017-07-31,LG4,Alumni,9,47,103436,47513326257,1207505530,48720831787
2017-07-31,LG4,Others(HKUST),24,148,18886,3325448111,306331791,3631779902
2017-07-31,LG4,Non-HKUST,10,32,53140,2467900471,118527749,2586428220
2017-07-31,LG4,Total,498,2040,1946633,310003415387,47981730939,357985146326
2017-07-31,All-Floors,Staff,325,3448,3490350,258441515032,29993022749,288434537781
2017-07-31,All-Floors,TPG,109,1091,1581073,258008866213,17453285063,275462151276
2017-07-31,All-Floors,RPG,273,2041,2336030,315305559384,33993907585,349299466969
2017-07-31,All-Floors,UG,570,5447,7275976,1239067026164,164985705074,1404052731238
2017-07-31,All-Floors,Alumni,17,204,333204,58786290110,2865208158,61651498268
2017-07-31,All-Floors,Others(HKUST),50,524,1088976,70924095268,7468380533,78392475801
2017-07-31,All-Floors,Non-HKUST,25,107,177920,8039836784,2823303326,10863140110
2017-07-31,All-Floors,Total,1369,12862,16283529,2208573188955,259582812488,2468156001443
