Date,Floor,User-Group,User-Count,WiFi-Conn,Duration-Sec,Traffic-In-Byte,Traffic-Out-Byte,Traffic-Both-Byte
2018-08-03,1,Staff,51,169,1204173,649666546,12534375709,13184042255
2018-08-03,1,TPG,20,92,726680,578114074,6059820117,6637934191
2018-08-03,1,RPG,7,32,145622,99837402,2414764050,2514601452
2018-08-03,1,UG,39,137,1141983,4479393218,26885572685,31364965903
2018-08-03,1,Alumni,0,0,0,0,0,0
2018-08-03,1,Others(HKUST),9,31,195618,229167591,4430429820,4659597411
2018-08-03,1,Non-HKUST,8,13,96148,56978843,1300834456,1357813299
2018-08-03,1,Total,134,474,3510224,6093157674,53625796837,59718954511
2018-08-03,G,Staff,54,146,923557,786686680,2964827985,3751514665
2018-08-03,G,TPG,20,43,211658,175629391,2348694388,2524323779
2018-08-03,G,RPG,25,83,499464,679869007,7311993244,7991862251
2018-08-03,G,UG,60,154,896917,1084550265,13252758501,14337308766
2018-08-03,G,Alumni,5,11,86167,129614218,5194340041,5323954259
2018-08-03,G,Others(HKUST),19,38,245536,694543042,12114364920,12808907962
2018-08-03,G,Non-HKUST,13,25,140278,165578266,1131762163,1297340429
2018-08-03,G,Total,196,500,3003577,3716470869,44318741242,48035212111
2018-08-03,LG1,Staff,33,70,407805,466109266,6344289513,6810398779
2018-08-03,LG1,TPG,20,46,341425,408386511,6813838115,7222224626
2018-08-03,LG1,RPG,46,136,719319,973447742,8030622998,9004070740
2018-08-03,LG1,UG,184,537,3397116,16933002121,90011654994,106944657115
2018-08-03,LG1,Alumni,4,7,28728,14433069,893981547,908414616
2018-08-03,LG1,Others(HKUST),21,42,214288,135818321,1922946464,2058764785
2018-08-03,LG1,Non-HKUST,9,22,132069,602673235,8341725772,8944399007
2018-08-03,LG1,Total,317,860,5240750,19533870265,122359059403,141892929668
2018-08-03,LG3,Staff,15,23,97570,63536553,2342521272,2406057825
2018-08-03,LG3,TPG,5,14,90365,261718685,770604480,1032323165
2018-08-03,LG3,RPG,10,34,268063,1100230395,6812881811,7913112206
2018-08-03,LG3,UG,30,72,415898,716727473,12457735733,13174463206
2018-08-03,LG3,Alumni,0,0,0,0,0,0
2018-08-03,LG3,Others(HKUST),5,34,167239,203882534,5402639920,5606522454
2018-08-03,LG3,Non-HKUST,1,6,25447,5929833,16414650,22344483
2018-08-03,LG3,Total,66,183,1064582,2352025473,27802797866,30154823339
2018-08-03,LG4,Staff,14,38,258355,256451226,6558136264,6814587490
2018-08-03,LG4,TPG,4,17,121645,146099459,2500842327,2646941786
2018-08-03,LG4,RPG,14,53,403464,752711477,8681180190,9433891667
2018-08-03,LG4,UG,28,69,435006,479014742,6165060443,6644075185
2018-08-03,LG4,Alumni,5,17,105867,181446899,3271066884,3452513783
2018-08-03,LG4,Others(HKUST),5,6,32032,24400395,368402457,392802852
2018-08-03,LG4,Non-HKUST,2,3,15726,8607580,35708111,44315691
2018-08-03,LG4,Total,72,203,1372095,1848731778,27580396676,29429128454
2018-08-03,All-Floors,Staff,128,446,2891460,2222450271,30744150743,32966601014
2018-08-03,All-Floors,TPG,55,212,1491773,1569948120,18493799427,20063747547
2018-08-03,All-Floors,RPG,94,338,2035932,3606096023,33251442293,36857538316
2018-08-03,All-Floors,UG,290,969,6286920,23692687819,148772782356,172465470175
2018-08-03,All-Floors,Alumni,14,35,220762,325494186,9359388472,9684882658
2018-08-03,All-Floors,Others(HKUST),46,151,854713,1287811883,24238783581,25526595464
2018-08-03,All-Floors,Non-HKUST,27,69,409668,839767757,10826445152,11666212909
2018-08-03,All-Floors,Total,654,2220,14191228,33544256059,275686792024,309231048083
2018-08-04,1,Staff,10,27,150671,159015554,1431213901,1590229455
2018-08-04,1,TPG,18,57,452195,958276651,7605717418,8563994069
2018-08-04,1,RPG,10,32,208156,633742013,1860560620,2494302633
2018-08-04,1,UG,25,91,583167,2107997392,24617495690,26725493082
2018-08-04,1,Alumni,6,8,43895,69796048,1907944401,1977740449
2018-08-04,1,Others(HKUST),4,33,119886,344967441,497637379,842604820
2018-08-04,1,Non-HKUST,2,5,54187,56468038,322352782,378820820
2018-08-04,1,Total,75,253,1612157,4330263137,38242922191,42573185328
2018-08-04,G,Staff,26,65,287469,542275436,4206772560,4749047996
2018-08-04,G,TPG,12,28,305250,536109883,6728265220,7264375103
2018-08-04,G,RPG,16,48,331724,476702439,3283445679,3760148118
2018-08-04,G,UG,59,129,810675,2355751770,11568227937,13923979707
2018-08-04,G,Alumni,9,20,109886,223697079,701602902,925299981
2018-08-04,G,Others(HKUST),7,22,164364,83488683,455027992,538516675
2018-08-04,G,Non-HKUST,9,16,131118,93069039,2296113277,2389182316
2018-08-04,G,Total,138,328,2140486,4311094329,29239455567,33550549896
2018-08-04,LG1,Staff,10,21,80792,79171866,486336853,565508719
2018-08-04,LG1,TPG,17,37,267933,767587511,7946014474,8713601985
2018-08-04,LG1,RPG,24,55,314719,658845182,6266227737,6925072919
2018-08-04,LG1,UG,140,412,2923530,13581221772,91003564279,104584786051
2018-08-04,LG1,Alumni,9,28,124209,125221634,2698583652,2823805286
2018-08-04,LG1,Others(HKUST),8,21,156683,116696472,3209588238,3326284710
2018-08-04,LG1,Non-HKUST,11,18,137460,1015179919,8133354888,9148534807
2018-08-04,LG1,Total,219,592,4005326,16343924356,119743670121,136087594477
2018-08-04,LG3,Staff,6,12,92330,82313803,3827974290,3910288093
2018-08-04,LG3,TPG,1,2,7258,544287,829121,1373408
2018-08-04,LG3,RPG,16,38,252806,281465984,5120694544,5402160528
2018-08-04,LG3,UG,25,59,328415,3558602083,16499221105,20057823188
2018-08-04,LG3,Alumni,5,8,45136,59667053,2071876798,2131543851
2018-08-04,LG3,Others(HKUST),3,22,121399,99965574,2325322643,2425288217
2018-08-04,LG3,Non-HKUST,1,2,12409,17129733,330506694,347636427
2018-08-04,LG3,Total,57,143,859753,4099688517,30176425195,34276113712
2018-08-04,LG4,Staff,5,12,52623,128053944,4725114902,4853168846
2018-08-04,LG4,TPG,4,12,94470,52014298,396116564,448130862
2018-08-04,LG4,RPG,15,51,395380,510107854,7059158800,7569266654
2018-08-04,LG4,UG,18,52,299883,208359231,3763775624,3972134855
2018-08-04,LG4,Alumni,4,20,156840,117668429,5057526624,5175195053
2018-08-04,LG4,Others(HKUST),1,2,6040,48573156,48494360,97067516
2018-08-04,LG4,Non-HKUST,0,0,0,0,0,0
2018-08-04,LG4,Total,47,149,1005236,1064776912,21050186874,22114963786
2018-08-04,All-Floors,Staff,46,137,663885,990830603,14677412506,15668243109
2018-08-04,All-Floors,TPG,47,136,1127106,2314532630,22676942797,24991475427
2018-08-04,All-Floors,RPG,71,224,1502785,2560863472,23590087380,26150950852
2018-08-04,All-Floors,UG,229,743,4945670,21811932248,147452284635,169264216883
2018-08-04,All-Floors,Alumni,28,84,479966,596050243,12437534377,13033584620
2018-08-04,All-Floors,Others(HKUST),20,100,568372,693691326,6536070612,7229761938
2018-08-04,All-Floors,Non-HKUST,23,41,335174,1181846729,11082327641,12264174370
2018-08-04,All-Floors,Total,464,1465,9622958,30149747251,238452659948,268602407199
2018-08-05,1,Staff,9,38,206775,137795689,3256657166,3394452855
2018-08-05,1,TPG,19,58,348255,863015553,22825243509,23688259062
2018-08-05,1,RPG,8,21,151115,254413503,4276998980,4531412483
2018-08-05,1,UG,16,45,335175,387457871,9995679151,10383137022
2018-08-05,1,Alumni,4,9,43857,20529269,1063844835,1084374104
2018-08-05,1,Others(HKUST),3,25,81212,37100602,1291581596,1328682198
2018-08-05,1,Non-HKUST,3,5,56638,21448493,445737408,467185901
2018-08-05,1,Total,62,201,1223027,1721760980,43155742645,44877503625
2018-08-05,G,Staff,16,40,204974,350520436,1158939870,1509460306
2018-08-05,G,TPG,14,33,189337,178751297,3443088266,3621839563
2018-08-05,G,RPG,16,31,156784,82276882,1944951144,2027228026
2018-08-05,G,UG,26,67,452042,593251334,4864922005,5458173339
2018-08-05,G,Alumni,10,19,79728,106316581,2284571375,2390887956
2018-08-05,G,Others(HKUST),5,16,110229,153880710,2306794549,2460675259
2018-08-05,G,Non-HKUST,8,17,99923,143764104,2805772632,2949536736
2018-08-05,G,Total,95,223,1293017,1608761344,18809039841,20417801185
2018-08-05,LG1,Staff,6,11,66670,200509409,936034311,1136543720
2018-08-05,LG1,TPG,20,56,344145,287376872,3040941319,3328318191
2018-08-05,LG1,RPG,19,39,247638,4772674456,4985418279,9758092735
2018-08-05,LG1,UG,93,284,1955546,4818334718,39157443804,43975778522
2018-08-05,LG1,Alumni,12,21,110562,328562738,8143546256,8472108994
2018-08-05,LG1,Others(HKUST),7,21,172167,230612938,2033319821,2263932759
2018-08-05,LG1,Non-HKUST,6,9,68787,66639151,1186289207,1252928358
2018-08-05,LG1,Total,163,441,2965515,10704710282,59482992997,70187703279
2018-08-05,LG3,Staff,4,7,34799,9946563,301861988,311808551
2018-08-05,LG3,TPG,1,2,38209,112768359,2679837458,2792605817
2018-08-05,LG3,RPG,12,31,218552,193461495,4596456620,4789918115
2018-08-05,LG3,UG,16,35,191306,349630347,8363986808,8713617155
2018-08-05,LG3,Alumni,6,9,44509,28910588,603461392,632371980
2018-08-05,LG3,Others(HKUST),3,5,28096,7918454,37775480,45693934
2018-08-05,LG3,Non-HKUST,2,3,34505,115179921,9267605991,9382785912
2018-08-05,LG3,Total,44,92,589976,817815727,25850985737,26668801464
2018-08-05,LG4,Staff,6,18,67367,2535986293,583881866,3119868159
2018-08-05,LG4,TPG,4,24,148942,140402408,2376550858,2516953266
2018-08-05,LG4,RPG,11,27,202674,126378739,3742706201,3869084940
2018-08-05,LG4,UG,18,37,217410,220180652,5739678067,5959858719
2018-08-05,LG4,Alumni,5,14,119189,275826244,4683289930,4959116174
2018-08-05,LG4,Others(HKUST),2,3,21845,5879734,67644009,73523743
2018-08-05,LG4,Non-HKUST,2,4,22728,11940668,37730555,49671223
2018-08-05,LG4,Total,48,127,800155,3316594738,17231481486,20548076224
2018-08-05,All-Floors,Staff,35,114,580585,3234758390,6237375201,9472133591
2018-08-05,All-Floors,TPG,52,173,1068888,1582314489,34365661410,35947975899
2018-08-05,All-Floors,RPG,58,149,976763,5429205075,19546531224,24975736299
2018-08-05,All-Floors,UG,153,468,3151479,6368854922,68121709835,74490564757
2018-08-05,All-Floors,Alumni,28,72,397845,760145420,16778713788,17538859208
2018-08-05,All-Floors,Others(HKUST),19,70,413549,435392438,5737115455,6172507893
2018-08-05,All-Floors,Non-HKUST,20,38,282581,358972337,13743135793,14102108130
2018-08-05,All-Floors,Total,365,1084,6871690,18169643071,164530242706,182699885777
2018-08-06,1,Staff,50,144,1067119,762493277,9154724772,9917218049
2018-08-06,1,TPG,24,112,792433,1204372059,20600703808,21805075867
2018-08-06,1,RPG,11,53,356786,1131295611,4370543880,5501839491
2018-08-06,1,UG,41,150,1041433,21966298358,29156080990,51122379348
2018-08-06,1,Alumni,4,12,55765,35711843,1086297586,1122009429
2018-08-06,1,Others(HKUST),10,48,266075,1195199246,9252305594,10447504840
2018-08-06,1,Non-HKUST,5,15,99851,130475030,2271278654,2401753684
2018-08-06,1,Total,145,534,3679462,26425845424,75891935284,102317780708
2018-08-06,G,Staff,63,166,907538,1385762875,4407944574,5793707449
2018-08-06,G,TPG,29,73,478386,691009168,10458510704,11149519872
2018-08-06,G,RPG,31,70,421161,247990840,2766651225,3014642065
2018-08-06,G,UG,77,190,1167806,1505616860,14449600662,15955217522
2018-08-06,G,Alumni,7,12,131147,8172544197,6164882238,14337426435
2018-08-06,G,Others(HKUST),20,62,325030,957107527,8893853558,9850961085
2018-08-06,G,Non-HKUST,11,26,181984,407549528,1520923544,1928473072
2018-08-06,G,Total,238,599,3613052,13367580995,48662366505,62029947500
2018-08-06,LG1,Staff,35,78,464207,625763970,3171019218,3796783188
2018-08-06,LG1,TPG,26,67,433557,857959783,13802299825,14660259608
2018-08-06,LG1,RPG,47,118,675150,864823459,7039686092,7904509551
2018-08-06,LG1,UG,176,510,3163116,14549172428,102258920507,116808092935
2018-08-06,LG1,Alumni,9,26,152548,960514437,5748639068,6709153505
2018-08-06,LG1,Others(HKUST),22,68,478986,553213844,11817113475,12370327319
2018-08-06,LG1,Non-HKUST,11,26,107474,71350230,1646755460,1718105690
2018-08-06,LG1,Total,326,893,5475038,18482798151,145484433645,163967231796
2018-08-06,LG3,Staff,13,22,91045,74274113,833812670,908086783
2018-08-06,LG3,TPG,8,12,83277,203077654,5694630153,5897707807
2018-08-06,LG3,RPG,16,31,242590,10524764685,9717845646,20242610331
2018-08-06,LG3,UG,38,79,568003,723069818,8450848031,9173917849
2018-08-06,LG3,Alumni,2,2,6355,326126,244681,570807
2018-08-06,LG3,Others(HKUST),8,30,173208,656174114,4716090391,5372264505
2018-08-06,LG3,Non-HKUST,1,2,47314,1374907698,1418970095,2793877793
2018-08-06,LG3,Total,86,178,1211792,13556594208,30832441667,44389035875
2018-08-06,LG4,Staff,11,25,117150,174562514,4100310242,4274872756
2018-08-06,LG4,TPG,2,6,41776,6326238,51483046,57809284
2018-08-06,LG4,RPG,19,79,550872,884685231,8930874348,9815559579
2018-08-06,LG4,UG,26,46,341551,873179740,8564696045,9437875785
2018-08-06,LG4,Alumni,5,22,177187,122354817,7249908466,7372263283
2018-08-06,LG4,Others(HKUST),4,8,33596,60994814,1970037355,2031032169
2018-08-06,LG4,Non-HKUST,2,5,25990,411945040,280166075,692111115
2018-08-06,LG4,Total,69,191,1288122,2534048394,31147475577,33681523971
2018-08-06,All-Floors,Staff,128,435,2647059,3022856749,21667811476,24690668225
2018-08-06,All-Floors,TPG,77,270,1829429,2962744902,50607627536,53570372438
2018-08-06,All-Floors,RPG,106,351,2246559,13653559826,32825601191,46479161017
2018-08-06,All-Floors,UG,307,975,6281909,39617337204,162880146235,202497483439
2018-08-06,All-Floors,Alumni,24,74,523002,9291451420,20249972039,29541423459
2018-08-06,All-Floors,Others(HKUST),52,216,1276895,3422689545,36649400373,40072089918
2018-08-06,All-Floors,Non-HKUST,27,74,462613,2396227526,7138093828,9534321354
2018-08-06,All-Floors,Total,721,2395,15267466,74366867172,332018652678,406385519850
2018-08-07,1,Staff,42,131,790862,629531706,6778899647,7408431353
2018-08-07,1,TPG,21,77,589896,1051488783,7394465886,8445954669
2018-08-07,1,RPG,15,68,395866,879411831,8625247293,9504659124
2018-08-07,1,UG,47,141,988554,1260262910,17499389252,18759652162
2018-08-07,1,Alumni,5,7,46100,46597295,2737815363,2784412658
2018-08-07,1,Others(HKUST),17,72,344572,2031112264,2251149574,4282261838
2018-08-07,1,Non-HKUST,5,10,108349,133968499,1159096860,1293065359
2018-08-07,1,Total,152,506,3264199,6032373288,46446063875,52478437163
2018-08-07,G,Staff,62,148,881625,743312711,5175901544,5919214255
2018-08-07,G,TPG,10,22,196159,629144021,4851403693,5480547714
2018-08-07,G,RPG,28,65,370017,726686625,6538564096,7265250721
2018-08-07,G,UG,57,165,913319,2506986433,28920042928,31427029361
2018-08-07,G,Alumni,14,28,209361,8503942149,6490094570,14994036719
2018-08-07,G,Others(HKUST),16,41,233734,229755682,4826982197,5056737879
2018-08-07,G,Non-HKUST,11,23,158871,124046265,3446798221,3570844486
2018-08-07,G,Total,198,492,2963086,13463873886,60249787249,73713661135
2018-08-07,LG1,Staff,28,72,425190,1178146820,4759470733,5937617553
2018-08-07,LG1,TPG,13,36,277978,5837475775,6209117143,12046592918
2018-08-07,LG1,RPG,61,187,981749,2591260836,13722903800,16314164636
2018-08-07,LG1,UG,173,593,3540646,12177384726,90229344647,102406729373
2018-08-07,LG1,Alumni,8,29,213389,340772321,10483563807,10824336128
2018-08-07,LG1,Others(HKUST),24,55,401223,362254062,4791357637,5153611699
2018-08-07,LG1,Non-HKUST,6,11,58168,154259484,2646514707,2800774191
2018-08-07,LG1,Total,313,983,5898343,22641554024,132842272474,155483826498
2018-08-07,LG3,Staff,16,26,99664,267920511,1281929159,1549849670
2018-08-07,LG3,TPG,1,3,13298,23747938,566097962,589845900
2018-08-07,LG3,RPG,16,35,213978,747732211,12413043115,13160775326
2018-08-07,LG3,UG,36,96,548720,1461909737,29131842695,30593752432
2018-08-07,LG3,Alumni,1,1,3353,13410898,281457973,294868871
2018-08-07,LG3,Others(HKUST),7,24,126458,147631222,3105011391,3252642613
2018-08-07,LG3,Non-HKUST,2,3,30909,96565966,4816555431,4913121397
2018-08-07,LG3,Total,79,188,1036380,2758918483,51595937726,54354856209
2018-08-07,LG4,Staff,13,27,152758,196430581,6318024367,6514454948
2018-08-07,LG4,TPG,4,32,230114,399672839,7142676802,7542349641
2018-08-07,LG4,RPG,18,87,607191,1345019302,11826005061,13171024363
2018-08-07,LG4,UG,40,91,555601,1120656113,12546119772,13666775885
2018-08-07,LG4,Alumni,5,14,108706,60392539,1446701384,1507093923
2018-08-07,LG4,Others(HKUST),5,21,129109,106958199,665539443,772497642
2018-08-07,LG4,Non-HKUST,3,8,59439,450943835,1568195287,2019139122
2018-08-07,LG4,Total,88,280,1842918,3680073408,41513262116,45193335524
2018-08-07,All-Floors,Staff,122,404,2350099,3015342329,24314225450,27329567779
2018-08-07,All-Floors,TPG,40,170,1307445,7941529356,26163761486,34105290842
2018-08-07,All-Floors,RPG,119,442,2568801,6290110805,53125763365,59415874170
2018-08-07,All-Floors,UG,307,1086,6546840,18527199919,178326739294,196853939213
2018-08-07,All-Floors,Alumni,28,79,580909,8965115202,21439633097,30404748299
2018-08-07,All-Floors,Others(HKUST),58,213,1235096,2877711429,15640040242,18517751671
2018-08-07,All-Floors,Non-HKUST,19,55,415736,959784049,13637160506,14596944555
2018-08-07,All-Floors,Total,693,2449,15004926,48576793089,332647323440,381224116529
2018-08-08,1,Staff,47,161,1116913,445367739,4247995840,4693363579
2018-08-08,1,TPG,20,64,553053,1361132708,10958727103,12319859811
2018-08-08,1,RPG,15,56,312573,307924636,2809366020,3117290656
2018-08-08,1,UG,35,145,960203,3662370783,25334931356,28997302139
2018-08-08,1,Alumni,2,5,51294,32431238,189989240,222420478
2018-08-08,1,Others(HKUST),6,38,165118,65503191,1543713485,1609216676
2018-08-08,1,Non-HKUST,4,9,42999,29947161,740235412,770182573
2018-08-08,1,Total,129,478,3202153,5904677456,45824958456,51729635912
2018-08-08,G,Staff,60,138,862193,600454493,3747371317,4347825810
2018-08-08,G,TPG,22,57,452777,351842602,5099489216,5451331818
2018-08-08,G,RPG,40,83,440673,1369306079,5856497288,7225803367
2018-08-08,G,UG,97,191,1134472,1367716517,15288042968,16655759485
2018-08-08,G,Alumni,11,25,137958,227151194,6369594591,6596745785
2018-08-08,G,Others(HKUST),11,32,157949,87351052,636837089,724188141
2018-08-08,G,Non-HKUST,13,30,197302,110365854,2698148146,2808514000
2018-08-08,G,Total,254,556,3383324,4114187791,39695980615,43810168406
2018-08-08,LG1,Staff,33,74,383417,2992171559,8190146779,11182318338
2018-08-08,LG1,TPG,21,49,301275,10613104035,5924786034,16537890069
2018-08-08,LG1,RPG,49,144,780905,1566306827,12364661751,13930968578
2018-08-08,LG1,UG,205,555,3376435,8190446146,119743486339,127933932485
2018-08-08,LG1,Alumni,7,31,228975,381719058,9358024784,9739743842
2018-08-08,LG1,Others(HKUST),15,30,277020,116632468,1195991739,1312624207
2018-08-08,LG1,Non-HKUST,11,19,93597,143040577,3122442030,3265482607
2018-08-08,LG1,Total,341,902,5441624,24003420670,159899539456,183902960126
2018-08-08,LG3,Staff,16,34,165140,131657321,1647322157,1778979478
2018-08-08,LG3,TPG,1,1,3332,2819478,37845526,40665004
2018-08-08,LG3,RPG,19,48,354971,2323252090,8256437499,10579689589
2018-08-08,LG3,UG,41,112,716950,1175435672,15087356082,16262791754
2018-08-08,LG3,Alumni,3,9,60641,61225666,1070982595,1132208261
2018-08-08,LG3,Others(HKUST),4,23,153216,225695638,7417157342,7642852980
2018-08-08,LG3,Non-HKUST,1,2,34021,72456256,5250776149,5323232405
2018-08-08,LG3,Total,85,229,1488271,3992542121,38767877350,42760419471
2018-08-08,LG4,Staff,17,31,153045,186033229,5326511979,5512545208
2018-08-08,LG4,TPG,7,34,196047,2929334728,6895412552,9824747280
2018-08-08,LG4,RPG,19,78,601632,1153987058,17429620254,18583607312
2018-08-08,LG4,UG,34,75,444056,3071376801,29449641931,32521018732
2018-08-08,LG4,Alumni,3,14,97428,227868972,3605710653,3833579625
2018-08-08,LG4,Others(HKUST),0,0,0,0,0,0
2018-08-08,LG4,Non-HKUST,2,7,38849,344753759,1813347969,2158101728
2018-08-08,LG4,Total,82,239,1531057,7913354547,64520245338,72433599885
2018-08-08,All-Floors,Staff,130,438,2680708,4355684341,23159348072,27515032413
2018-08-08,All-Floors,TPG,64,205,1506484,15258233551,28916260431,44174493982
2018-08-08,All-Floors,RPG,121,409,2490754,6720776690,46716582812,53437359502
2018-08-08,All-Floors,UG,358,1078,6632116,17467345919,204903458676,222370804595
2018-08-08,All-Floors,Alumni,22,84,576296,930396128,20594301863,21524697991
2018-08-08,All-Floors,Others(HKUST),34,123,753303,495182349,10793699655,11288882004
2018-08-08,All-Floors,Non-HKUST,27,67,406768,700563607,13624949706,14325513313
2018-08-08,All-Floors,Total,756,2404,15046429,45928182585,348708601215,394636783800
2018-08-09,1,Staff,56,165,1228470,698702839,7630755583,8329458422
2018-08-09,1,TPG,20,81,643368,2789942048,14235967601,17025909649
2018-08-09,1,RPG,6,17,123159,70525463,2143508194,2214033657
2018-08-09,1,UG,30,96,751320,2045154910,19339291245,21384446155
2018-08-09,1,Alumni,1,6,49194,61125387,4171678127,4232803514
2018-08-09,1,Others(HKUST),6,12,91228,49862793,638181199,688043992
2018-08-09,1,Non-HKUST,5,12,82518,100237940,1290221891,1390459831
2018-08-09,1,Total,124,389,2969257,5815551380,49449603840,55265155220
2018-08-09,G,Staff,49,118,849024,777485708,4343156286,5120641994
2018-08-09,G,TPG,25,62,466665,302354399,2931312799,3233667198
2018-08-09,G,RPG,28,46,255130,481538280,3916124193,4397662473
2018-08-09,G,UG,77,165,1082515,3028217776,26486643311,29514861087
2018-08-09,G,Alumni,4,13,105385,238046404,6747826897,6985873301
2018-08-09,G,Others(HKUST),13,41,236913,239612017,3333495691,3573107708
2018-08-09,G,Non-HKUST,9,20,157723,88053505,1124387726,1212441231
2018-08-09,G,Total,205,465,3153355,5155308089,48882946903,54038254992
2018-08-09,LG1,Staff,23,50,287051,384869570,2337333667,2722203237
2018-08-09,LG1,TPG,17,58,476986,7171777091,12723574688,19895351779
2018-08-09,LG1,RPG,36,85,450203,392247577,4053560419,4445807996
2018-08-09,LG1,UG,161,447,2522703,10776509368,83247906464,94024415832
2018-08-09,LG1,Alumni,5,18,114260,166472745,3108500475,3274973220
2018-08-09,LG1,Others(HKUST),12,28,235625,343222908,4794723831,5137946739
2018-08-09,LG1,Non-HKUST,6,14,87402,178054499,2369698465,2547752964
2018-08-09,LG1,Total,260,700,4174230,19413153758,112635298009,132048451767
2018-08-09,LG3,Staff,17,32,145869,176910327,1136300433,1313210760
2018-08-09,LG3,TPG,5,11,102976,69614385,1593699118,1663313503
2018-08-09,LG3,RPG,19,53,401339,1242413071,12850707899,14093120970
2018-08-09,LG3,UG,32,70,468403,691108244,7956660967,8647769211
2018-08-09,LG3,Alumni,1,3,14225,51985267,218608611,270593878
2018-08-09,LG3,Others(HKUST),6,28,175694,122483241,3044532381,3167015622
2018-08-09,LG3,Non-HKUST,2,4,35224,15004770,175342785,190347555
2018-08-09,LG3,Total,82,201,1343730,2369519305,26975852194,29345371499
2018-08-09,LG4,Staff,13,21,122589,109667706,3888456066,3998123772
2018-08-09,LG4,TPG,6,29,201625,317728768,3019331188,3337059956
2018-08-09,LG4,RPG,18,72,610917,1942696274,19159642744,21102339018
2018-08-09,LG4,UG,23,39,285410,1337376383,13487708365,14825084748
2018-08-09,LG4,Alumni,7,20,166842,307478490,3591583115,3899061605
2018-08-09,LG4,Others(HKUST),1,1,49876,2053278,12582420,14635698
2018-08-09,LG4,Non-HKUST,2,2,16979,14778193,337892057,352670250
2018-08-09,LG4,Total,70,184,1454238,4031779092,43497195955,47528975047
2018-08-09,All-Floors,Staff,118,386,2633003,2147636150,19336002035,21483638185
2018-08-09,All-Floors,TPG,61,241,1891620,10651416691,34503885394,45155302085
2018-08-09,All-Floors,RPG,100,273,1840748,4129420665,42123543449,46252964114
2018-08-09,All-Floors,UG,288,817,5110351,17878366681,150518210352,168396577033
2018-08-09,All-Floors,Alumni,17,60,449906,825108293,17838197225,18663305518
2018-08-09,All-Floors,Others(HKUST),30,110,789336,757234237,11823515522,12580749759
2018-08-09,All-Floors,Non-HKUST,20,52,379846,396128907,5297542924,5693671831
2018-08-09,All-Floors,Total,634,1939,13094810,36785311624,281440896901,318226208525
2018-08-10,1,Staff,46,159,1179778,1825072326,18329742175,20154814501
2018-08-10,1,TPG,17,70,517666,432484466,10470756237,10903240703
2018-08-10,1,RPG,11,32,253949,231407897,3601950127,3833358024
2018-08-10,1,UG,30,101,664411,1420852268,8343348392,9764200660
2018-08-10,1,Alumni,0,0,0,0,0,0
2018-08-10,1,Others(HKUST),12,30,167528,465645867,4367042939,4832688806
2018-08-10,1,Non-HKUST,3,8,30880,46463693,1946996122,1993459815
2018-08-10,1,Total,119,400,2814212,4421926517,47059835992,51481762509
2018-08-10,G,Staff,56,130,676906,794733914,3448220463,4242954377
2018-08-10,G,TPG,23,65,465964,428642061,2940487624,3369129685
2018-08-10,G,RPG,25,52,285908,280741701,4773424543,5054166244
2018-08-10,G,UG,55,101,522729,583400624,6677863144,7261263768
2018-08-10,G,Alumni,5,16,81807,94400917,2881633172,2976034089
2018-08-10,G,Others(HKUST),23,46,289360,381794879,7986093879,8367888758
2018-08-10,G,Non-HKUST,14,34,196498,156906707,1389418875,1546325582
2018-08-10,G,Total,201,444,2519172,2720620803,30097141700,32817762503
2018-08-10,LG1,Staff,27,60,345379,413577958,9982425251,10396003209
2018-08-10,LG1,TPG,20,64,471024,1157593743,8748245034,9905838777
2018-08-10,LG1,RPG,41,90,497768,1374821242,6728799654,8103620896
2018-08-10,LG1,UG,116,368,2238201,3654978611,58624390732,62279369343
2018-08-10,LG1,Alumni,3,19,212712,184857292,3072898526,3257755818
2018-08-10,LG1,Others(HKUST),21,36,189917,257554313,8330707696,8588262009
2018-08-10,LG1,Non-HKUST,7,15,76970,415798231,2748462192,3164260423
2018-08-10,LG1,Total,235,652,4031971,7459181390,98235929085,105695110475
2018-08-10,LG3,Staff,14,29,133008,113140007,1842832127,1955972134
2018-08-10,LG3,TPG,6,13,52670,51893083,1455421710,1507314793
2018-08-10,LG3,RPG,21,49,311018,1604956039,16767834798,18372790837
2018-08-10,LG3,UG,29,56,325233,1763481590,5396258973,7159740563
2018-08-10,LG3,Alumni,3,9,60506,36437813,322374616,358812429
2018-08-10,LG3,Others(HKUST),4,14,84841,105557242,3245627697,3351184939
2018-08-10,LG3,Non-HKUST,2,3,16648,56818706,5126326159,5183144865
2018-08-10,LG3,Total,79,173,983924,3732284480,34156676080,37888960560
2018-08-10,LG4,Staff,15,24,150243,961144504,5931813177,6892957681
2018-08-10,LG4,TPG,7,34,237518,340813218,3821893488,4162706706
2018-08-10,LG4,RPG,17,64,438386,1472981574,15064717445,16537699019
2018-08-10,LG4,UG,19,51,263156,2328712305,59490813793,61819526098
2018-08-10,LG4,Alumni,3,22,200963,267568850,8111388403,8378957253
2018-08-10,LG4,Others(HKUST),5,10,134683,125698821,2399028837,2524727658
2018-08-10,LG4,Non-HKUST,2,10,60917,136573182,6243711029,6380284211
2018-08-10,LG4,Total,68,215,1485866,5633492454,101063366172,106696858626
2018-08-10,All-Floors,Staff,123,402,2485314,4107668709,39535033193,43642701902
2018-08-10,All-Floors,TPG,59,246,1744842,2411426571,27436804093,29848230664
2018-08-10,All-Floors,RPG,103,287,1787029,4964908453,46936726567,51901635020
2018-08-10,All-Floors,UG,207,677,4013730,9751425398,138532675034,148284100432
2018-08-10,All-Floors,Alumni,12,66,555988,583264872,14388294717,14971559589
2018-08-10,All-Floors,Others(HKUST),56,136,866329,1336251122,26328501048,27664752170
2018-08-10,All-Floors,Non-HKUST,23,70,381913,812560519,17454914377,18267474896
2018-08-10,All-Floors,Total,583,1884,11835145,23967505644,310612949029,334580454673
2018-08-11,1,Staff,10,49,279906,244701628,5131817682,5376519310
2018-08-11,1,TPG,20,70,560798,998516079,14207795410,15206311489
2018-08-11,1,RPG,6,24,187607,638269861,12949682816,13587952677
2018-08-11,1,UG,17,48,297824,334420912,7043219450,7377640362
2018-08-11,1,Alumni,1,1,3025,248512,411707,660219
2018-08-11,1,Others(HKUST),1,5,15125,28623,72330,100953
2018-08-11,1,Non-HKUST,1,2,9687,24318203,15082507,39400710
2018-08-11,1,Total,56,199,1353972,2240503818,39348081902,41588585720
2018-08-11,G,Staff,17,44,203871,113733303,581344277,695077580
2018-08-11,G,TPG,12,38,323209,560982378,6335934721,6896917099
2018-08-11,G,RPG,18,32,203989,223036961,2831459149,3054496110
2018-08-11,G,UG,48,132,786978,1553615525,15050781700,16604397225
2018-08-11,G,Alumni,7,12,87875,100847285,1445551584,1546398869
2018-08-11,G,Others(HKUST),4,10,53249,30371435,127407342,157778777
2018-08-11,G,Non-HKUST,4,6,81517,141736108,588823628,730559736
2018-08-11,G,Total,110,274,1740688,2724322995,26961302401,29685625396
2018-08-11,LG1,Staff,13,36,202063,746202758,9415570303,10161773061
2018-08-11,LG1,TPG,10,35,339440,1291800558,10856325579,12148126137
2018-08-11,LG1,RPG,38,93,528807,551437836,15150849415,15702287251
2018-08-11,LG1,UG,89,264,1812918,4326053137,48141220337,52467273474
2018-08-11,LG1,Alumni,5,13,83933,114135459,3652945232,3767080691
2018-08-11,LG1,Others(HKUST),2,3,33994,48445655,1185378758,1233824413
2018-08-11,LG1,Non-HKUST,7,10,96934,278416666,1338071389,1616488055
2018-08-11,LG1,Total,164,454,3098089,7356492069,89740361013,97096853082
2018-08-11,LG3,Staff,3,4,31811,15117814,780785820,795903634
2018-08-11,LG3,TPG,1,1,3025,8349486,150752204,159101690
2018-08-11,LG3,RPG,14,48,341282,535159830,9788277327,10323437157
2018-08-11,LG3,UG,13,25,123960,113239641,1888259049,2001498690
2018-08-11,LG3,Alumni,7,29,177335,386457896,4250172741,4636630637
2018-08-11,LG3,Others(HKUST),1,5,55474,50797888,672021282,722819170
2018-08-11,LG3,Non-HKUST,3,7,56679,74622151,3832761802,3907383953
2018-08-11,LG3,Total,42,119,789566,1183744706,21363030225,22546774931
2018-08-11,LG4,Staff,9,15,65994,370139498,3635431712,4005571210
2018-08-11,LG4,TPG,3,17,126983,123664147,3102941699,3226605846
2018-08-11,LG4,RPG,12,41,319455,2486205524,13714640443,16200845967
2018-08-11,LG4,UG,12,24,181148,249302351,5689489076,5938791427
2018-08-11,LG4,Alumni,4,11,114939,1296231725,7059522797,8355754522
2018-08-11,LG4,Others(HKUST),2,2,6347,26015870,0,26015870
2018-08-11,LG4,Non-HKUST,0,0,0,0,0,0
2018-08-11,LG4,Total,42,110,814866,4551559115,33202025727,37753584842
2018-08-11,All-Floors,Staff,46,148,783645,1489895001,19544949794,21034844795
2018-08-11,All-Floors,TPG,44,161,1353455,2983312648,34653749613,37637062261
2018-08-11,All-Floors,RPG,77,238,1581140,4434110012,54434909150,58869019162
2018-08-11,All-Floors,UG,157,493,3202828,6576631566,77812969612,84389601178
2018-08-11,All-Floors,Alumni,23,66,467107,1897920877,16408604061,18306524938
2018-08-11,All-Floors,Others(HKUST),9,25,164189,155659471,1984879712,2140539183
2018-08-11,All-Floors,Non-HKUST,14,25,244817,519093128,5774739326,6293832454
2018-08-11,All-Floors,Total,370,1156,7797181,18056622703,210614801268,228671423971
2018-08-12,1,Staff,9,33,199989,336646197,8775822953,9112469150
2018-08-12,1,TPG,13,30,250961,220171940,4580559094,4800731034
2018-08-12,1,RPG,4,15,101707,219584877,2258032386,2477617263
2018-08-12,1,UG,4,10,70520,81316688,1428079864,1509396552
2018-08-12,1,Alumni,5,11,75667,332881574,2326782569,2659664143
2018-08-12,1,Others(HKUST),2,16,49288,450055,1141553,1591608
2018-08-12,1,Non-HKUST,1,3,28442,33728709,186751321,220480030
2018-08-12,1,Total,38,118,776574,1224780040,19557169740,20781949780
2018-08-12,G,Staff,11,20,116831,36500061,1225237811,1261737872
2018-08-12,G,TPG,14,38,205869,161699993,6793622923,6955322916
2018-08-12,G,RPG,12,27,146504,245199363,4037797010,4282996373
2018-08-12,G,UG,20,58,271486,1579012166,3928334170,5507346336
2018-08-12,G,Alumni,11,25,144029,469907348,5389420639,5859327987
2018-08-12,G,Others(HKUST),0,0,0,0,0,0
2018-08-12,G,Non-HKUST,5,7,44808,10295562,151693826,161989388
2018-08-12,G,Total,73,175,929527,2502614493,21526106379,24028720872
2018-08-12,LG1,Staff,6,12,97112,136999049,1697011677,1834010726
2018-08-12,LG1,TPG,18,62,363194,581418139,16274356250,16855774389
2018-08-12,LG1,RPG,23,55,352159,649517605,8436778567,9086296172
2018-08-12,LG1,UG,67,163,1192881,1612306456,26217078923,27829385379
2018-08-12,LG1,Alumni,7,13,103177,445289427,16219794974,16665084401
2018-08-12,LG1,Others(HKUST),2,4,59007,16940693,91791894,108732587
2018-08-12,LG1,Non-HKUST,3,4,25417,48976922,542663797,591640719
2018-08-12,LG1,Total,126,313,2192947,3491448291,69479476082,72970924373
2018-08-12,LG3,Staff,7,8,34189,9060640,37806588,46867228
2018-08-12,LG3,TPG,3,5,36366,219483729,3462694390,3682178119
2018-08-12,LG3,RPG,10,26,186230,455287160,5224142797,5679429957
2018-08-12,LG3,UG,23,57,255959,319879080,2969426971,3289306051
2018-08-12,LG3,Alumni,4,8,71729,31354900,520170494,551525394
2018-08-12,LG3,Others(HKUST),1,1,3026,11245235,124332543,135577778
2018-08-12,LG3,Non-HKUST,2,7,57228,88030414,5718068522,5806098936
2018-08-12,LG3,Total,50,112,644727,1134341158,18056642305,19190983463
2018-08-12,LG4,Staff,3,3,9367,3168809,75673441,78842250
2018-08-12,LG4,TPG,5,14,110174,188801780,6588598530,6777400310
2018-08-12,LG4,RPG,11,25,178944,177214538,3545562013,3722776551
2018-08-12,LG4,UG,4,10,62032,44561283,2659559618,2704120901
2018-08-12,LG4,Alumni,10,26,171019,476026851,5423853713,5899880564
2018-08-12,LG4,Others(HKUST),2,2,6046,644225,3822120,4466345
2018-08-12,LG4,Non-HKUST,1,2,6046,951238,2024738,2975976
2018-08-12,LG4,Total,36,82,543628,891368724,18299094173,19190462897
2018-08-12,All-Floors,Staff,29,76,457488,522374756,11811552470,12333927226
2018-08-12,All-Floors,TPG,46,149,966564,1371575581,37699831187,39071406768
2018-08-12,All-Floors,RPG,58,148,965544,1746803543,23502312773,25249116316
2018-08-12,All-Floors,UG,106,298,1852878,3637075673,37202479546,40839555219
2018-08-12,All-Floors,Alumni,33,83,565621,1755460100,29880022389,31635482489
2018-08-12,All-Floors,Others(HKUST),7,23,117367,29280208,221088110,250368318
2018-08-12,All-Floors,Non-HKUST,12,23,161941,181982845,6601202204,6783185049
2018-08-12,All-Floors,Total,291,800,5087403,9244552706,146918488679,156163041385
2018-08-13,1,Staff,53,187,1124219,641908395,7239585724,7881494119
2018-08-13,1,TPG,14,52,338100,264684021,9570221722,9834905743
2018-08-13,1,RPG,10,37,292228,2332361828,7665090694,9997452522
2018-08-13,1,UG,19,65,488516,661794446,7846472437,8508266883
2018-08-13,1,Alumni,0,0,0,0,0,0
2018-08-13,1,Others(HKUST),3,19,85026,20286603,1307574692,1327861295
2018-08-13,1,Non-HKUST,1,2,12693,4255704,24262293,28517997
2018-08-13,1,Total,100,362,2340782,3925290997,33653207562,37578498559
2018-08-13,G,Staff,60,138,862495,967813993,3692561496,4660375489
2018-08-13,G,TPG,19,56,340926,596146247,6313767654,6909913901
2018-08-13,G,RPG,21,48,266747,142848197,3218481785,3361329982
2018-08-13,G,UG,44,122,661705,3023818696,9414777087,12438595783
2018-08-13,G,Alumni,7,23,151516,180712227,3243530836,3424243063
2018-08-13,G,Others(HKUST),4,10,59298,24995988,179154195,204150183
2018-08-13,G,Non-HKUST,8,23,152423,123606607,6492861152,6616467759
2018-08-13,G,Total,163,420,2495110,5059941955,32555134205,37615076160
2018-08-13,LG1,Staff,24,48,315121,739835033,6035977354,6775812387
2018-08-13,LG1,TPG,21,66,410740,870992715,16789876181,17660868896
2018-08-13,LG1,RPG,29,94,481648,1339229633,11467612163,12806841796
2018-08-13,LG1,UG,104,304,1813585,7798197492,42417172273,50215369765
2018-08-13,LG1,Alumni,3,11,77098,368527583,2784623780,3153151363
2018-08-13,LG1,Others(HKUST),1,1,41527,6163703,34099692,40263395
2018-08-13,LG1,Non-HKUST,8,10,54386,89415955,1052208157,1141624112
2018-08-13,LG1,Total,190,534,3194105,11212362114,80581569600,91793931714
2018-08-13,LG3,Staff,18,26,108523,502217594,2263475072,2765692666
2018-08-13,LG3,TPG,2,7,65347,146438182,559691356,706129538
2018-08-13,LG3,RPG,21,58,330560,392303015,8214567120,8606870135
2018-08-13,LG3,UG,30,90,581269,519406477,10027090495,10546496972
2018-08-13,LG3,Alumni,3,8,46862,36865045,539540991,576406036
2018-08-13,LG3,Others(HKUST),1,6,46283,28357661,222143153,250500814
2018-08-13,LG3,Non-HKUST,0,0,0,0,0,0
2018-08-13,LG3,Total,75,195,1178844,1625587974,21826508187,23452096161
2018-08-13,LG4,Staff,19,43,222285,400690075,3653217884,4053907959
2018-08-13,LG4,TPG,2,11,92602,51773744,887861683,939635427
2018-08-13,LG4,RPG,20,86,614659,1516797689,18893103564,20409901253
2018-08-13,LG4,UG,16,38,217098,1001772611,13465876096,14467648707
2018-08-13,LG4,Alumni,3,17,117074,264345333,6100666809,6365012142
2018-08-13,LG4,Others(HKUST),1,1,3325,0,0,0
2018-08-13,LG4,Non-HKUST,1,6,30835,93073080,4041197745,4134270825
2018-08-13,LG4,Total,62,202,1297878,3328452532,47041923781,50370376313
2018-08-13,All-Floors,Staff,127,442,2632643,3252465090,22884817530,26137282620
2018-08-13,All-Floors,TPG,51,192,1247715,1930034909,34121418596,36051453505
2018-08-13,All-Floors,RPG,91,323,1985842,5723540362,49458855326,55182395688
2018-08-13,All-Floors,UG,191,619,3762173,13004989722,83171388388,96176378110
2018-08-13,All-Floors,Alumni,15,59,392550,850450188,12668362416,13518812604
2018-08-13,All-Floors,Others(HKUST),9,37,235459,79803955,1742971732,1822775687
2018-08-13,All-Floors,Non-HKUST,17,41,250337,310351346,11610529347,11920880693
2018-08-13,All-Floors,Total,501,1713,10506719,25151635572,215658343335,240809978907
2018-08-14,1,Staff,58,182,1143529,805036789,18474699360,19279736149
2018-08-14,1,TPG,11,35,277430,340451078,6604256689,6944707767
2018-08-14,1,RPG,11,32,263708,374110779,5889603231,6263714010
2018-08-14,1,UG,19,57,412104,1823698313,10159592538,11983290851
2018-08-14,1,Alumni,0,0,0,0,0,0
2018-08-14,1,Others(HKUST),1,2,23921,1452613,23237768,24690381
2018-08-14,1,Non-HKUST,1,1,3615,4491826,50769693,55261519
2018-08-14,1,Total,101,309,2124307,3349241398,41202159279,44551400677
2018-08-14,G,Staff,63,140,788019,766512655,3141416528,3907929183
2018-08-14,G,TPG,14,44,303664,267843188,5901936997,6169780185
2018-08-14,G,RPG,30,59,383852,934038084,5958517519,6892555603
2018-08-14,G,UG,37,86,454536,1517551160,12008962602,13526513762
2018-08-14,G,Alumni,5,13,84751,143045079,5048511833,5191556912
2018-08-14,G,Others(HKUST),4,11,89578,47353673,268471538,315825211
2018-08-14,G,Non-HKUST,8,20,125123,102625885,2476022054,2578647939
2018-08-14,G,Total,161,373,2229523,3778969724,34803839071,38582808795
2018-08-14,LG1,Staff,26,50,299567,442331569,6153568416,6595899985
2018-08-14,LG1,TPG,15,54,341905,230529447,2574461650,2804991097
2018-08-14,LG1,RPG,28,64,428053,680456070,10677238464,11357694534
2018-08-14,LG1,UG,75,218,1326990,11043991012,38837999158,49881990170
2018-08-14,LG1,Alumni,4,8,43636,122739002,2071216507,2193955509
2018-08-14,LG1,Others(HKUST),2,10,60653,68872720,1632995334,1701868054
2018-08-14,LG1,Non-HKUST,6,8,80597,50830492,518819093,569649585
2018-08-14,LG1,Total,156,412,2581401,12639750312,62466298622,75106048934
2018-08-14,LG3,Staff,16,29,144082,217408350,2196929917,2414338267
2018-08-14,LG3,TPG,6,9,70397,118310388,3848521061,3966831449
2018-08-14,LG3,RPG,18,43,327714,520483011,8861424964,9381907975
2018-08-14,LG3,UG,14,27,165446,113153329,2118526073,2231679402
2018-08-14,LG3,Alumni,2,8,54516,139883000,5358756443,5498639443
2018-08-14,LG3,Others(HKUST),2,8,63948,21472118,551517069,572989187
2018-08-14,LG3,Non-HKUST,1,2,20609,63829209,3666542951,3730372160
2018-08-14,LG3,Total,59,126,846712,1194539405,26602218478,27796757883
2018-08-14,LG4,Staff,39,79,394809,2557435838,9589722288,12147158126
2018-08-14,LG4,TPG,7,22,179949,1667188610,11269993013,12937181623
2018-08-14,LG4,RPG,17,47,459481,2362740166,13227837229,15590577395
2018-08-14,LG4,UG,11,30,210054,719774667,20246449630,20966224297
2018-08-14,LG4,Alumni,7,29,223444,763183786,15746589457,16509773243
2018-08-14,LG4,Others(HKUST),1,1,3331,0,0,0
2018-08-14,LG4,Non-HKUST,0,0,0,0,0,0
2018-08-14,LG4,Total,82,208,1471068,8070323067,70080591617,78150914684
2018-08-14,All-Floors,Staff,148,480,2770006,4788725201,39556336509,44345061710
2018-08-14,All-Floors,TPG,47,164,1173345,2624322711,30199169410,32823492121
2018-08-14,All-Floors,RPG,90,245,1862808,4871828110,44614621407,49486449517
2018-08-14,All-Floors,UG,143,418,2569130,15218168481,83371530001,98589698482
2018-08-14,All-Floors,Alumni,15,58,406347,1168850867,28225074240,29393925107
2018-08-14,All-Floors,Others(HKUST),8,32,241431,139151124,2476221709,2615372833
2018-08-14,All-Floors,Non-HKUST,13,31,229944,221777412,6712153791,6933931203
2018-08-14,All-Floors,Total,464,1428,9253011,29032823906,235155107067,264187930973
2018-08-15,1,Staff,58,174,1053072,506492477,7399736106,7906228583
2018-08-15,1,TPG,18,57,317225,871503927,7148481737,8019985664
2018-08-15,1,RPG,9,31,208985,208749545,3947987309,4156736854
2018-08-15,1,UG,22,91,549270,3501383715,14921661455,18423045170
2018-08-15,1,Alumni,2,4,30662,45698949,660168449,705867398
2018-08-15,1,Others(HKUST),3,5,33643,23526403,81405582,104931985
2018-08-15,1,Non-HKUST,4,5,19979,13683344,321762383,335445727
2018-08-15,1,Total,116,367,2212836,5171038360,34481203021,39652241381
2018-08-15,G,Staff,55,127,779726,509081367,5434878330,5943959697
2018-08-15,G,TPG,19,48,338032,270803338,4316053424,4586856762
2018-08-15,G,RPG,28,62,336129,1396471687,5162789291,6559260978
2018-08-15,G,UG,35,67,370151,1707361558,9048367808,10755729366
2018-08-15,G,Alumni,6,13,101663,180786637,3446430352,3627216989
2018-08-15,G,Others(HKUST),2,7,74194,9354844,117591649,126946493
2018-08-15,G,Non-HKUST,7,12,114287,77136097,4277029548,4354165645
2018-08-15,G,Total,152,336,2114182,4150995528,31803140402,35954135930
2018-08-15,LG1,Staff,29,59,398225,953241299,3923275379,4876516678
2018-08-15,LG1,TPG,13,57,299205,300494992,3242376888,3542871880
2018-08-15,LG1,RPG,30,83,492019,776018968,9835223975,10611242943
2018-08-15,LG1,UG,71,187,1318950,3476242442,38126102031,41602344473
2018-08-15,LG1,Alumni,5,21,161604,175459870,2185221551,2360681421
2018-08-15,LG1,Others(HKUST),2,4,57871,35768457,626948462,662716919
2018-08-15,LG1,Non-HKUST,6,11,86368,318904186,1525021608,1843925794
2018-08-15,LG1,Total,156,422,2814242,6036130214,59464169894,65500300108
2018-08-15,LG3,Staff,19,26,112881,147299847,762943897,910243744
2018-08-15,LG3,TPG,4,5,20951,23178020,440858012,464036032
2018-08-15,LG3,RPG,11,37,233591,319818568,6158526487,6478345055
2018-08-15,LG3,UG,10,27,165953,140292879,2092513641,2232806520
2018-08-15,LG3,Alumni,1,3,34337,61280631,1379268712,1440549343
2018-08-15,LG3,Others(HKUST),0,0,0,0,0,0
2018-08-15,LG3,Non-HKUST,2,3,24005,74027162,6531674074,6605701236
2018-08-15,LG3,Total,47,101,591718,765897107,17365784823,18131681930
2018-08-15,LG4,Staff,23,46,306493,942739343,10596969148,11539708491
2018-08-15,LG4,TPG,5,15,123997,347667161,8447389230,8795056391
2018-08-15,LG4,RPG,12,37,315328,1406493910,16692941015,18099434925
2018-08-15,LG4,UG,9,19,89244,104769791,2153707558,2258477349
2018-08-15,LG4,Alumni,4,26,169910,228528474,5647241789,5875770263
2018-08-15,LG4,Others(HKUST),0,0,0,0,0,0
2018-08-15,LG4,Non-HKUST,0,0,0,0,0,0
2018-08-15,LG4,Total,53,143,1004972,3030198679,43538248740,46568447419
2018-08-15,All-Floors,Staff,134,432,2650397,3058854333,28117802860,31176657193
2018-08-15,All-Floors,TPG,57,182,1099410,1813647438,23595159291,25408806729
2018-08-15,All-Floors,RPG,84,250,1586052,4107552678,41797468077,45905020755
2018-08-15,All-Floors,UG,134,391,2493568,8930050385,66342352493,75272402878
2018-08-15,All-Floors,Alumni,16,67,498176,691754561,13318330853,14010085414
2018-08-15,All-Floors,Others(HKUST),5,16,165708,68649704,825945693,894595397
2018-08-15,All-Floors,Non-HKUST,19,31,244639,483750789,12655487613,13139238402
2018-08-15,All-Floors,Total,449,1369,8737950,19154259888,186652546880,205806806768
2018-08-16,1,Staff,62,192,1332752,1784948274,27938114254,29723062528
2018-08-16,1,TPG,14,45,307887,831275812,15411537184,16242812996
2018-08-16,1,RPG,10,31,220798,552346085,4213242578,4765588663
2018-08-16,1,UG,27,82,687419,2800159983,26494327487,29294487470
2018-08-16,1,Alumni,1,5,61195,58972281,713601434,772573715
2018-08-16,1,Others(HKUST),4,10,38948,3533208,53906604,57439812
2018-08-16,1,Non-HKUST,3,7,35613,16384277,114367969,130752246
2018-08-16,1,Total,121,372,2684612,6047619920,74939097510,80986717430
2018-08-16,G,Staff,67,152,896378,493047313,3649345878,4142393191
2018-08-16,G,TPG,15,36,252032,309501929,3949956940,4259458869
2018-08-16,G,RPG,22,51,305890,439173809,6046549741,6485723550
2018-08-16,G,UG,43,87,533107,3200192968,10378383386,13578576354
2018-08-16,G,Alumni,7,14,76309,20997926,318768639,339766565
2018-08-16,G,Others(HKUST),5,22,180280,72743773,343056319,415800092
2018-08-16,G,Non-HKUST,9,22,126485,445706073,1448884375,1894590448
2018-08-16,G,Total,168,384,2370481,4981363791,26134945278,31116309069
2018-08-16,LG1,Staff,26,64,437607,418579983,2458675888,2877255871
2018-08-16,LG1,TPG,8,23,174037,315863795,4146616864,4462480659
2018-08-16,LG1,RPG,28,68,385079,1282648160,8434186451,9716834611
2018-08-16,LG1,UG,112,331,2109541,6937422201,50359479718,57296901919
2018-08-16,LG1,Alumni,3,7,71551,117179576,3164218707,3281398283
2018-08-16,LG1,Others(HKUST),4,7,32300,19631231,82812356,102443587
2018-08-16,LG1,Non-HKUST,3,6,46797,76054329,1190004569,1266058898
2018-08-16,LG1,Total,184,506,3256912,9167379275,69835994553,79003373828
2018-08-16,LG3,Staff,16,33,122712,81024259,248935779,329960038
2018-08-16,LG3,TPG,3,5,24533,5269605,63908346,69177951
2018-08-16,LG3,RPG,18,42,237160,401198308,3502877966,3904076274
2018-08-16,LG3,UG,28,66,348274,827249718,8496063195,9323312913
2018-08-16,LG3,Alumni,0,0,0,0,0,0
2018-08-16,LG3,Others(HKUST),0,0,0,0,0,0
2018-08-16,LG3,Non-HKUST,2,2,20278,573955632,409835613,983791245
2018-08-16,LG3,Total,67,148,752957,1888697522,12721620899,14610318421
2018-08-16,LG4,Staff,19,40,256480,2340563714,13249778835,15590342549
2018-08-16,LG4,TPG,6,21,140611,290004513,5201427312,5491431825
2018-08-16,LG4,RPG,12,50,343470,573645692,7495607688,8069253380
2018-08-16,LG4,UG,18,21,116081,916475352,4111733332,5028208684
2018-08-16,LG4,Alumni,7,21,147406,138858482,1908573722,2047432204
2018-08-16,LG4,Others(HKUST),1,6,86280,42298146,171842491,214140637
2018-08-16,LG4,Non-HKUST,2,2,10579,1601934,8727476,10329410
2018-08-16,LG4,Total,65,161,1100907,4303447833,32147690856,36451138689
2018-08-16,All-Floors,Staff,140,481,3045929,5118163543,47544850634,52663014177
2018-08-16,All-Floors,TPG,43,130,899100,1751915654,28773446646,30525362300
2018-08-16,All-Floors,RPG,83,242,1492397,3249012054,29692464424,32941476478
2018-08-16,All-Floors,UG,193,587,3794422,14681500222,99839987118,114521487340
2018-08-16,All-Floors,Alumni,16,47,356461,336008265,6105162502,6441170767
2018-08-16,All-Floors,Others(HKUST),10,45,337808,138206358,651617770,789824128
2018-08-16,All-Floors,Non-HKUST,17,39,239752,1113702245,3171820002,4285522247
2018-08-16,All-Floors,Total,502,1571,10165869,26388508341,215779349096,242167857437
2018-08-17,1,Staff,49,177,1213652,592664878,6900977171,7493642049
2018-08-17,1,TPG,35,108,698534,3971438893,18886230832,22857669725
2018-08-17,1,RPG,5,20,112225,91982592,1359225302,1451207894
2018-08-17,1,UG,14,30,300129,626726572,17234481044,17861207616
2018-08-17,1,Alumni,0,0,0,0,0,0
2018-08-17,1,Others(HKUST),2,8,27525,2676353,27798549,30474902
2018-08-17,1,Non-HKUST,1,2,17562,5479282,16262400,21741682
2018-08-17,1,Total,106,345,2369627,5290968570,44424975298,49715943868
2018-08-17,G,Staff,61,160,1006338,2606865852,7497094389,10103960241
2018-08-17,G,TPG,58,122,631766,2164942483,12985001488,15149943971
2018-08-17,G,RPG,24,49,297541,334591572,7837459101,8172050673
2018-08-17,G,UG,22,38,223004,157859115,1417961546,1575820661
2018-08-17,G,Alumni,0,0,0,0,0,0
2018-08-17,G,Others(HKUST),3,21,127195,57238285,381527112,438765397
2018-08-17,G,Non-HKUST,6,11,85766,21552647,286677628,308230275
2018-08-17,G,Total,174,401,2371610,5343049954,30405721264,35748771218
2018-08-17,LG1,Staff,28,70,416110,469972366,9656956906,10126929272
2018-08-17,LG1,TPG,16,40,243411,243665486,2495407455,2739072941
2018-08-17,LG1,RPG,34,71,392305,1166896622,5227671497,6394568119
2018-08-17,LG1,UG,78,222,1413376,5888032016,22236823035,28124855051
2018-08-17,LG1,Alumni,0,0,0,0,0,0
2018-08-17,LG1,Others(HKUST),4,9,128081,14474814,378844656,393319470
2018-08-17,LG1,Non-HKUST,7,15,115768,310927981,5672247785,5983175766
2018-08-17,LG1,Total,167,427,2709051,8093969285,45667951334,53761920619
2018-08-17,LG3,Staff,6,18,63585,28757609,647553116,676310725
2018-08-17,LG3,TPG,5,10,83486,2333257330,3236500372,5569757702
2018-08-17,LG3,RPG,14,39,273919,503913788,3796063259,4299977047
2018-08-17,LG3,UG,16,38,195700,215465733,1931809964,2147275697
2018-08-17,LG3,Alumni,0,0,0,0,0,0
2018-08-17,LG3,Others(HKUST),2,3,10302,3202853,27219308,30422161
2018-08-17,LG3,Non-HKUST,1,1,3633,0,0,0
2018-08-17,LG3,Total,44,109,630625,3084597313,9639146019,12723743332
2018-08-17,LG4,Staff,14,27,175479,931939113,11574020604,12505959717
2018-08-17,LG4,TPG,4,11,82215,52524370,298262558,350786928
2018-08-17,LG4,RPG,17,54,366614,883325879,7400475778,8283801657
2018-08-17,LG4,UG,15,25,162254,977013023,5699224806,6676237829
2018-08-17,LG4,Alumni,0,0,0,0,0,0
2018-08-17,LG4,Others(HKUST),2,2,10286,32735243,61725539,94460782
2018-08-17,LG4,Non-HKUST,3,7,35739,13893504,270838771,284732275
2018-08-17,LG4,Total,55,126,832587,2891431132,25304548056,28195979188
2018-08-17,All-Floors,Staff,126,452,2875164,4630199818,36276602186,40906802004
2018-08-17,All-Floors,TPG,106,291,1739412,8765828562,37901402705,46667231267
2018-08-17,All-Floors,RPG,82,233,1442604,2980710453,25620894937,28601605390
2018-08-17,All-Floors,UG,126,353,2294463,7865096459,48520300395,56385396854
2018-08-17,All-Floors,Alumni,0,0,0,0,0,0
2018-08-17,All-Floors,Others(HKUST),9,43,303389,110327548,877115164,987442712
2018-08-17,All-Floors,Non-HKUST,17,36,258468,351853414,6246026584,6597879998
2018-08-17,All-Floors,Total,466,1408,8913500,24704016254,155442341971,180146358225
2018-08-18,1,Staff,4,30,138591,176612062,2882373317,3058985379
2018-08-18,1,TPG,32,90,652196,2327631568,25636130266,27963761834
2018-08-18,1,RPG,9,24,149994,100564160,1829103768,1929667928
2018-08-18,1,UG,10,26,176440,503466281,8591321277,9094787558
2018-08-18,1,Alumni,0,0,0,0,0,0
2018-08-18,1,Others(HKUST),0,0,0,0,0,0
2018-08-18,1,Non-HKUST,2,7,50537,16551125,187061327,203612452
2018-08-18,1,Total,57,177,1167758,3124825196,39125989955,42250815151
2018-08-18,G,Staff,12,36,175854,81214371,1526845320,1608059691
2018-08-18,G,TPG,33,70,425896,1282420920,6323186604,7605607524
2018-08-18,G,RPG,39,78,428088,681190010,5412123076,6093313086
2018-08-18,G,UG,24,45,323315,776524970,4417978216,5194503186
2018-08-18,G,Alumni,0,0,0,0,0,0
2018-08-18,G,Others(HKUST),1,3,43667,692285,5301947,5994232
2018-08-18,G,Non-HKUST,7,17,114574,28839726,843682425,872522151
2018-08-18,G,Total,116,249,1511394,2850882282,18529117588,21379999870
2018-08-18,LG1,Staff,13,38,229319,462044739,6996138139,7458182878
2018-08-18,LG1,TPG,12,39,314946,1718893936,6698021770,8416915706
2018-08-18,LG1,RPG,28,68,400559,625094017,5969386224,6594480241
2018-08-18,LG1,UG,74,172,1107445,2144011262,28936902602,31080913864
2018-08-18,LG1,Alumni,0,0,0,0,0,0
2018-08-18,LG1,Others(HKUST),0,0,0,0,0,0
2018-08-18,LG1,Non-HKUST,3,8,46128,36303309,149011567,185314876
2018-08-18,LG1,Total,130,325,2098397,4986347263,48749460302,53735807565
2018-08-18,LG3,Staff,10,16,64157,52670146,445867758,498537904
2018-08-18,LG3,TPG,4,7,35877,20841306,296108817,316950123
2018-08-18,LG3,RPG,10,35,207064,89273996,543781651,633055647
2018-08-18,LG3,UG,10,20,98348,175652629,2956163437,3131816066
2018-08-18,LG3,Alumni,0,0,0,0,0,0
2018-08-18,LG3,Others(HKUST),1,1,3352,32684,124347,157031
2018-08-18,LG3,Non-HKUST,3,6,31737,151571297,421509036,573080333
2018-08-18,LG3,Total,38,85,440535,490042058,4663555046,5153597104
2018-08-18,LG4,Staff,4,12,78852,152780533,4813102128,4965882661
2018-08-18,LG4,TPG,6,16,114238,98921755,2133673606,2232595361
2018-08-18,LG4,RPG,11,28,227600,658161617,5639867328,6298028945
2018-08-18,LG4,UG,5,13,68643,313590742,4962299745,5275890487
2018-08-18,LG4,Alumni,0,0,0,0,0,0
2018-08-18,LG4,Others(HKUST),0,0,0,0,0,0
2018-08-18,LG4,Non-HKUST,0,0,0,0,0,0
2018-08-18,LG4,Total,26,69,489333,1223454647,17548942807,18772397454
2018-08-18,All-Floors,Staff,37,132,686773,925321851,16664326662,17589648513
2018-08-18,All-Floors,TPG,76,222,1543153,5448709485,41087121063,46535830548
2018-08-18,All-Floors,RPG,85,233,1413305,2154283800,19394262047,21548545847
2018-08-18,All-Floors,UG,110,276,1774191,3913245884,49864665277,53777911161
2018-08-18,All-Floors,Alumni,0,0,0,0,0,0
2018-08-18,All-Floors,Others(HKUST),2,4,47019,724969,5426294,6151263
2018-08-18,All-Floors,Non-HKUST,13,38,242976,233265457,1601264355,1834529812
2018-08-18,All-Floors,Total,323,905,5707417,12675551446,128617065698,141292617144
2018-08-19,1,Staff,2,23,83359,4337543,199014822,203352365
2018-08-19,1,TPG,0,0,0,0,0,0
2018-08-19,1,RPG,0,0,0,0,0,0
2018-08-19,1,UG,1,1,3016,156433,389872,546305
2018-08-19,1,Alumni,0,0,0,0,0,0
2018-08-19,1,Others(HKUST),0,0,0,0,0,0
2018-08-19,1,Non-HKUST,0,0,0,0,0,0
2018-08-19,1,Total,3,24,86375,4493976,199404694,203898670
2018-08-19,G,Staff,1,1,6652,67082,373798,440880
2018-08-19,G,TPG,0,0,0,0,0,0
2018-08-19,G,RPG,0,0,0,0,0,0
2018-08-19,G,UG,0,0,0,0,0,0
2018-08-19,G,Alumni,0,0,0,0,0,0
2018-08-19,G,Others(HKUST),0,0,0,0,0,0
2018-08-19,G,Non-HKUST,0,0,0,0,0,0
2018-08-19,G,Total,1,1,6652,67082,373798,440880
2018-08-19,LG1,Staff,21,73,478491,1542747845,8305021504,9847769349
2018-08-19,LG1,TPG,54,232,1629559,12751899644,46683382636,59435282280
2018-08-19,LG1,RPG,58,185,1268417,4147787291,21022437320,25170224611
2018-08-19,LG1,UG,145,483,3155867,8887157341,58189838595,67076995936
2018-08-19,LG1,Alumni,0,0,0,0,0,0
2018-08-19,LG1,Others(HKUST),0,0,0,0,0,0
2018-08-19,LG1,Non-HKUST,9,21,118784,232265711,6224607500,6456873211
2018-08-19,LG1,Total,287,994,6651118,27561857832,140425287555,167987145387
2018-08-19,LG3,Staff,0,0,0,0,0,0
2018-08-19,LG3,TPG,0,0,0,0,0,0
2018-08-19,LG3,RPG,0,0,0,0,0,0
2018-08-19,LG3,UG,0,0,0,0,0,0
2018-08-19,LG3,Alumni,0,0,0,0,0,0
2018-08-19,LG3,Others(HKUST),0,0,0,0,0,0
2018-08-19,LG3,Non-HKUST,0,0,0,0,0,0
2018-08-19,LG3,Total,0,0,0,0,0,0
2018-08-19,LG4,Staff,0,0,0,0,0,0
2018-08-19,LG4,TPG,0,0,0,0,0,0
2018-08-19,LG4,RPG,0,0,0,0,0,0
2018-08-19,LG4,UG,0,0,0,0,0,0
2018-08-19,LG4,Alumni,0,0,0,0,0,0
2018-08-19,LG4,Others(HKUST),0,0,0,0,0,0
2018-08-19,LG4,Non-HKUST,0,0,0,0,0,0
2018-08-19,LG4,Total,0,0,0,0,0,0
2018-08-19,All-Floors,Staff,24,97,568502,1547152470,8504410124,10051562594
2018-08-19,All-Floors,TPG,54,232,1629559,12751899644,46683382636,59435282280
2018-08-19,All-Floors,RPG,58,185,1268417,4147787291,21022437320,25170224611
2018-08-19,All-Floors,UG,146,484,3158883,8887313774,58190228467,67077542241
2018-08-19,All-Floors,Alumni,0,0,0,0,0,0
2018-08-19,All-Floors,Others(HKUST),0,0,0,0,0,0
2018-08-19,All-Floors,Non-HKUST,9,21,118784,232265711,6224607500,6456873211
2018-08-19,All-Floors,Total,291,1019,6744145,27566418890,140625066047,168191484937
2018-08-20,1,Staff,47,168,1247378,908036191,14098476428,15006512619
2018-08-20,1,TPG,60,156,1008402,2366969954,15254212654,17621182608
2018-08-20,1,RPG,17,53,393067,600395929,9003537018,9603932947
2018-08-20,1,UG,26,80,665485,2254416970,18357821437,20612238407
2018-08-20,1,Alumni,1,2,7188,316578,519936,836514
2018-08-20,1,Others(HKUST),1,2,21207,10752098,463434369,474186467
2018-08-20,1,Non-HKUST,8,15,99917,99238098,1212150923,1311389021
2018-08-20,1,Total,160,476,3442644,6240125818,58390152765,64630278583
2018-08-20,G,Staff,49,130,823046,592673353,3522119985,4114793338
2018-08-20,G,TPG,52,124,726035,1198428779,9166046191,10364474970
2018-08-20,G,RPG,55,106,516126,530350300,4879665992,5410016292
2018-08-20,G,UG,56,85,421949,552067659,6004969125,6557036784
2018-08-20,G,Alumni,3,5,26153,45057799,1738870420,1783928219
2018-08-20,G,Others(HKUST),4,10,103096,65183244,308268849,373452093
2018-08-20,G,Non-HKUST,10,19,100963,121043480,680947625,801991105
2018-08-20,G,Total,229,479,2717368,3104804614,26300888187,29405692801
2018-08-20,LG1,Staff,27,59,385388,379314867,2795828274,3175143141
2018-08-20,LG1,TPG,31,86,479020,1562036364,17582886033,19144922397
2018-08-20,LG1,RPG,46,102,566573,734016901,11448924108,12182941009
2018-08-20,LG1,UG,134,372,2526875,7974051432,53570789673,61544841105
2018-08-20,LG1,Alumni,3,8,40640,237676736,3816366968,4054043704
2018-08-20,LG1,Others(HKUST),3,5,102471,19856314,85948526,105804840
2018-08-20,LG1,Non-HKUST,7,13,79245,78752380,2321282092,2400034472
2018-08-20,LG1,Total,251,645,4180212,10985704994,91622025674,102607730668
2018-08-20,LG3,Staff,19,50,287744,370998875,2051574405,2422573280
2018-08-20,LG3,TPG,6,11,134845,141562864,2285640324,2427203188
2018-08-20,LG3,RPG,18,43,283144,836735972,31379655434,32216391406
2018-08-20,LG3,UG,14,33,248855,203058460,3190893923,3393952383
2018-08-20,LG3,Alumni,0,0,0,0,0,0
2018-08-20,LG3,Others(HKUST),1,3,17352,14685018,223734261,238419279
2018-08-20,LG3,Non-HKUST,1,5,35691,26822470,810865534,837688004
2018-08-20,LG3,Total,59,145,1007631,1593863659,39942363881,41536227540
2018-08-20,LG4,Staff,13,20,132799,252690612,3804457192,4057147804
2018-08-20,LG4,TPG,8,19,131047,563589632,7490336636,8053926268
2018-08-20,LG4,RPG,15,61,486138,5396662375,25081089293,30477751668
2018-08-20,LG4,UG,9,22,135347,187911429,9193611543,9381522972
2018-08-20,LG4,Alumni,4,10,65864,54963172,2880513541,2935476713
2018-08-20,LG4,Others(HKUST),2,2,6678,1093200,7913832,9007032
2018-08-20,LG4,Non-HKUST,3,6,28522,6442723,167306212,173748935
2018-08-20,LG4,Total,54,140,986395,6463353143,48625228249,55088581392
2018-08-20,All-Floors,Staff,122,427,2876355,2503713898,26272456284,28776170182
2018-08-20,All-Floors,TPG,132,396,2479349,5832587593,51779121838,57611709431
2018-08-20,All-Floors,RPG,132,365,2245048,8098161477,81792871845,89891033322
2018-08-20,All-Floors,UG,224,592,3998511,11171505950,90318085701,101489591651
2018-08-20,All-Floors,Alumni,11,25,139845,338014285,8436270865,8774285150
2018-08-20,All-Floors,Others(HKUST),8,22,250804,111569874,1089299837,1200869711
2018-08-20,All-Floors,Non-HKUST,26,58,344338,332299151,5192552386,5524851537
2018-08-20,All-Floors,Total,655,1885,12334250,28387852228,264880658756,293268510984
2018-08-21,1,Staff,52,168,1188981,649834983,12683038522,13332873505
2018-08-21,1,TPG,37,127,886329,1881594290,13588057298,15469651588
2018-08-21,1,RPG,8,29,244899,523494603,8687237006,9210731609
2018-08-21,1,UG,30,91,614616,3002294028,17874574035,20876868063
2018-08-21,1,Alumni,0,0,0,0,0,0
2018-08-21,1,Others(HKUST),4,4,68415,53840258,1215329421,1269169679
2018-08-21,1,Non-HKUST,3,7,52762,44792432,1178561680,1223354112
2018-08-21,1,Total,134,426,3056002,6155850594,55226797962,61382648556
2018-08-21,G,Staff,57,129,810036,5402795116,5844727341,11247522457
2018-08-21,G,TPG,46,134,740320,2933249660,15932943081,18866192741
2018-08-21,G,RPG,36,72,382810,596563541,7250528457,7847091998
2018-08-21,G,UG,79,120,571602,963831863,4926437962,5890269825
2018-08-21,G,Alumni,6,9,60978,1141232636,1786009594,2927242230
2018-08-21,G,Others(HKUST),4,8,56749,74808895,591607868,666416763
2018-08-21,G,Non-HKUST,12,23,163465,207997973,5597012497,5805010470
2018-08-21,G,Total,240,495,2785960,11320479684,41929266800,53249746484
2018-08-21,LG1,Staff,19,41,247680,273975678,3041149237,3315124915
2018-08-21,LG1,TPG,26,73,448020,1199190952,7916585983,9115776935
2018-08-21,LG1,RPG,36,90,490253,4772996545,11296759791,16069756336
2018-08-21,LG1,UG,130,308,1928606,4747057947,69486499173,74233557120
2018-08-21,LG1,Alumni,3,8,94539,374612217,5542034835,5916647052
2018-08-21,LG1,Others(HKUST),3,5,21563,322863757,319872314,642736071
2018-08-21,LG1,Non-HKUST,3,3,20906,6957705,158878516,165836221
2018-08-21,LG1,Total,220,528,3251567,11697654801,97761779849,109459434650
2018-08-21,LG3,Staff,12,30,132321,64167748,514822101,578989849
2018-08-21,LG3,TPG,15,30,274456,382237235,11128510754,11510747989
2018-08-21,LG3,RPG,19,53,371442,11450883256,7211889412,18662772668
2018-08-21,LG3,UG,41,72,380646,4725911034,2001949209,6727860243
2018-08-21,LG3,Alumni,2,6,61368,46538830,447582487,494121317
2018-08-21,LG3,Others(HKUST),2,3,14346,16870416,152695532,169565948
2018-08-21,LG3,Non-HKUST,3,5,17935,15811780,78353118,94164898
2018-08-21,LG3,Total,94,199,1252514,16702420299,21535802613,38238222912
2018-08-21,LG4,Staff,20,50,297986,243825661,6456537155,6700362816
2018-08-21,LG4,TPG,7,19,209896,478237278,7417679796,7895917074
2018-08-21,LG4,RPG,14,43,336421,1092758597,8850544069,9943302666
2018-08-21,LG4,UG,17,31,217305,519947519,8510716503,9030664022
2018-08-21,LG4,Alumni,3,12,73889,43475163,751712428,795187591
2018-08-21,LG4,Others(HKUST),1,1,3629,788932,3337908,4126840
2018-08-21,LG4,Non-HKUST,2,5,25150,33213455,1174268166,1207481621
2018-08-21,LG4,Total,64,161,1164276,2412246605,33164796025,35577042630
2018-08-21,All-Floors,Staff,124,418,2677004,6634599186,28540274356,35174873542
2018-08-21,All-Floors,TPG,122,383,2559021,6874509415,55983776912,62858286327
2018-08-21,All-Floors,RPG,101,287,1825825,18436696542,43296958735,61733655277
2018-08-21,All-Floors,UG,274,622,3712775,13959042391,102800176882,116759219273
2018-08-21,All-Floors,Alumni,13,35,290774,1605858846,8527339344,10133198190
2018-08-21,All-Floors,Others(HKUST),10,21,164702,469172258,2282843043,2752015301
2018-08-21,All-Floors,Non-HKUST,18,43,280218,308773345,8187073977,8495847322
2018-08-21,All-Floors,Total,662,1809,11510319,48288651983,249618443249,297907095232
2018-08-22,1,Staff,45,158,1003044,352429092,7992248076,8344677168
2018-08-22,1,TPG,43,131,920013,581568068,8616115900,9197683968
2018-08-22,1,RPG,17,53,378987,183273486,3115002925,3298276411
2018-08-22,1,UG,28,78,510709,1332640704,6782847357,8115488061
2018-08-22,1,Alumni,0,0,0,0,0,0
2018-08-22,1,Others(HKUST),3,17,68774,19244947,114887294,134132241
2018-08-22,1,Non-HKUST,2,3,27936,18936550,174152198,193088748
2018-08-22,1,Total,138,440,2909463,2488092847,26795253750,29283346597
2018-08-22,G,Staff,51,135,809685,1503054805,3044844290,4547899095
2018-08-22,G,TPG,47,115,633392,1459103903,17597873441,19056977344
2018-08-22,G,RPG,52,97,479729,370629022,2561736238,2932365260
2018-08-22,G,UG,73,127,614121,844306271,7155536326,7999842597
2018-08-22,G,Alumni,6,9,77179,118616865,3296878592,3415495457
2018-08-22,G,Others(HKUST),5,10,46098,85075747,267992811,353068558
2018-08-22,G,Non-HKUST,9,11,71816,174335167,3113603137,3287938304
2018-08-22,G,Total,243,504,2732020,4555121780,37038464835,41593586615
2018-08-22,LG1,Staff,17,37,258571,343041064,4083968476,4427009540
2018-08-22,LG1,TPG,31,74,375804,302009357,4007994152,4310003509
2018-08-22,LG1,RPG,37,98,542915,2926561506,13446580276,16373141782
2018-08-22,LG1,UG,241,615,3632306,7813717298,44563646275,52377363573
2018-08-22,LG1,Alumni,2,8,84174,384216470,4176483721,4560700191
2018-08-22,LG1,Others(HKUST),2,3,41618,962118,5385470,6347588
2018-08-22,LG1,Non-HKUST,5,12,63667,15930843,550567660,566498503
2018-08-22,LG1,Total,335,847,4999055,11786438656,70834626030,82621064686
2018-08-22,LG3,Staff,17,36,151865,718637391,2124959947,2843597338
2018-08-22,LG3,TPG,16,39,296954,602298828,6489629871,7091928699
2018-08-22,LG3,RPG,17,53,411492,1087382635,7916668164,9004050799
2018-08-22,LG3,UG,83,159,732981,1103217621,10523929439,11627147060
2018-08-22,LG3,Alumni,2,5,42262,49383026,268515089,317898115
2018-08-22,LG3,Others(HKUST),1,1,3632,2678780,962831,3641611
2018-08-22,LG3,Non-HKUST,3,7,45904,27354003,569075492,596429495
2018-08-22,LG3,Total,139,300,1685090,3590952284,27893740833,31484693117
2018-08-22,LG4,Staff,21,38,200656,172841169,4048525678,4221366847
2018-08-22,LG4,TPG,6,18,161654,612207359,11602694035,12214901394
2018-08-22,LG4,RPG,19,62,487619,4713496681,13753994517,18467491198
2018-08-22,LG4,UG,37,66,290490,1696377364,9507058069,11203435433
2018-08-22,LG4,Alumni,3,10,62591,25291688,468505600,493797288
2018-08-22,LG4,Others(HKUST),0,0,0,0,0,0
2018-08-22,LG4,Non-HKUST,3,5,23374,246002069,34211430,280213499
2018-08-22,LG4,Total,89,199,1226384,7466216330,39414989329,46881205659
2018-08-22,All-Floors,Staff,117,404,2423821,3090003521,21294546467,24384549988
2018-08-22,All-Floors,TPG,128,377,2387817,3557187515,48314307399,51871494914
2018-08-22,All-Floors,RPG,119,363,2300742,9281343330,40793982120,50075325450
2018-08-22,All-Floors,UG,387,1045,5780607,12790259258,78533017466,91323276724
2018-08-22,All-Floors,Alumni,12,32,266206,577508049,8210383002,8787891051
2018-08-22,All-Floors,Others(HKUST),11,31,160122,107961592,389228406,497189998
2018-08-22,All-Floors,Non-HKUST,20,38,232697,482558632,4441609917,4924168549
2018-08-22,All-Floors,Total,794,2290,13552012,29886821897,201977074777,231863896674
2018-08-23,1,Staff,49,174,1198379,585972354,15892648117,16478620471
2018-08-23,1,TPG,59,204,1465113,1439333245,24824063729,26263396974
2018-08-23,1,RPG,10,28,175712,162942278,703340985,866283263
2018-08-23,1,UG,36,83,623151,1122836158,11297524246,12420360404
2018-08-23,1,Alumni,2,3,31087,23991294,104855125,128846419
2018-08-23,1,Others(HKUST),3,8,40907,13506611,69172915,82679526
2018-08-23,1,Non-HKUST,6,11,92593,27762226,178534531,206296757
2018-08-23,1,Total,165,511,3626942,3376344166,53070139648,56446483814
2018-08-23,G,Staff,50,144,878491,814776666,2395871222,3210647888
2018-08-23,G,TPG,55,117,615092,706428658,7701167545,8407596203
2018-08-23,G,RPG,33,74,473580,431880883,2030427157,2462308040
2018-08-23,G,UG,112,175,866401,1577592857,4388491831,5966084688
2018-08-23,G,Alumni,9,20,188426,1274264670,4401980934,5676245604
2018-08-23,G,Others(HKUST),7,13,58575,26042267,145587936,171630203
2018-08-23,G,Non-HKUST,10,23,124163,139564314,2199957097,2339521411
2018-08-23,G,Total,276,566,3204728,4970550315,23263483722,28234034037
2018-08-23,LG1,Staff,22,46,261179,1397949480,2386316672,3784266152
2018-08-23,LG1,TPG,30,82,472070,920582662,9114948125,10035530787
2018-08-23,LG1,RPG,50,125,613942,4332850858,6274235827,10607086685
2018-08-23,LG1,UG,317,807,4552969,14878749673,59407020191,74285769864
2018-08-23,LG1,Alumni,4,12,83383,632692267,3605705884,4238398151
2018-08-23,LG1,Others(HKUST),4,12,73484,83218722,406973987,490192709
2018-08-23,LG1,Non-HKUST,6,11,62327,76175100,1238413250,1314588350
2018-08-23,LG1,Total,433,1095,6119354,22322218762,82433613936,104755832698
2018-08-23,LG3,Staff,15,27,121963,102045057,2104606395,2206651452
2018-08-23,LG3,TPG,9,21,133841,110397593,2987669236,3098066829
2018-08-23,LG3,RPG,18,46,323997,358687197,9579187435,9937874632
2018-08-23,LG3,UG,45,92,494289,494711883,13233251761,13727963644
2018-08-23,LG3,Alumni,1,1,4239,3407864,17056178,20464042
2018-08-23,LG3,Others(HKUST),1,1,3961,0,0,0
2018-08-23,LG3,Non-HKUST,1,3,10909,5264628,163856611,169121239
2018-08-23,LG3,Total,90,191,1093199,1074514222,28085627616,29160141838
2018-08-23,LG4,Staff,17,29,177301,348241041,5028696677,5376937718
2018-08-23,LG4,TPG,12,36,229400,320222735,8038927471,8359150206
2018-08-23,LG4,RPG,25,77,624023,785172413,10132911212,10918083625
2018-08-23,LG4,UG,22,54,351734,2162892362,21756395713,23919288075
2018-08-23,LG4,Alumni,2,8,66108,29553344,277953735,307507079
2018-08-23,LG4,Others(HKUST),3,4,15765,32109215,179064071,211173286
2018-08-23,LG4,Non-HKUST,1,2,8189,18855653,470789217,489644870
2018-08-23,LG4,Total,82,210,1472520,3697046763,45884738096,49581784859
2018-08-23,All-Floors,Staff,126,420,2637313,3248984598,27808139083,31057123681
2018-08-23,All-Floors,TPG,144,460,2915516,3496964893,52666776106,56163740999
2018-08-23,All-Floors,RPG,122,350,2211254,6071533629,28720102616,34791636245
2018-08-23,All-Floors,UG,487,1211,6888544,20236782933,110082683742,130319466675
2018-08-23,All-Floors,Alumni,17,44,373243,1963909439,8407551856,10371461295
2018-08-23,All-Floors,Others(HKUST),11,38,192692,154876815,800798909,955675724
2018-08-23,All-Floors,Non-HKUST,22,50,298181,267621921,4251550706,4519172627
2018-08-23,All-Floors,Total,929,2573,15516743,35440674228,232737603018,268178277246
2018-08-24,1,Staff,51,173,1078196,748969991,12674463141,13423433132
2018-08-24,1,TPG,38,109,817055,1190916805,13481371641,14672288446
2018-08-24,1,RPG,20,62,451427,4470756539,6426529047,10897285586
2018-08-24,1,UG,52,129,841691,1166247842,10230847461,11397095303
2018-08-24,1,Alumni,0,0,0,0,0,0
2018-08-24,1,Others(HKUST),6,7,52235,79602706,327303002,406905708
2018-08-24,1,Non-HKUST,6,10,75332,33741107,276113481,309854588
2018-08-24,1,Total,173,490,3315936,7690234990,43416627773,51106862763
2018-08-24,G,Staff,57,143,886418,361430314,3005397402,3366827716
2018-08-24,G,TPG,50,113,695909,1190226316,10170711193,11360937509
2018-08-24,G,RPG,38,74,405018,330099435,4470403214,4800502649
2018-08-24,G,UG,163,285,1445912,1906255456,14257970332,16164225788
2018-08-24,G,Alumni,7,18,145677,119968267,2415199043,2535167310
2018-08-24,G,Others(HKUST),4,8,80188,2240707,31750366,33991073
2018-08-24,G,Non-HKUST,9,19,92637,92257957,747526026,839783983
2018-08-24,G,Total,328,660,3751759,4002478452,35098957576,39101436028
2018-08-24,LG1,Staff,21,37,228415,866033140,2371155071,3237188211
2018-08-24,LG1,TPG,33,73,546188,1832685710,8538385553,10371071263
2018-08-24,LG1,RPG,46,100,620104,1904325586,11396003920,13300329506
2018-08-24,LG1,UG,411,1059,6099380,15635915311,79922613481,95558528792
2018-08-24,LG1,Alumni,3,11,70853,210763987,516697078,727461065
2018-08-24,LG1,Others(HKUST),3,12,102303,38685218,1033587471,1072272689
2018-08-24,LG1,Non-HKUST,10,18,124151,307535683,1710271946,2017807629
2018-08-24,LG1,Total,527,1310,7791394,20795944635,105488714520,126284659155
2018-08-24,LG3,Staff,10,19,82684,30799178,373383763,404182941
2018-08-24,LG3,TPG,15,39,289068,468993440,9245548877,9714542317
2018-08-24,LG3,RPG,24,50,331632,513808774,6655172887,7168981661
2018-08-24,LG3,UG,96,239,1288433,1279742787,13459156227,14738899014
2018-08-24,LG3,Alumni,0,0,0,0,0,0
2018-08-24,LG3,Others(HKUST),3,5,49054,37780769,184838178,222618947
2018-08-24,LG3,Non-HKUST,2,3,14372,19551013,339643432,359194445
2018-08-24,LG3,Total,150,355,2055243,2350675961,30257743364,32608419325
2018-08-24,LG4,Staff,59,81,464452,181808405,2409345913,2591154318
2018-08-24,LG4,TPG,12,29,230362,873647055,22388775258,23262422313
2018-08-24,LG4,RPG,23,54,337389,221026591,4586783404,4807809995
2018-08-24,LG4,UG,38,84,477471,2877482325,15532799174,18410281499
2018-08-24,LG4,Alumni,4,20,108744,52018345,1561539038,1613557383
2018-08-24,LG4,Others(HKUST),2,3,11822,37411105,115228628,152639733
2018-08-24,LG4,Non-HKUST,2,2,14585,36607304,211574194,248181498
2018-08-24,LG4,Total,140,273,1644825,4280001130,46806045609,51086046739
2018-08-24,All-Floors,Staff,163,453,2740165,2189041028,20833745290,23022786318
2018-08-24,All-Floors,TPG,127,363,2578582,5556469326,63824792522,69381261848
2018-08-24,All-Floors,RPG,132,340,2145570,7440016925,33534892472,40974909397
2018-08-24,All-Floors,UG,674,1796,10152887,22865643721,133403386675,156269030396
2018-08-24,All-Floors,Alumni,13,49,325274,382750599,4493435159,4876185758
2018-08-24,All-Floors,Others(HKUST),11,35,295602,195720505,1692707645,1888428150
2018-08-24,All-Floors,Non-HKUST,26,52,321077,489693064,3285129079,3774822143
2018-08-24,All-Floors,Total,1146,3088,18559157,39119335168,261068088842,300187424010
2018-08-25,1,Staff,7,32,157719,156299896,3095323972,3251623868
2018-08-25,1,TPG,27,72,503526,718739071,10757186492,11475925563
2018-08-25,1,RPG,6,21,107838,36410472,342557760,378968232
2018-08-25,1,UG,9,26,150810,168544815,3667038915,3835583730
2018-08-25,1,Alumni,3,11,78012,129374349,3052124414,3181498763
2018-08-25,1,Others(HKUST),1,1,3946,264025,285087,549112
2018-08-25,1,Non-HKUST,2,3,31821,31211632,751726165,782937797
2018-08-25,1,Total,55,166,1033672,1240844260,21666242805,22907087065
2018-08-25,G,Staff,16,48,199350,167355148,834963481,1002318629
2018-08-25,G,TPG,26,78,536565,1373789943,19623261972,20997051915
2018-08-25,G,RPG,24,53,302809,274231676,2566554314,2840785990
2018-08-25,G,UG,63,114,612302,485734076,8303818733,8789552809
2018-08-25,G,Alumni,8,14,84884,35558808,681549666,717108474
2018-08-25,G,Others(HKUST),4,5,54335,2256136,21475785,23731921
2018-08-25,G,Non-HKUST,8,16,99510,25653909,150478636,176132545
2018-08-25,G,Total,149,328,1889755,2364579696,32182102587,34546682283
2018-08-25,LG1,Staff,9,17,86404,358143447,430207700,788351147
2018-08-25,LG1,TPG,20,45,334037,684971521,8536516897,9221488418
2018-08-25,LG1,RPG,25,66,440846,1000117936,12418690970,13418808906
2018-08-25,LG1,UG,233,629,3745585,7739766493,68485569277,76225335770
2018-08-25,LG1,Alumni,5,10,43602,83736750,485706945,569443695
2018-08-25,LG1,Others(HKUST),1,4,50665,9507993,47695164,57203157
2018-08-25,LG1,Non-HKUST,7,7,64104,48859100,883383526,932242626
2018-08-25,LG1,Total,300,778,4765243,9925103240,91287770479,101212873719
2018-08-25,LG3,Staff,5,13,75526,77195857,887800132,964995989
2018-08-25,LG3,TPG,6,20,145643,625326125,2339783552,2965109677
2018-08-25,LG3,RPG,8,20,110050,134624518,1251437685,1386062203
2018-08-25,LG3,UG,42,70,354135,604179852,8992176652,9596356504
2018-08-25,LG3,Alumni,3,6,33315,25324023,863453641,888777664
2018-08-25,LG3,Others(HKUST),0,0,0,0,0,0
2018-08-25,LG3,Non-HKUST,3,8,29990,42592205,246751279,289343484
2018-08-25,LG3,Total,67,137,748659,1509242580,14581402941,16090645521
2018-08-25,LG4,Staff,1,1,8189,20634109,750219414,770853523
2018-08-25,LG4,TPG,8,15,90118,166385417,2546198983,2712584400
2018-08-25,LG4,RPG,8,26,173601,303009229,3711738803,4014748032
2018-08-25,LG4,UG,16,31,162177,514042518,12934181600,13448224118
2018-08-25,LG4,Alumni,5,9,40900,29747003,2434797816,2464544819
2018-08-25,LG4,Others(HKUST),0,0,0,0,0,0
2018-08-25,LG4,Non-HKUST,3,3,10603,0,0,0
2018-08-25,LG4,Total,41,85,485588,1033818276,22377136616,23410954892
2018-08-25,All-Floors,Staff,35,111,527188,779628457,5998514699,6778143156
2018-08-25,All-Floors,TPG,77,230,1609889,3569212077,43802947896,47372159973
2018-08-25,All-Floors,RPG,64,186,1135144,1748393831,20290979532,22039373363
2018-08-25,All-Floors,UG,325,870,5025009,9512267754,102382785177,111895052931
2018-08-25,All-Floors,Alumni,21,50,280713,303740933,7517632482,7821373415
2018-08-25,All-Floors,Others(HKUST),5,10,108946,12028154,69456036,81484190
2018-08-25,All-Floors,Non-HKUST,18,37,236028,148316846,2032339606,2180656452
2018-08-25,All-Floors,Total,545,1494,8922917,16073588052,182094655428,198168243480
2018-08-26,1,Staff,3,24,83251,685879,1135982,1821861
2018-08-26,1,TPG,0,0,0,0,0,0
2018-08-26,1,RPG,1,1,3997,5201913,37444486,42646399
2018-08-26,1,UG,0,0,0,0,0,0
2018-08-26,1,Alumni,0,0,0,0,0,0
2018-08-26,1,Others(HKUST),0,0,0,0,0,0
2018-08-26,1,Non-HKUST,0,0,0,0,0,0
2018-08-26,1,Total,4,25,87248,5887792,38580468,44468260
2018-08-26,G,Staff,2,12,41945,96225,279841,376066
2018-08-26,G,TPG,0,0,0,0,0,0
2018-08-26,G,RPG,0,0,0,0,0,0
2018-08-26,G,UG,0,0,0,0,0,0
2018-08-26,G,Alumni,0,0,0,0,0,0
2018-08-26,G,Others(HKUST),0,0,0,0,0,0
2018-08-26,G,Non-HKUST,0,0,0,0,0,0
2018-08-26,G,Total,2,12,41945,96225,279841,376066
2018-08-26,LG1,Staff,17,52,378162,778529318,15266358649,16044887967
2018-08-26,LG1,TPG,69,219,1590768,2342000668,26256549035,28598549703
2018-08-26,LG1,RPG,57,174,1271684,1575749799,22351313185,23927062984
2018-08-26,LG1,UG,237,586,4017080,8715117226,73935749734,82650866960
2018-08-26,LG1,Alumni,2,3,28896,80667859,1433449632,1514117491
2018-08-26,LG1,Others(HKUST),0,0,0,0,0,0
2018-08-26,LG1,Non-HKUST,11,31,213549,936592334,3481800655,4418392989
2018-08-26,LG1,Total,393,1065,7500139,14428657204,142725220890,157153878094
2018-08-26,LG3,Staff,0,0,0,0,0,0
2018-08-26,LG3,TPG,0,0,0,0,0,0
2018-08-26,LG3,RPG,1,1,4009,8468353,65423081,73891434
2018-08-26,LG3,UG,3,3,11975,722566,948174,1670740
2018-08-26,LG3,Alumni,1,1,4007,5656500,178170061,183826561
2018-08-26,LG3,Others(HKUST),0,0,0,0,0,0
2018-08-26,LG3,Non-HKUST,0,0,0,0,0,0
2018-08-26,LG3,Total,5,5,19991,14847419,244541316,259388735
2018-08-26,LG4,Staff,0,0,0,0,0,0
2018-08-26,LG4,TPG,0,0,0,0,0,0
2018-08-26,LG4,RPG,0,0,0,0,0,0
2018-08-26,LG4,UG,0,0,0,0,0,0
2018-08-26,LG4,Alumni,0,0,0,0,0,0
2018-08-26,LG4,Others(HKUST),0,0,0,0,0,0
2018-08-26,LG4,Non-HKUST,0,0,0,0,0,0
2018-08-26,LG4,Total,0,0,0,0,0,0
2018-08-26,All-Floors,Staff,21,88,503358,779311422,15267774472,16047085894
2018-08-26,All-Floors,TPG,69,219,1590768,2342000668,26256549035,28598549703
2018-08-26,All-Floors,RPG,58,176,1279690,1589420065,22454180752,24043600817
2018-08-26,All-Floors,UG,240,589,4029055,8715839792,73936697908,82652537700
2018-08-26,All-Floors,Alumni,3,4,32903,86324359,1611619693,1697944052
2018-08-26,All-Floors,Others(HKUST),0,0,0,0,0,0
2018-08-26,All-Floors,Non-HKUST,11,31,213549,936592334,3481800655,4418392989
2018-08-26,All-Floors,Total,402,1107,7649323,14449488640,143008622515,157458111155
2018-08-27,1,Staff,52,221,1361717,4697587250,13458070753,18155658003
2018-08-27,1,TPG,59,202,1553528,1500250428,19544882664,21045133092
2018-08-27,1,RPG,25,83,686364,731588475,14491394559,15222983034
2018-08-27,1,UG,26,64,444758,800506688,4696376936,5496883624
2018-08-27,1,Alumni,2,3,20007,642507,1085392,1727899
2018-08-27,1,Others(HKUST),2,6,30224,2569736,31244397,33814133
2018-08-27,1,Non-HKUST,4,4,14932,26708388,240542219,267250607
2018-08-27,1,Total,170,583,4111530,7759853472,52463596920,60223450392
2018-08-27,G,Staff,63,178,1063916,962545905,9655866707,10618412612
2018-08-27,G,TPG,53,122,777892,13566729794,14097454597,27664184391
2018-08-27,G,RPG,40,84,484837,843407514,3201909906,4045317420
2018-08-27,G,UG,96,167,944148,1243825296,15254120647,16497945943
2018-08-27,G,Alumni,6,13,83631,85980317,3060805582,3146785899
2018-08-27,G,Others(HKUST),5,12,104250,5997197,61898310,67895507
2018-08-27,G,Non-HKUST,9,17,63639,32913314,1341180297,1374093611
2018-08-27,G,Total,272,593,3522313,16741399337,46673236046,63414635383
2018-08-27,LG1,Staff,31,77,517171,1372459372,6619271824,7991731196
2018-08-27,LG1,TPG,75,205,1194799,2707558043,24613088267,27320646310
2018-08-27,LG1,RPG,65,186,1124876,1730939307,16627596884,18358536191
2018-08-27,LG1,UG,246,585,3769058,15322007742,68686942161,84008949903
2018-08-27,LG1,Alumni,4,15,105952,297752924,3377549071,3675301995
2018-08-27,LG1,Others(HKUST),2,10,56476,92386458,732440984,824827442
2018-08-27,LG1,Non-HKUST,9,14,115181,391747394,1494840420,1886587814
2018-08-27,LG1,Total,432,1092,6883513,21914851240,122151729611,144066580851
2018-08-27,LG3,Staff,15,33,138992,55775755,1111724599,1167500354
2018-08-27,LG3,TPG,18,50,345829,922644795,4174352843,5096997638
2018-08-27,LG3,RPG,20,53,393496,643054606,7865718081,8508772687
2018-08-27,LG3,UG,48,87,422110,344182704,5778228370,6122411074
2018-08-27,LG3,Alumni,1,4,19319,18846160,99320463,118166623
2018-08-27,LG3,Others(HKUST),0,0,0,0,0,0
2018-08-27,LG3,Non-HKUST,0,0,0,0,0,0
2018-08-27,LG3,Total,102,227,1319746,1984504020,19029344356,21013848376
2018-08-27,LG4,Staff,18,26,139272,133119208,2688996046,2822115254
2018-08-27,LG4,TPG,11,28,180636,939075793,14869240923,15808316716
2018-08-27,LG4,RPG,22,79,579619,1741280627,20161628316,21902908943
2018-08-27,LG4,UG,28,59,358535,764181873,17638935516,18403117389
2018-08-27,LG4,Alumni,5,13,104815,66770256,909175265,975945521
2018-08-27,LG4,Others(HKUST),1,1,3021,1475989,12006743,13482732
2018-08-27,LG4,Non-HKUST,5,10,53103,371505924,529067078,900573002
2018-08-27,LG4,Total,90,216,1419001,4017409670,56809049887,60826459557
2018-08-27,All-Floors,Staff,144,535,3221068,7221487490,33533929929,40755417419
2018-08-27,All-Floors,TPG,179,607,4052684,19636258853,77299019294,96935278147
2018-08-27,All-Floors,RPG,154,485,3269192,5690270529,62348247746,68038518275
2018-08-27,All-Floors,UG,384,962,5938609,18474704303,112054603630,130529307933
2018-08-27,All-Floors,Alumni,16,48,333724,469992164,7447935773,7917927937
2018-08-27,All-Floors,Others(HKUST),8,29,193971,102429380,837590434,940019814
2018-08-27,All-Floors,Non-HKUST,21,45,246855,822875020,3605630014,4428505034
2018-08-27,All-Floors,Total,906,2711,17256103,52418017739,297126956820,349544974559
2018-08-28,1,Staff,59,272,1393152,1075914423,15020099390,16096013813
2018-08-28,1,TPG,60,238,1257422,1709375287,15331865738,17041241025
2018-08-28,1,RPG,24,93,448751,628168221,6116491956,6744660177
2018-08-28,1,UG,19,64,347541,399708758,6026245775,6425954533
2018-08-28,1,Alumni,0,0,0,0,0,0
2018-08-28,1,Others(HKUST),2,8,37275,42711537,170791256,213502793
2018-08-28,1,Non-HKUST,5,18,98800,1782782208,1945811666,3728593874
2018-08-28,1,Total,169,693,3582941,5638660434,44611305781,50249966215
2018-08-28,G,Staff,62,182,918863,372219383,2577359477,2949578860
2018-08-28,G,TPG,67,189,881170,1107938455,14078659891,15186598346
2018-08-28,G,RPG,48,126,561301,3356645548,9472341356,12828986904
2018-08-28,G,UG,68,123,483658,537759656,10479676833,11017436489
2018-08-28,G,Alumni,4,5,33667,62985279,2949243267,3012228546
2018-08-28,G,Others(HKUST),6,18,138420,30549821,480941664,511491485
2018-08-28,G,Non-HKUST,15,35,174520,126019504,2150896553,2276916057
2018-08-28,G,Total,270,678,3191599,5594117646,42189119041,47783236687
2018-08-28,LG1,Staff,37,114,614519,1305050052,7981399113,9286449165
2018-08-28,LG1,TPG,77,245,1302553,4990249169,25974713725,30964962894
2018-08-28,LG1,RPG,74,231,1210686,4235867487,27005662343,31241529830
2018-08-28,LG1,UG,119,345,1745844,2933624498,39189753538,42123378036
2018-08-28,LG1,Alumni,6,22,153953,266217700,3112551155,3378768855
2018-08-28,LG1,Others(HKUST),2,8,172984,26515442,103663970,130179412
2018-08-28,LG1,Non-HKUST,16,44,246385,254455614,4170688282,4425143896
2018-08-28,LG1,Total,331,1009,5446924,14011979962,107538432126,121550412088
2018-08-28,LG3,Staff,11,17,82088,34247966,1483648705,1517896671
2018-08-28,LG3,TPG,28,85,424774,7403169804,7180431323,14583601127
2018-08-28,LG3,RPG,22,71,387535,449935214,7513518302,7963453516
2018-08-28,LG3,UG,31,54,228959,242306088,3623272880,3865578968
2018-08-28,LG3,Alumni,1,2,15174,17925397,154840002,172765399
2018-08-28,LG3,Others(HKUST),2,6,22704,5490407,96188198,101678605
2018-08-28,LG3,Non-HKUST,0,0,0,0,0,0
2018-08-28,LG3,Total,95,235,1161234,8153074876,20051899410,28204974286
2018-08-28,LG4,Staff,15,27,118706,99072401,2125022034,2224094435
2018-08-28,LG4,TPG,15,59,274186,783463040,14100884952,14884347992
2018-08-28,LG4,RPG,26,92,502397,788674578,13056514865,13845189443
2018-08-28,LG4,UG,42,81,351706,708134494,11051230034,11759364528
2018-08-28,LG4,Alumni,5,20,105314,160210333,2697242654,2857452987
2018-08-28,LG4,Others(HKUST),3,6,82825,6836734,36291652,43128386
2018-08-28,LG4,Non-HKUST,2,4,16500,2994330,73591181,76585511
2018-08-28,LG4,Total,108,289,1451634,2549385910,43140777372,45690163282
2018-08-28,All-Floors,Staff,135,612,3127328,2886504225,29187528719,32074032944
2018-08-28,All-Floors,TPG,201,816,4140105,15994195755,76666555629,92660751384
2018-08-28,All-Floors,RPG,164,613,3110670,9459291048,63164528822,72623819870
2018-08-28,All-Floors,UG,224,667,3157708,4821533494,70370179060,75191712554
2018-08-28,All-Floors,Alumni,15,49,308108,507338709,8913877078,9421215787
2018-08-28,All-Floors,Others(HKUST),8,46,454208,112103941,887876740,999980681
2018-08-28,All-Floors,Non-HKUST,36,101,536205,2166251656,8340987682,10507239338
2018-08-28,All-Floors,Total,783,2904,14834332,35947218828,257531533730,293478752558
2018-08-29,1,Staff,51,130,683525,702759663,19656444234,20359203897
2018-08-29,1,TPG,49,125,626133,1009368234,13419128103,14428496337
2018-08-29,1,RPG,15,28,151271,166619600,5877871899,6044491499
2018-08-29,1,UG,21,52,292030,3876500038,22551108570,26427608608
2018-08-29,1,Alumni,1,3,13746,11804344,142960181,154764525
2018-08-29,1,Others(HKUST),1,1,3010,83967,25291,109258
2018-08-29,1,Non-HKUST,1,2,18096,10184102,105181412,115365514
2018-08-29,1,Total,139,341,1787811,5777319948,61752719690,67530039638
2018-08-29,G,Staff,42,96,447903,116936066,776695633,893631699
2018-08-29,G,TPG,55,113,508581,622084137,12654005361,13276089498
2018-08-29,G,RPG,27,59,256737,755930584,2563619071,3319549655
2018-08-29,G,UG,70,104,417113,432973812,5027412440,5460386252
2018-08-29,G,Alumni,3,8,35528,27592637,1023081482,1050674119
2018-08-29,G,Others(HKUST),3,7,24113,3638611,15066191,18704802
2018-08-29,G,Non-HKUST,7,12,62663,63690231,1911968935,1975659166
2018-08-29,G,Total,207,399,1752638,2022846078,23971849113,25994695191
2018-08-29,LG1,Staff,18,40,161898,388593170,3842541410,4231134580
2018-08-29,LG1,TPG,62,110,528928,880648867,16981890123,17862538990
2018-08-29,LG1,RPG,34,87,413376,6584029147,5168225080,11752254227
2018-08-29,LG1,UG,96,188,737808,6257804298,19489876089,25747680387
2018-08-29,LG1,Alumni,2,3,15075,21563607,154605692,176169299
2018-08-29,LG1,Others(HKUST),2,2,20466,2807391,24086622,26894013
2018-08-29,LG1,Non-HKUST,8,14,76119,174471244,938208732,1112679976
2018-08-29,LG1,Total,222,444,1953670,14309917724,46599433748,60909351472
2018-08-29,LG3,Staff,16,24,76391,41092657,40670952,81763609
2018-08-29,LG3,TPG,24,66,322918,998176719,3672304503,4670481222
2018-08-29,LG3,RPG,17,38,191156,741437194,2215063807,2956501001
2018-08-29,LG3,UG,17,34,153233,127164753,3293734306,3420899059
2018-08-29,LG3,Alumni,0,0,0,0,0,0
2018-08-29,LG3,Others(HKUST),1,1,2344,199101,874006,1073107
2018-08-29,LG3,Non-HKUST,1,1,3020,0,0,0
2018-08-29,LG3,Total,76,164,749062,1908070424,9222647574,11130717998
2018-08-29,LG4,Staff,9,13,64057,72727342,2280899173,2353626515
2018-08-29,LG4,TPG,13,33,152274,717022333,7791446303,8508468636
2018-08-29,LG4,RPG,13,28,141159,272861499,4587153745,4860015244
2018-08-29,LG4,UG,28,43,173366,453351358,5301357858,5754709216
2018-08-29,LG4,Alumni,1,3,8392,5821765,69114416,74936181
2018-08-29,LG4,Others(HKUST),0,0,0,0,0,0
2018-08-29,LG4,Non-HKUST,1,2,5360,5711035,710511,6421546
2018-08-29,LG4,Total,65,122,544608,1527495332,20030682006,21558177338
2018-08-29,All-Floors,Staff,106,303,1433774,1322108898,26597251402,27919360300
2018-08-29,All-Floors,TPG,185,447,2138834,4227300290,54518774393,58746074683
2018-08-29,All-Floors,RPG,98,240,1153699,8520878024,20411933602,28932811626
2018-08-29,All-Floors,UG,202,421,1773550,11147794259,55663489263,66811283522
2018-08-29,All-Floors,Alumni,7,17,72741,66782353,1389761771,1456544124
2018-08-29,All-Floors,Others(HKUST),6,11,49933,6729070,40052110,46781180
2018-08-29,All-Floors,Non-HKUST,17,31,165258,254056612,2956069590,3210126202
2018-08-29,All-Floors,Total,621,1470,6787789,25545649506,161577332131,187122981637
2018-08-30,1,Staff,48,172,1114614,939072277,7862748230,8801820507
2018-08-30,1,TPG,71,248,1626495,2640897397,29117910105,31758807502
2018-08-30,1,RPG,22,71,482898,419439513,5933413582,6352853095
2018-08-30,1,UG,31,90,645775,4033187515,19735754476,23768941991
2018-08-30,1,Alumni,1,1,3017,0,6001260,6001260
2018-08-30,1,Others(HKUST),2,11,60194,4294241,50611091,54905332
2018-08-30,1,Non-HKUST,7,22,123753,107536597,2546801941,2654338538
2018-08-30,1,Total,182,615,4056746,8144427540,65253240685,73397668225
2018-08-30,G,Staff,61,157,936391,297939936,3820533963,4118473899
2018-08-30,G,TPG,108,222,1194764,1860927130,24316892007,26177819137
2018-08-30,G,RPG,62,124,642561,1297825087,10190195229,11488020316
2018-08-30,G,UG,134,195,793005,749184851,30506019805,31255204656
2018-08-30,G,Alumni,5,12,60329,25571025,800228856,825799881
2018-08-30,G,Others(HKUST),6,11,174638,29989296,230682410,260671706
2018-08-30,G,Non-HKUST,11,19,87465,89579785,2085233274,2174813059
2018-08-30,G,Total,387,740,3889153,4351017110,71949785544,76300802654
2018-08-30,LG1,Staff,31,67,389316,1193595675,37665897832,38859493507
2018-08-30,LG1,TPG,125,385,2084862,3978997376,64660692169,68639689545
2018-08-30,LG1,RPG,60,157,799463,1121904748,11864158795,12986063543
2018-08-30,LG1,UG,197,508,2756227,6815426662,55795327588,62610754250
2018-08-30,LG1,Alumni,5,17,135785,422633740,9580235735,10002869475
2018-08-30,LG1,Others(HKUST),3,7,314404,75179903,235434358,310614261
2018-08-30,LG1,Non-HKUST,17,40,217231,505102100,2595989452,3101091552
2018-08-30,LG1,Total,438,1181,6697288,14112840204,182397735929,196510576133
2018-08-30,LG3,Staff,25,49,235252,285395377,3387006126,3672401503
2018-08-30,LG3,TPG,39,97,573291,745634365,16971648073,17717282438
2018-08-30,LG3,RPG,14,40,217243,505598272,5871912369,6377510641
2018-08-30,LG3,UG,41,89,428308,592616869,6581906979,7174523848
2018-08-30,LG3,Alumni,3,5,51322,6070675319,897954299,6968629618
2018-08-30,LG3,Others(HKUST),0,0,0,0,0,0
2018-08-30,LG3,Non-HKUST,1,3,9045,12856031,98713589,111569620
2018-08-30,LG3,Total,123,283,1514461,8212776233,33809141435,42021917668
2018-08-30,LG4,Staff,18,27,99528,334515832,2455740802,2790256634
2018-08-30,LG4,TPG,60,105,525093,1821523192,18478204166,20299727358
2018-08-30,LG4,RPG,48,101,500972,521261530,11597889870,12119151400
2018-08-30,LG4,UG,46,82,378372,705002933,11009964637,11714967570
2018-08-30,LG4,Alumni,5,12,87576,70254316,1365136275,1435390591
2018-08-30,LG4,Others(HKUST),2,4,129371,21671679,72162168,93833847
2018-08-30,LG4,Non-HKUST,8,20,93586,109154218,5084538785,5193693003
2018-08-30,LG4,Total,187,351,1814498,3583383700,50063636703,53647020403
2018-08-30,All-Floors,Staff,124,472,2775101,3050519097,55191926953,58242446050
2018-08-30,All-Floors,TPG,280,1057,6004505,11047979460,153545346520,164593325980
2018-08-30,All-Floors,RPG,167,493,2643137,3866029150,45457569845,49323598995
2018-08-30,All-Floors,UG,376,964,5001687,12895418830,123628973485,136524392315
2018-08-30,All-Floors,Alumni,14,47,338029,6589134400,12649556425,19238690825
2018-08-30,All-Floors,Others(HKUST),9,33,678607,131135119,588890027,720025146
2018-08-30,All-Floors,Non-HKUST,36,104,531080,824228731,12411277041,13235505772
2018-08-30,All-Floors,Total,1006,3170,17972146,38404444787,403473540296,441877985083
2018-08-31,1,Staff,58,214,1371959,1756735454,20551008589,22307744043
2018-08-31,1,TPG,56,187,1252337,1950145284,47388050793,49338196077
2018-08-31,1,RPG,17,50,406012,368016670,10733039135,11101055805
2018-08-31,1,UG,30,88,614702,3732262771,9496341564,13228604335
2018-08-31,1,Alumni,0,0,0,0,0,0
2018-08-31,1,Others(HKUST),2,4,38611,941982,4642797,5584779
2018-08-31,1,Non-HKUST,7,15,91077,87782824,1224133648,1311916472
2018-08-31,1,Total,170,558,3774698,7895884985,89397216526,97293101511
2018-08-31,G,Staff,53,148,723691,257139115,3045758192,3302897307
2018-08-31,G,TPG,101,188,936043,1365031322,24262825299,25627856621
2018-08-31,G,RPG,46,77,430008,452324924,6751717187,7204042111
2018-08-31,G,UG,124,201,771633,1427248566,6974557546,8401806112
2018-08-31,G,Alumni,7,20,141159,199560019,1576020733,1775580752
2018-08-31,G,Others(HKUST),4,13,66568,42850165,311481031,354331196
2018-08-31,G,Non-HKUST,13,21,113378,51275701,2560150650,2611426351
2018-08-31,G,Total,348,668,3182480,3795429812,45482510638,49277940450
2018-08-31,LG1,Staff,35,72,404631,1051311122,6642247933,7693559055
2018-08-31,LG1,TPG,143,411,2292508,4151919598,43006843186,47158762784
2018-08-31,LG1,RPG,55,150,840695,4470327643,28998404390,33468732033
2018-08-31,LG1,UG,379,755,4028785,12449828700,91121586035,103571414735
2018-08-31,LG1,Alumni,7,37,215443,472230328,5383563216,5855793544
2018-08-31,LG1,Others(HKUST),5,18,128975,76652658,2137258374,2213911032
2018-08-31,LG1,Non-HKUST,10,28,157956,259753604,1235693702,1495447306
2018-08-31,LG1,Total,634,1471,8068993,22932023653,178525596836,201457620489
2018-08-31,LG3,Staff,30,56,230296,135773300,2926825285,3062598585
2018-08-31,LG3,TPG,47,145,914644,2733052919,36124621258,38857674177
2018-08-31,LG3,RPG,35,70,442071,2041266513,14441136264,16482402777
2018-08-31,LG3,UG,67,129,639904,697497150,8480829693,9178326843
2018-08-31,LG3,Alumni,2,8,74825,894965345,1945924605,2840889950
2018-08-31,LG3,Others(HKUST),1,1,3016,20393196,26786515,47179711
2018-08-31,LG3,Non-HKUST,7,13,61504,241107613,508288004,749395617
2018-08-31,LG3,Total,189,422,2366260,6764056036,64454411624,71218467660
2018-08-31,LG4,Staff,20,33,178524,467248574,4464480074,4931728648
2018-08-31,LG4,TPG,75,149,723593,3156116922,25765263713,28921380635
2018-08-31,LG4,RPG,39,74,461427,710632098,8590079583,9300711681
2018-08-31,LG4,UG,56,103,466677,1137742882,10699684261,11837427143
2018-08-31,LG4,Alumni,5,15,103801,68130131,794354128,862484259
2018-08-31,LG4,Others(HKUST),4,10,77497,104403524,2954960111,3059363635
2018-08-31,LG4,Non-HKUST,5,6,20500,5817845,248233020,254050865
2018-08-31,LG4,Total,204,390,2032019,5650091976,53517054890,59167146866
2018-08-31,All-Floors,Staff,141,523,2909101,3668207565,37630320073,41298527638
2018-08-31,All-Floors,TPG,290,1080,6119125,13356266045,176547604249,189903870294
2018-08-31,All-Floors,RPG,155,421,2580213,8042567848,69514376559,77556944407
2018-08-31,All-Floors,UG,555,1276,6521701,19444580069,126772999099,146217579168
2018-08-31,All-Floors,Alumni,18,80,535228,1634885823,9699862682,11334748505
2018-08-31,All-Floors,Others(HKUST),10,46,314667,245241525,5435128828,5680370353
2018-08-31,All-Floors,Non-HKUST,35,83,444415,645737587,5776499024,6422236611
2018-08-31,All-Floors,Total,1204,3509,19424450,47037486462,431376790514,478414276976
