Date,Floor,User-Group,User-Count,WiFi-Conn,Duration-Sec,Traffic-In-Byte,Traffic-Out-Byte,Traffic-Both-Byte
2020-07-01,1,Alumni,0,0,0,0,0,0
2020-07-01,1,Non-HKUST,0,0,0,0,0,0
2020-07-01,1,Others(HKUST),0,0,0,0,0,0
2020-07-01,1,RPG,3,3,360,106390907,3716496,110107403
2020-07-01,1,Staff,3,19,176727,122526701,28193886,150720587
2020-07-01,1,TPG,1,1,180,22609678,5129129,27738807
2020-07-01,1,Total,7,23,177267,251527286,37039511,288566797
2020-07-01,1,UG,0,0,0,0,0,0
2020-07-01,All-Floors,Alumni,3,4,0,107204201,4144929,111349130
2020-07-01,All-Floors,Non-HKUST,0,0,0,0,0,0
2020-07-01,All-Floors,Others(HKUST),7,38,1122361,67928451213,10558980773,78487431986
2020-07-01,All-Floors,RPG,38,41,4135,1773082834,53900232,1826983066
2020-07-01,All-Floors,Staff,31,90,344990,11761098855,1395361859,13156460714
2020-07-01,All-Floors,TPG,6,7,1439,473626424,70774833,544401257
2020-07-01,All-Floors,Total,122,238,1478145,87724608155,12219593184,99944201339
2020-07-01,All-Floors,UG,37,58,5220,5681144628,136430558,5817575186
2020-07-01,G,Alumni,0,0,0,0,0,0
2020-07-01,G,Non-HKUST,0,0,0,0,0,0
2020-07-01,G,Others(HKUST),2,7,224946,1839938869,257175175,2097114044
2020-07-01,G,RPG,3,3,0,5084926,1647348,6732274
2020-07-01,G,Staff,7,46,167543,11450724401,1317651589,12768375990
2020-07-01,G,TPG,1,1,0,11674,8277,19951
2020-07-01,G,Total,16,65,393029,16532462372,1623764174,18156226546
2020-07-01,G,UG,3,8,540,3236702502,47281785,3283984287
2020-07-01,LG1,Alumni,0,0,0,0,0,0
2020-07-01,LG1,Non-HKUST,0,0,0,0,0,0
2020-07-01,LG1,Others(HKUST),1,17,722816,42641551597,6863058220,49504609817
2020-07-01,LG1,RPG,4,4,1438,24961561,2203139,27164700
2020-07-01,LG1,Staff,4,5,720,2258091,865523,3123614
2020-07-01,LG1,TPG,0,0,0,0,0,0
2020-07-01,LG1,Total,11,28,726414,42672206356,6868133948,49540340304
2020-07-01,LG1,UG,2,2,1440,3435107,2007066,5442173
2020-07-01,LG3,Alumni,3,4,0,107204201,4144929,111349130
2020-07-01,LG3,Non-HKUST,0,0,0,0,0,0
2020-07-01,LG3,Others(HKUST),1,1,0,0,0,0
2020-07-01,LG3,RPG,16,18,2157,1193185980,35339038,1228525018
2020-07-01,LG3,Staff,13,14,0,125916603,44341010,170257613
2020-07-01,LG3,TPG,1,1,0,6189514,366657,6556171
2020-07-01,LG3,Total,59,65,2518,1708008311,93439457,1801447768
2020-07-01,LG3,UG,25,27,361,275512013,9247823,284759836
2020-07-01,LG4,Alumni,0,0,0,0,0,0
2020-07-01,LG4,Non-HKUST,0,0,0,0,0,0
2020-07-01,LG4,Others(HKUST),4,13,174599,23446960747,3438747378,26885708125
2020-07-01,LG4,RPG,13,13,180,443459460,10994211,454453671
2020-07-01,LG4,Staff,6,6,0,59673059,4309851,63982910
2020-07-01,LG4,TPG,3,4,1259,444815558,65270770,510086328
2020-07-01,LG4,Total,40,57,178917,26560403830,3597216094,30157619924
2020-07-01,LG4,UG,14,21,2879,2165495006,77893884,2243388890
2020-07-02,1,Alumni,3,46,123859,3744225164,561353957,4305579121
2020-07-02,1,Non-HKUST,0,0,0,0,0,0
2020-07-02,1,Others(HKUST),5,27,136781,231532201,80373118,311905319
2020-07-02,1,RPG,9,57,228216,11427315418,943076134,12370391552
2020-07-02,1,Staff,62,508,1352451,36291158673,6733350555,43024509228
2020-07-02,1,TPG,14,175,428185,37678286215,3528988646,41207274861
2020-07-02,1,Total,111,905,2530599,102018481351,14949515284,116967996635
2020-07-02,1,UG,18,92,261107,12645963680,3102372874,15748336554
2020-07-02,All-Floors,Alumni,20,189,426345,34181125692,5392990939,39574116631
2020-07-02,All-Floors,Non-HKUST,16,125,239740,52853268076,2492133581,55345401657
2020-07-02,All-Floors,Others(HKUST),15,169,1667649,52615559943,7688865296,60304425239
2020-07-02,All-Floors,RPG,215,1007,2183521,285623315993,28310373844,313933689837
2020-07-02,All-Floors,Staff,285,1900,3247571,174332806558,31399559237,205732365795
2020-07-02,All-Floors,TPG,67,768,1838469,434890261600,36012661705,470902923305
2020-07-02,All-Floors,Total,871,6096,13541566,1641579016797,191400683425,1832979700222
2020-07-02,All-Floors,UG,253,1938,3938271,607082678935,80104098823,687186777758
2020-07-02,G,Alumni,15,38,94971,6472914117,925817153,7398731270
2020-07-02,G,Non-HKUST,7,55,91790,31719202852,1533441645,33252644497
2020-07-02,G,Others(HKUST),10,41,431949,2896991226,273470956,3170462182
2020-07-02,G,RPG,90,290,393400,72640687566,8149304441,80789992007
2020-07-02,G,Staff,146,788,1390036,74806400083,19057140803,93863540886
2020-07-02,G,TPG,45,213,424914,52995105625,13275211829,66270317454
2020-07-02,G,Total,492,2052,3666279,481992044704,63707420646,545699465350
2020-07-02,G,UG,179,627,839219,240460743235,20493033819,260953777054
2020-07-02,LG1,Alumni,5,33,73058,4873218162,281457478,5154675640
2020-07-02,LG1,Non-HKUST,7,31,41945,12537723132,572783754,13110506886
2020-07-02,LG1,Others(HKUST),8,48,902353,24668765008,3832694091,28501459099
2020-07-02,LG1,RPG,56,294,753448,71248250172,9191138268,80439388440
2020-07-02,LG1,Staff,52,234,232045,21454731214,1977048795,23431780009
2020-07-02,LG1,TPG,25,214,555512,41343012620,5552919760,46895932380
2020-07-02,LG1,Total,287,1697,4565893,385459298019,63087764582,448547062601
2020-07-02,LG1,UG,134,843,2007532,209333597711,41679722436,251013320147
2020-07-02,LG3,Alumni,6,29,41756,8247397419,885105392,9132502811
2020-07-02,LG3,Non-HKUST,3,3,3777,575606084,26076003,601682087
2020-07-02,LG3,Others(HKUST),6,16,3778,485881480,27574068,513455548
2020-07-02,LG3,RPG,84,230,528693,64295874168,4316922414,68612796582
2020-07-02,LG3,Staff,101,157,147217,25563012062,1941242790,27504254852
2020-07-02,LG3,TPG,11,62,152704,31771161607,2572853124,34344014731
2020-07-02,LG3,Total,277,714,1300232,236199039714,16290302540,252489342254
2020-07-02,LG3,UG,66,217,422307,105260106894,6520528749,111780635643
2020-07-02,LG4,Alumni,5,43,92701,10843370830,2739256959,13582627789
2020-07-02,LG4,Non-HKUST,6,36,102228,8020736008,359832179,8380568187
2020-07-02,LG4,Others(HKUST),7,37,192788,24332390028,3474753063,27807143091
2020-07-02,LG4,RPG,71,136,279764,66011188669,5709932587,71721121256
2020-07-02,LG4,Staff,78,213,125822,16217504526,1690776294,17908280820
2020-07-02,LG4,TPG,18,104,277154,271102695533,11082688346,282185383879
2020-07-02,LG4,Total,231,728,1478563,435910153009,33365680373,469275833382
2020-07-02,LG4,UG,46,159,408106,39382267415,8308440945,47690708360
2020-07-03,1,Alumni,2,57,101887,5214583007,474235592,5688818599
2020-07-03,1,Non-HKUST,2,6,23407,165080783,76137929,241218712
2020-07-03,1,Others(HKUST),6,29,110043,1028215892,284106993,1312322885
2020-07-03,1,RPG,14,131,326729,35093769864,2026726530,37120496394
2020-07-03,1,Staff,56,538,1234054,26866637298,4906675488,31773312786
2020-07-03,1,TPG,20,196,365194,111577403116,7225572290,118802975406
2020-07-03,1,Total,117,1093,2508153,215353885346,17394024292,232747909638
2020-07-03,1,UG,17,136,346839,35408195386,2400569470,37808764856
2020-07-03,All-Floors,Alumni,20,195,419505,59398580911,4625162972,64023743883
2020-07-03,All-Floors,Non-HKUST,15,126,193895,29460438548,1863878574,31324317122
2020-07-03,All-Floors,Others(HKUST),18,119,1355913,36282660686,6549728185,42832388871
2020-07-03,All-Floors,RPG,203,1055,2059842,1184033333393,47569231551,1231602564944
2020-07-03,All-Floors,Staff,252,1730,2649750,117903120290,17805333979,135708454269
2020-07-03,All-Floors,TPG,84,993,1969620,460822532725,37024462786,497846995511
2020-07-03,All-Floors,Total,816,6083,12466088,2393380167287,181548574169,2574928741456
2020-07-03,All-Floors,UG,224,1865,3817563,505479500734,66110776122,571590276856
2020-07-03,G,Alumni,13,50,73959,11954562694,1243828004,13198390698
2020-07-03,G,Non-HKUST,10,60,63718,17048689928,1317250675,18365940603
2020-07-03,G,Others(HKUST),9,29,423283,1546188210,363848048,1910036258
2020-07-03,G,RPG,86,265,285013,105194616006,6135143514,111329759520
2020-07-03,G,Staff,146,665,982726,60711786223,7952504346,68664290569
2020-07-03,G,TPG,65,263,290724,78259770085,3978060384,82237830469
2020-07-03,G,Total,471,1780,2614582,361005353105,28627403795,389632756900
2020-07-03,G,UG,142,448,495159,86289739959,7636768824,93926508783
2020-07-03,LG1,Alumni,5,22,58143,14780344516,938743658,15719088174
2020-07-03,LG1,Non-HKUST,9,37,60845,6064888448,264201284,6329089732
2020-07-03,LG1,Others(HKUST),7,37,735105,21376070337,3976876730,25352947067
2020-07-03,LG1,RPG,55,294,946392,75909603018,19501139872,95410742890
2020-07-03,LG1,Staff,55,244,183508,11311889838,2441831112,13753720950
2020-07-03,LG1,TPG,44,392,881360,90067350968,15248051836,105315402804
2020-07-03,LG1,Total,276,1851,4874482,432728954843,72106020951,504834975794
2020-07-03,LG1,UG,101,825,2009129,213218807718,29735176459,242953984177
2020-07-03,LG3,Alumni,6,18,36701,4834650541,1117060757,5951711298
2020-07-03,LG3,Non-HKUST,2,2,0,162317821,17675067,179992888
2020-07-03,LG3,Others(HKUST),3,4,0,79388036,76647728,156035764
2020-07-03,LG3,RPG,85,241,347634,757835762950,15113016861,772948779811
2020-07-03,LG3,Staff,85,139,126705,5242798795,906288618,6149087413
2020-07-03,LG3,TPG,23,55,93181,23306208126,2333745348,25639953474
2020-07-03,LG3,Total,283,726,1136894,916230482299,37944750952,954175233251
2020-07-03,LG3,UG,79,267,532673,124769356030,18380316573,143149672603
2020-07-03,LG4,Alumni,7,48,148815,22614440153,851294961,23465735114
2020-07-03,LG4,Non-HKUST,4,21,45925,6019461568,188613619,6208075187
2020-07-03,LG4,Others(HKUST),6,20,87482,12252798211,1848248686,14101046897
2020-07-03,LG4,RPG,57,124,154074,209999581555,4793204774,214792786329
2020-07-03,LG4,Staff,65,144,122757,13770008136,1598034415,15368042551
2020-07-03,LG4,TPG,22,87,339161,157611800430,8239032928,165850833358
2020-07-03,LG4,Total,215,633,1331977,468061491694,25476374179,493537865873
2020-07-03,LG4,UG,54,189,433763,45793401641,7957944796,53751346437
2020-07-04,1,Alumni,3,18,76705,7233868763,501954111,7735822874
2020-07-04,1,Non-HKUST,1,1,0,0,0,0
2020-07-04,1,Others(HKUST),1,17,12782,1468667379,98504261,1567171640
2020-07-04,1,RPG,9,60,279929,11960164805,1205288496,13165453301
2020-07-04,1,Staff,13,121,328506,7683809567,752254242,8436063809
2020-07-04,1,TPG,11,133,313923,40039124877,13109268588,53148393465
2020-07-04,1,Total,47,432,1169547,84487499548,16225591799,100713091347
2020-07-04,1,UG,9,82,157702,16101864157,558322101,16660186258
2020-07-04,All-Floors,Alumni,24,202,473104,91602988030,7119282375,98722270405
2020-07-04,All-Floors,Non-HKUST,8,64,125121,12600213554,2152518832,14752732386
2020-07-04,All-Floors,Others(HKUST),9,109,1610223,70591908609,10643492135,81235400744
2020-07-04,All-Floors,RPG,124,704,1616384,211861404327,32266770690,244128175017
2020-07-04,All-Floors,Staff,70,500,1230581,71244968273,8912957199,80157925472
2020-07-04,All-Floors,TPG,73,858,1817226,283191618784,32200321740,315391940524
2020-07-04,All-Floors,Total,482,3676,9580041,1094401698765,151640947110,1246042645875
2020-07-04,All-Floors,UG,174,1239,2707402,353308597188,58345604139,411654201327
2020-07-04,G,Alumni,17,36,30782,14567724962,1019593204,15587318166
2020-07-04,G,Non-HKUST,3,19,38164,2494379080,218486461,2712865541
2020-07-04,G,Others(HKUST),5,50,527557,4453141587,500880101,4954021688
2020-07-04,G,RPG,62,151,151551,25733895845,3329788264,29063684109
2020-07-04,G,Staff,34,171,533372,26314281082,2488921982,28803203064
2020-07-04,G,TPG,58,207,405624,58698848962,4600044737,63298893699
2020-07-04,G,Total,285,963,2200108,199590279545,28546597981,228136877526
2020-07-04,G,UG,106,329,513058,67328008027,16388883232,83716891259
2020-07-04,LG1,Alumni,10,65,126920,26921652942,3443094551,30364747493
2020-07-04,LG1,Non-HKUST,2,8,17818,1919826407,535716026,2455542433
2020-07-04,LG1,Others(HKUST),2,19,863250,27357001061,4387086958,31744088019
2020-07-04,LG1,RPG,47,283,800908,106492869874,22351380987,128844250861
2020-07-04,LG1,Staff,12,90,113965,24630724452,4958605138,29589329590
2020-07-04,LG1,TPG,35,316,744278,102001269996,10036756680,112038026676
2020-07-04,LG1,Total,192,1308,4175992,449807286051,64198522603,514005808654
2020-07-04,LG1,UG,84,527,1508853,160483941319,18485882263,178969823582
2020-07-04,LG3,Alumni,7,43,81187,30061129167,1529220991,31590350158
2020-07-04,LG3,Non-HKUST,4,20,44292,7124538630,1331629759,8456168389
2020-07-04,LG3,Others(HKUST),4,10,23401,397633490,65108563,462742053
2020-07-04,LG3,RPG,47,152,280466,60094583413,4391798447,64486381860
2020-07-04,LG3,Staff,32,75,118810,7334266986,456696986,7790963972
2020-07-04,LG3,TPG,18,91,170470,46074178820,2057812182,48131991002
2020-07-04,LG3,Total,159,511,869307,229308994459,16128641809,245437636268
2020-07-04,LG3,UG,47,120,150681,78222663953,6296374881,84519038834
2020-07-04,LG4,Alumni,11,40,157510,12818612196,625419518,13444031714
2020-07-04,LG4,Non-HKUST,3,16,24847,1061469437,66686586,1128156023
2020-07-04,LG4,Others(HKUST),4,13,183233,36915465092,5591912252,42507377344
2020-07-04,LG4,RPG,34,58,103530,7579890390,988514496,8568404886
2020-07-04,LG4,Staff,12,43,135928,5281886186,256478851,5538365037
2020-07-04,LG4,TPG,17,111,182931,36378196129,2396439553,38774635682
2020-07-04,LG4,Total,118,462,1165087,131207639162,26541592918,157749232080
2020-07-04,LG4,UG,37,181,377108,31172119732,16616141662,47788261394
2020-07-05,1,Alumni,1,5,19800,3453320575,862767070,4316087645
2020-07-05,1,Non-HKUST,1,1,899,566524,98255,664779
2020-07-05,1,Others(HKUST),1,1,0,24635,12235,36870
2020-07-05,1,RPG,14,47,159119,10886011681,570572469,11456584150
2020-07-05,1,Staff,7,68,266755,5317865658,532821450,5850687108
2020-07-05,1,TPG,8,38,126197,7064719207,362246068,7426965275
2020-07-05,1,Total,39,197,680783,32405816010,5579437128,37985253138
2020-07-05,1,UG,7,37,108013,5683307730,3250919581,8934227311
2020-07-05,All-Floors,Alumni,27,143,370808,46270612856,7358341715,53628954571
2020-07-05,All-Floors,Non-HKUST,7,48,72741,17392063024,698525183,18090588207
2020-07-05,All-Floors,Others(HKUST),8,38,1477211,53486673566,8337944870,61824618436
2020-07-05,All-Floors,RPG,108,422,951700,110054446100,10773880609,120828326709
2020-07-05,All-Floors,Staff,51,379,938333,37903291691,3996075087,41899366778
2020-07-05,All-Floors,TPG,46,403,1045174,141879551880,12382851643,154262403523
2020-07-05,All-Floors,Total,405,2234,6486563,629456444361,64430862719,693887307080
2020-07-05,All-Floors,UG,158,801,1630596,222469805244,20883243612,243353048856
2020-07-05,G,Alumni,12,27,42302,6196700865,466788178,6663489043
2020-07-05,G,Non-HKUST,4,18,29163,10526329460,431547358,10957876818
2020-07-05,G,Others(HKUST),5,11,471579,1875238656,242420527,2117659183
2020-07-05,G,RPG,36,81,118080,15579732126,1554101390,17133833516
2020-07-05,G,Staff,18,168,527031,19292707263,2149621618,21442328881
2020-07-05,G,TPG,31,111,223939,36559127077,5262833578,41821960655
2020-07-05,G,Total,196,674,1884482,125221558052,14523001513,139744559565
2020-07-05,G,UG,90,258,472388,35191722605,4415688864,39607411469
2020-07-05,LG1,Alumni,14,37,86407,5460490159,3853397740,9313887899
2020-07-05,LG1,Non-HKUST,1,18,10807,4471188476,158549052,4629737528
2020-07-05,LG1,Others(HKUST),2,13,809611,26448299810,4296989699,30745289509
2020-07-05,LG1,RPG,28,142,427869,24688155532,5342751784,30030907316
2020-07-05,LG1,Staff,10,46,70935,6413491726,376655303,6790147029
2020-07-05,LG1,TPG,22,191,483703,52833933010,4726722597,57560655607
2020-07-05,LG1,Total,129,720,2554296,252526571719,25429298545,277955870264
2020-07-05,LG1,UG,52,273,664964,132211013006,6674232370,138885245376
2020-07-05,LG3,Alumni,5,33,53997,17322891079,1129163241,18452054320
2020-07-05,LG3,Non-HKUST,2,2,0,105326957,3288400,108615357
2020-07-05,LG3,Others(HKUST),3,5,9718,57140659,58947255,116087914
2020-07-05,LG3,RPG,48,102,174624,47320828255,2159925615,49480753870
2020-07-05,LG3,Staff,27,55,24828,3426166830,251636074,3677802904
2020-07-05,LG3,TPG,13,27,49139,7377861215,347006302,7724867517
2020-07-05,LG3,Total,152,359,551557,102025346016,6053609517,108078955533
2020-07-05,LG3,UG,54,135,239251,26415131021,2103642630,28518773651
2020-07-05,LG4,Alumni,13,41,168302,13837210178,1046225486,14883435664
2020-07-05,LG4,Non-HKUST,3,9,31872,2288651607,105042118,2393693725
2020-07-05,LG4,Others(HKUST),3,8,186303,25105969806,3739575154,28845544960
2020-07-05,LG4,RPG,29,50,72008,11579718506,1146529351,12726247857
2020-07-05,LG4,Staff,14,42,48784,3453060214,685340642,4138400856
2020-07-05,LG4,TPG,8,36,162196,38043911371,1684043098,39727954469
2020-07-05,LG4,Total,110,284,815445,117277152564,12845516016,130122668580
2020-07-05,LG4,UG,40,98,145980,22968630882,4438760167,27407391049
2020-07-06,1,Alumni,1,17,23783,1307352763,161921923,1469274686
2020-07-06,1,Non-HKUST,1,7,35445,628574340,40055008,668629348
2020-07-06,1,Others(HKUST),3,27,117860,114795978,22576455,137372433
2020-07-06,1,RPG,13,108,397414,32646677210,1738870914,34385548124
2020-07-06,1,Staff,61,552,1266373,41815600767,5800960876,47616561643
2020-07-06,1,TPG,11,122,290870,32040028724,2069017113,34109045837
2020-07-06,1,Total,110,951,2584656,141941756563,13782250377,155724006940
2020-07-06,1,UG,20,118,452911,33388726781,3948848088,37337574869
2020-07-06,All-Floors,Alumni,15,210,433065,64266443428,173545824865,237812268293
2020-07-06,All-Floors,Non-HKUST,17,127,215960,52445866648,5274560569,57720427217
2020-07-06,All-Floors,Others(HKUST),13,86,1324456,47624426312,7344085921,54968512233
2020-07-06,All-Floors,RPG,209,1227,2521664,359907919051,34737896229,394645815280
2020-07-06,All-Floors,Staff,261,1978,3455875,209906781379,27786184260,237692965639
2020-07-06,All-Floors,TPG,76,928,2222022,389700107267,44667004669,434367111936
2020-07-06,All-Floors,Total,823,6263,14121642,1738934264735,382736693905,2121670958640
2020-07-06,All-Floors,UG,232,1707,3948600,615082720650,89381137392,704463858042
2020-07-06,G,Alumni,11,32,31274,5990885766,24582516232,30573401998
2020-07-06,G,Non-HKUST,11,25,63836,2291713747,270329402,2562043149
2020-07-06,G,Others(HKUST),5,19,326937,1368740669,167940883,1536681552
2020-07-06,G,RPG,94,329,416319,62986955070,8066721374,71053676444
2020-07-06,G,Staff,150,684,1320085,70660876969,11957635953,82618512922
2020-07-06,G,TPG,54,208,303218,70753096682,6638842261,77391938943
2020-07-06,G,Total,463,1765,3231550,314747128046,77339190899,392086318945
2020-07-06,G,UG,138,468,769881,100694859143,25655204794,126350063937
2020-07-06,LG1,Alumni,5,52,84084,13912614638,146184157394,160096772032
2020-07-06,LG1,Non-HKUST,3,45,52901,40415482419,4604355197,45019837616
2020-07-06,LG1,Others(HKUST),6,22,705061,21930713879,3433951973,25364665852
2020-07-06,LG1,RPG,51,354,865092,77868913016,9837253753,87706166769
2020-07-06,LG1,Staff,67,336,501692,62434392461,5978678730,68413071191
2020-07-06,LG1,TPG,36,438,1066510,166193370259,28155057816,194348428075
2020-07-06,LG1,Total,259,1869,4847696,682859160954,238178282758,921037443712
2020-07-06,LG1,UG,91,622,1572356,300103674282,39984827895,340088502177
2020-07-06,LG3,Alumni,3,53,105452,18255639303,1776300974,20031940277
2020-07-06,LG3,Non-HKUST,9,13,361,2981350601,79046793,3060397394
2020-07-06,LG3,Others(HKUST),3,4,178,20278553,2256144,22534697
2020-07-06,LG3,RPG,88,318,707282,155136034507,11241171369,166377205876
2020-07-06,LG3,Staff,92,150,116784,14012949216,854538411,14867487627
2020-07-06,LG3,TPG,15,60,239810,28607083524,1517154134,30124237658
2020-07-06,LG3,Total,286,848,1634418,328064919950,24744778423,352809698373
2020-07-06,LG3,UG,76,250,464551,109051584246,9274310598,118325894844
2020-07-06,LG4,Alumni,7,56,188472,24799950958,840928342,25640879300
2020-07-06,LG4,Non-HKUST,4,37,63417,6128745541,280774169,6409519710
2020-07-06,LG4,Others(HKUST),7,14,174420,24189897233,3717360466,27907257699
2020-07-06,LG4,RPG,65,118,135557,31269339248,3853878819,35123218067
2020-07-06,LG4,Staff,67,256,250941,20982961966,3194370290,24177332256
2020-07-06,LG4,TPG,23,100,321614,92106528078,6286933345,98393461423
2020-07-06,LG4,Total,228,830,1823322,271321299222,28692191448,300013490670
2020-07-06,LG4,UG,55,249,688901,71843876198,10517946017,82361822215
2020-07-07,1,Alumni,1,1,19612,1710084008,279269880,1989353888
2020-07-07,1,Non-HKUST,2,7,28782,882714928,133832925,1016547853
2020-07-07,1,Others(HKUST),5,29,164999,812030993,94577847,906608840
2020-07-07,1,RPG,17,126,392040,22194423606,1565904180,23760327786
2020-07-07,1,Staff,60,566,1397171,47967998253,7030395420,54998393673
2020-07-07,1,TPG,10,106,315397,23411316048,2656515242,26067831290
2020-07-07,1,Total,112,948,2714135,139474378065,15868659807,155343037872
2020-07-07,1,UG,17,113,396134,42495810229,4108164313,46603974542
2020-07-07,All-Floors,Alumni,21,259,464116,83733417764,37644051627,121377469391
2020-07-07,All-Floors,Non-HKUST,14,110,179806,23190157464,7982163880,31172321344
2020-07-07,All-Floors,Others(HKUST),14,129,1626408,58665391224,9320630612,67986021836
2020-07-07,All-Floors,RPG,209,1163,2381195,250944512579,26090374208,277034886787
2020-07-07,All-Floors,Staff,259,1876,3291044,216402765034,31460737214,247863502248
2020-07-07,All-Floors,TPG,79,859,2005480,450829108745,61578567973,512407676718
2020-07-07,All-Floors,Total,840,6409,14146671,1772786785467,261835627527,2034622412994
2020-07-07,All-Floors,UG,244,2013,4198622,689021432657,87759102013,776780534670
2020-07-07,G,Alumni,15,85,125026,11156126504,1240750724,12396877228
2020-07-07,G,Non-HKUST,8,11,3241,660703690,439903670,1100607360
2020-07-07,G,Others(HKUST),9,30,384487,3173094553,408615473,3581710026
2020-07-07,G,RPG,97,273,319556,49017279411,3440313985,52457593396
2020-07-07,G,Staff,140,656,1393639,100340034487,15621092314,115961126801
2020-07-07,G,TPG,55,195,292288,72873317385,25607915507,98481232892
2020-07-07,G,Total,495,1770,3252523,332104247138,58450827401,390555074539
2020-07-07,G,UG,171,520,734286,94883691108,11692235728,106575926836
2020-07-07,LG1,Alumni,4,72,100243,24702662471,32299029371,57001691842
2020-07-07,LG1,Non-HKUST,2,48,86602,18872936200,7231992507,26104928707
2020-07-07,LG1,Others(HKUST),5,32,899445,30369771185,5029879002,35399650187
2020-07-07,LG1,RPG,51,305,751031,58883216977,8800516625,67683733602
2020-07-07,LG1,Staff,58,291,340937,41996444790,4724981330,46721426120
2020-07-07,LG1,TPG,36,389,940786,206900814184,25121437506,232022251690
2020-07-07,LG1,Total,268,1979,5287676,685067011673,121299158998,806366170671
2020-07-07,LG1,UG,112,842,2168632,303341165866,38091322657,341432488523
2020-07-07,LG3,Alumni,10,47,34922,30749211364,3176702501,33925913865
2020-07-07,LG3,Non-HKUST,2,18,27148,1435476300,91127885,1526604185
2020-07-07,LG3,Others(HKUST),5,19,3059,144550682,54806334,199357016
2020-07-07,LG3,RPG,84,314,652521,85099347927,9028641223,94127989150
2020-07-07,LG3,Staff,95,178,75938,12262558684,2839137139,15101695823
2020-07-07,LG3,TPG,19,53,90709,30369288893,1406890605,31776179498
2020-07-07,LG3,Total,299,895,1217674,281125083890,27347406150,308472490040
2020-07-07,LG3,UG,84,266,333377,121064650040,10750100463,131814750503
2020-07-07,LG4,Alumni,8,54,184313,15415333417,648299151,16063632568
2020-07-07,LG4,Non-HKUST,7,26,34033,1338326346,85306893,1423633239
2020-07-07,LG4,Others(HKUST),6,19,174418,24165943811,3732751956,27898695767
2020-07-07,LG4,RPG,63,145,266047,35750244658,3254998195,39005242853
2020-07-07,LG4,Staff,73,185,83359,13835728820,1245131011,15080859831
2020-07-07,LG4,TPG,20,116,366300,117274372235,6785809113,124060181348
2020-07-07,LG4,Total,244,817,1674663,335016064701,38869575171,373885639872
2020-07-07,LG4,UG,67,272,566193,127236115414,23117278852,150353394266
2020-07-08,1,Alumni,0,0,0,0,0,0
2020-07-08,1,Non-HKUST,1,1,0,30298,32656,62954
2020-07-08,1,Others(HKUST),4,20,114822,76937087,14245609,91182696
2020-07-08,1,RPG,15,113,391545,27371912053,3227336950,30599249003
2020-07-08,1,Staff,61,514,1401452,40763204982,3992849531,44756054513
2020-07-08,1,TPG,9,58,193545,14064840069,1392970725,15457810794
2020-07-08,1,Total,113,852,2690249,132143221451,26858576120,159001797571
2020-07-08,1,UG,23,146,588885,49866296962,18231140649,68097437611
2020-07-08,All-Floors,Alumni,20,277,438518,61001234014,34477338937,95478572951
2020-07-08,All-Floors,Non-HKUST,18,98,274863,21278613591,1719871072,22998484663
2020-07-08,All-Floors,Others(HKUST),14,85,1463595,51523490486,7981610864,59505101350
2020-07-08,All-Floors,RPG,203,1021,2017616,216315440462,25196607017,241512047479
2020-07-08,All-Floors,Staff,281,1814,3614632,248232537071,23011899966,271244437037
2020-07-08,All-Floors,TPG,72,847,1818861,472979345238,69275554859,542254900097
2020-07-08,All-Floors,Total,829,6084,14122406,1725814986365,249570115897,1975385102262
2020-07-08,All-Floors,UG,221,1942,4494321,654484325503,87907233182,742391558685
2020-07-08,G,Alumni,14,69,52886,10555566481,2422517641,12978084122
2020-07-08,G,Non-HKUST,8,28,105974,4031400569,338517519,4369918088
2020-07-08,G,Others(HKUST),7,19,273431,2520617292,255360164,2775977456
2020-07-08,G,RPG,79,268,376533,65944204604,6206851151,72151055755
2020-07-08,G,Staff,158,748,1577362,107142346021,13067223630,120209569651
2020-07-08,G,TPG,57,231,350070,181187369214,13416958352,194604327566
2020-07-08,G,Total,475,1901,3445363,492770410363,47942930279,540713340642
2020-07-08,G,UG,152,538,709107,121388906182,12235501822,133624408004
2020-07-08,LG1,Alumni,9,79,135041,19859570326,30106868872,49966439198
2020-07-08,LG1,Non-HKUST,6,35,89672,8275834107,1058829893,9334664000
2020-07-08,LG1,Others(HKUST),5,17,902004,24538578959,3974652011,28513230970
2020-07-08,LG1,RPG,50,338,811279,51570820716,8374924574,59945745290
2020-07-08,LG1,Staff,40,278,453129,57735893724,3740439079,61476332803
2020-07-08,LG1,TPG,44,435,905421,169919733421,42081471289,212001204710
2020-07-08,LG1,Total,260,1916,5422244,559725592781,123422721617,683148314398
2020-07-08,LG1,UG,106,734,2125698,227825161528,34085535899,261910697427
2020-07-08,LG3,Alumni,9,62,99029,16930780781,1092206491,18022987272
2020-07-08,LG3,Non-HKUST,4,6,1984,138845685,8488123,147333808
2020-07-08,LG3,Others(HKUST),7,14,180,122330872,10582989,132913861
2020-07-08,LG3,RPG,94,198,349362,40527553043,6012188507,46539741550
2020-07-08,LG3,Staff,111,174,120954,35902338940,1684697819,37587036759
2020-07-08,LG3,TPG,16,59,116212,29828350942,7691820854,37520171796
2020-07-08,LG3,Total,299,732,1038436,258270953360,25038988785,283309942145
2020-07-08,LG3,UG,58,219,350715,134820753097,8539004002,143359757099
2020-07-08,LG4,Alumni,7,67,151562,13655316426,855745933,14511062359
2020-07-08,LG4,Non-HKUST,7,28,77233,8832502932,314002881,9146505813
2020-07-08,LG4,Others(HKUST),6,15,173158,24265026276,3726770091,27991796367
2020-07-08,LG4,RPG,54,104,88897,30900950046,1375305835,32276255881
2020-07-08,LG4,Staff,61,100,61735,6688753404,526689907,7215443311
2020-07-08,LG4,TPG,14,64,253613,77979051592,4692333639,82671385231
2020-07-08,LG4,Total,203,683,1526114,282904808410,26306899096,309211707506
2020-07-08,LG4,UG,54,305,719916,120583207734,14816050810,135399258544
2020-07-09,1,Alumni,0,0,0,0,0,0
2020-07-09,1,Non-HKUST,1,3,16203,148334989,60668745,209003734
2020-07-09,1,Others(HKUST),4,21,139836,273604127,181237710,454841837
2020-07-09,1,RPG,18,149,464020,46392602873,2912772483,49305375356
2020-07-09,1,Staff,55,488,1181362,62590444695,5794234077,68384678772
2020-07-09,1,TPG,13,98,360048,23587422550,1873181940,25460604490
2020-07-09,1,Total,110,907,2601998,175900665489,15213028869,191113694358
2020-07-09,1,UG,19,148,440529,42908256255,4390933914,47299190169
2020-07-09,All-Floors,Alumni,24,225,494453,89293275391,6102100988,95395376379
2020-07-09,All-Floors,Non-HKUST,14,91,193207,48844057276,4063714194,52907771470
2020-07-09,All-Floors,Others(HKUST),15,68,1324979,37604271065,5960100922,43564371987
2020-07-09,All-Floors,RPG,226,1366,2642096,410793791221,41505908997,452299700218
2020-07-09,All-Floors,Staff,264,1887,2889278,216602336505,24783279824,241385616329
2020-07-09,All-Floors,TPG,84,1044,2114597,302941727898,46799627245,349741355143
2020-07-09,All-Floors,Total,890,6789,13808868,1919713905065,201654878885,2121368783950
2020-07-09,All-Floors,UG,263,2108,4150258,813634445709,72440146715,886074592424
2020-07-09,G,Alumni,15,40,16737,10171300872,388119560,10559420432
2020-07-09,G,Non-HKUST,7,17,17827,5793936096,339426678,6133362774
2020-07-09,G,Others(HKUST),6,15,365588,3281260670,485967743,3767228413
2020-07-09,G,RPG,98,322,491260,72029163900,10333215495,82362379395
2020-07-09,G,Staff,140,717,1096349,91513504010,11368917752,102882421762
2020-07-09,G,TPG,64,216,191684,54785074234,7772095969,62557170203
2020-07-09,G,Total,493,1861,2949198,363028567788,44975955328,408004523116
2020-07-09,G,UG,163,534,769753,125454328006,14288212131,139742540137
2020-07-09,LG1,Alumni,9,88,176913,14735269982,1136613769,15871883751
2020-07-09,LG1,Non-HKUST,4,47,104979,40278792598,3577705291,43856497889
2020-07-09,LG1,Others(HKUST),4,12,732797,21906518078,3415644947,25322163025
2020-07-09,LG1,RPG,61,418,873669,78973459782,11482484183,90455943965
2020-07-09,LG1,Staff,67,313,412696,37329372371,4069691344,41399063715
2020-07-09,LG1,TPG,41,556,1064503,167707920394,31723495936,199431416330
2020-07-09,LG1,Total,309,2342,5509209,676112863634,87100359595,763213223229
2020-07-09,LG1,UG,123,908,2143652,315181530429,31694724125,346876254554
2020-07-09,LG3,Alumni,7,31,61918,31328771588,2873981763,34202753351
2020-07-09,LG3,Non-HKUST,5,8,21246,1709234730,52717130,1761951860
2020-07-09,LG3,Others(HKUST),4,7,179,5210852,1156796,6367648
2020-07-09,LG3,RPG,94,329,601639,152308300355,13486428582,165794728937
2020-07-09,LG3,Staff,91,157,63556,11911807752,843370266,12755178018
2020-07-09,LG3,TPG,23,46,98736,9108876347,879311974,9988188321
2020-07-09,LG3,Total,305,840,1171124,433761259620,28846363977,462607623597
2020-07-09,LG3,UG,81,262,323850,227389057996,10709397466,238098455462
2020-07-09,LG4,Alumni,10,66,238885,33057932949,1703385896,34761318845
2020-07-09,LG4,Non-HKUST,4,16,32952,913758863,33196350,946955213
2020-07-09,LG4,Others(HKUST),7,13,86579,12137677338,1876093726,14013771064
2020-07-09,LG4,RPG,66,148,211508,61090264311,3291008254,64381272565
2020-07-09,LG4,Staff,79,212,135315,13257207677,2707066385,15964274062
2020-07-09,LG4,TPG,24,128,399626,47752434373,4551541426,52303975799
2020-07-09,LG4,Total,251,839,1577339,270910548534,25519171116,296429719650
2020-07-09,LG4,UG,61,256,472474,102701273023,11356879079,114058152102
2020-07-10,1,Alumni,0,0,0,0,0,0
2020-07-10,1,Non-HKUST,1,54,51861,118992576305,5058514133,124051090438
2020-07-10,1,Others(HKUST),6,21,236913,1415051313,123938494,1538989807
2020-07-10,1,RPG,19,143,427118,90843194127,3939476607,94782670734
2020-07-10,1,Staff,57,472,1232981,50238391801,4362042533,54600434334
2020-07-10,1,TPG,13,83,269093,16559224922,1303638178,17862863100
2020-07-10,1,Total,123,1012,2893600,387258459833,24452631612,411711091445
2020-07-10,1,UG,27,239,675634,109210021365,9665021667,118875043032
2020-07-10,All-Floors,Alumni,21,245,571907,65445402361,6550795423,71996197784
2020-07-10,All-Floors,Non-HKUST,17,129,210462,131422998564,5528663488,136951662052
2020-07-10,All-Floors,Others(HKUST),13,82,1666982,68919127131,10777954604,79697081735
2020-07-10,All-Floors,RPG,212,1259,2545879,422256954899,31983502983,454240457882
2020-07-10,All-Floors,Staff,269,1980,3190936,293873117088,23667626306,317540743394
2020-07-10,All-Floors,TPG,70,793,1759781,438361382968,100819068715,539180451683
2020-07-10,All-Floors,Total,840,6407,14117793,2135725437414,261405470177,2397130907591
2020-07-10,All-Floors,UG,238,1919,4171846,715446454403,82077858658,797524313061
2020-07-10,G,Alumni,16,51,43140,12470698595,516922483,12987621078
2020-07-10,G,Non-HKUST,8,28,78842,6299012038,225356670,6524368708
2020-07-10,G,Others(HKUST),7,20,356589,2779730823,425249803,3204980626
2020-07-10,G,RPG,96,295,321034,58703352411,5512843905,64216196316
2020-07-10,G,Staff,138,800,1282885,103147395047,9768757503,112916152550
2020-07-10,G,TPG,58,234,461138,67428658161,7420199945,74848858106
2020-07-10,G,Total,473,1954,3133207,359774538272,37096038217,396870576489
2020-07-10,G,UG,150,526,589579,108945691197,13226707908,122172399105
2020-07-10,LG1,Alumni,9,105,270893,25444497729,2019017945,27463515674
2020-07-10,LG1,Non-HKUST,4,14,5582,1909368622,71180094,1980548716
2020-07-10,LG1,Others(HKUST),5,25,900150,28444554812,4588638064,33033192876
2020-07-10,LG1,RPG,62,385,1027655,108447529462,9785484747,118233014209
2020-07-10,LG1,Staff,60,261,409902,93997390157,6773900264,100771290421
2020-07-10,LG1,TPG,36,299,573687,278587490998,75233151425,353820642423
2020-07-10,LG1,Total,287,1791,5122765,790037879963,130362938841,920400818804
2020-07-10,LG1,UG,111,702,1934896,253207048183,31891566302,285098614485
2020-07-10,LG3,Alumni,10,30,53254,11361477669,764731096,12126208765
2020-07-10,LG3,Non-HKUST,1,1,0,186905,96534,283439
2020-07-10,LG3,Others(HKUST),4,4,0,4558470,519684,5078154
2020-07-10,LG3,RPG,78,240,474549,78202870184,4582900980,82785771164
2020-07-10,LG3,Staff,101,175,79765,15675584315,737652499,16413236814
2020-07-10,LG3,TPG,16,51,65657,10836226735,2031065972,12867292707
2020-07-10,LG3,Total,255,706,1069537,285935769994,22317019035,308252789029
2020-07-10,LG3,UG,45,205,396312,169854865716,14200052270,184054917986
2020-07-10,LG4,Alumni,9,59,204620,16168728368,3250123899,19418852267
2020-07-10,LG4,Non-HKUST,9,32,74177,4221854694,173516057,4395370751
2020-07-10,LG4,Others(HKUST),4,12,173330,36275231713,5639608559,41914840272
2020-07-10,LG4,RPG,64,196,295523,86060008715,8162796744,94222805459
2020-07-10,LG4,Staff,82,272,185403,30814355768,2025273507,32839629275
2020-07-10,LG4,TPG,14,126,390206,64949782152,14831013195,79780795347
2020-07-10,LG4,Total,244,944,1898684,312718789352,47176842472,359895631824
2020-07-10,LG4,UG,62,247,575425,74228827942,13094510511,87323338453
2020-07-11,1,Alumni,0,0,0,0,0,0
2020-07-11,1,Non-HKUST,1,1,0,2419385,468876,2888261
2020-07-11,1,Others(HKUST),2,5,172798,87975371,25314319,113289690
2020-07-11,1,RPG,13,73,242680,15190427025,2042818069,17233245094
2020-07-11,1,Staff,6,24,445140,2259898957,132044418,2391943375
2020-07-11,1,TPG,1,16,53276,2038664782,219882849,2258547631
2020-07-11,1,Total,35,244,1201947,48995726247,52605142836,101600869083
2020-07-11,1,UG,12,125,288053,29416340727,50184614305,79600955032
2020-07-11,All-Floors,Alumni,25,245,584331,122834880035,12507793207,135342673242
2020-07-11,All-Floors,Non-HKUST,9,39,72538,13277918829,1049027699,14326946528
2020-07-11,All-Floors,Others(HKUST),9,52,1484807,50205994338,7769580996,57975575334
2020-07-11,All-Floors,RPG,147,764,1417627,206517389479,27822991968,234340381447
2020-07-11,All-Floors,Staff,76,292,1080566,63912567328,6188817117,70101384445
2020-07-11,All-Floors,TPG,27,271,742398,93012763283,5668467324,98681230607
2020-07-11,All-Floors,Total,430,2779,7827212,1008004670408,165708466057,1173713136465
2020-07-11,All-Floors,UG,137,1116,2444945,458243157116,104701787746,562944944862
2020-07-11,G,Alumni,17,62,88563,22555706025,4072323997,26628030022
2020-07-11,G,Non-HKUST,7,10,15475,2235006386,162363338,2397369724
2020-07-11,G,Others(HKUST),5,12,352980,3197529853,351546879,3549076732
2020-07-11,G,RPG,61,179,197837,29864807234,5609140996,35473948230
2020-07-11,G,Staff,31,149,454887,24641029365,3409594358,28050623723
2020-07-11,G,TPG,15,67,200375,16468206172,1024860568,17493066740
2020-07-11,G,Total,205,796,1844969,236172095350,26879209172,263051304522
2020-07-11,G,UG,69,317,534852,137209810315,12249379036,149459189351
2020-07-11,LG1,Alumni,10,119,264642,72773127348,3597268942,76370396290
2020-07-11,LG1,Non-HKUST,5,19,44822,10972750966,868580223,11841331189
2020-07-11,LG1,Others(HKUST),2,23,785871,22683777969,3656837380,26340615349
2020-07-11,LG1,RPG,38,290,563425,82231462120,15048182249,97279644369
2020-07-11,LG1,Staff,15,54,97935,30202977575,1804612051,32007589626
2020-07-11,LG1,TPG,13,133,315756,31291756792,2015479971,33307236763
2020-07-11,LG1,Total,143,1068,3263384,423811713912,54354688285,478166402197
2020-07-11,LG1,UG,60,430,1190933,173655861142,27363727469,201019588611
2020-07-11,LG3,Alumni,5,26,45178,12979602302,1078889449,14058491751
2020-07-11,LG3,Non-HKUST,1,2,358,23510932,2611992,26122924
2020-07-11,LG3,Others(HKUST),3,6,180,40198071,8121719,48319790
2020-07-11,LG3,RPG,47,125,271833,53137234727,3514048747,56651283474
2020-07-11,LG3,Staff,26,43,82424,6058109326,701118113,6759227439
2020-07-11,LG3,TPG,8,27,100625,15448150955,1032060269,16480211224
2020-07-11,LG3,Total,134,355,753152,153926011387,10829944908,164755956295
2020-07-11,LG3,UG,44,126,252554,66239205074,4493094619,70732299693
2020-07-11,LG4,Alumni,10,38,185948,14526444360,3759310819,18285755179
2020-07-11,LG4,Non-HKUST,2,7,11883,44231160,15003270,59234430
2020-07-11,LG4,Others(HKUST),4,6,172978,24196513074,3727760699,27924273773
2020-07-11,LG4,RPG,49,97,141852,26093458373,1608801907,27702260280
2020-07-11,LG4,Staff,18,22,180,750552105,141448177,892000282
2020-07-11,LG4,TPG,5,28,72366,27765984582,1376183667,29142168249
2020-07-11,LG4,Total,120,316,763760,145099123512,21039480856,166138604368
2020-07-11,LG4,UG,32,118,178553,51721939858,10410972317,62132912175
2020-07-12,1,Alumni,6,18,73444,7183427885,787415039,7970842924
2020-07-12,1,Non-HKUST,1,1,0,86038842,5340120,91378962
2020-07-12,1,Others(HKUST),3,5,200706,29424042,17434093,46858135
2020-07-12,1,RPG,12,34,103152,7017547629,377997303,7395544932
2020-07-12,1,Staff,14,78,447852,2435539889,189560379,2625100268
2020-07-12,1,TPG,0,0,0,0,0,0
2020-07-12,1,Total,49,204,1017951,35690302579,3299426146,38989728725
2020-07-12,1,UG,13,68,192797,18938324292,1921679212,20860003504
2020-07-12,All-Floors,Alumni,21,127,267492,58188880480,3536944923,61725825403
2020-07-12,All-Floors,Non-HKUST,14,56,82986,22385025490,12035855896,34420881386
2020-07-12,All-Floors,Others(HKUST),9,50,1272752,51914153268,8120521840,60034675108
2020-07-12,All-Floors,RPG,189,586,785591,94691722388,20929929050,115621651438
2020-07-12,All-Floors,Staff,97,359,1068320,58198263176,8181089193,66379352369
2020-07-12,All-Floors,TPG,27,162,430955,120065744067,7443304331,127509048398
2020-07-12,All-Floors,Total,508,1990,5384348,798306354089,91146119624,889452473713
2020-07-12,All-Floors,UG,151,650,1476252,392862565220,30898474391,423761039611
2020-07-12,G,Alumni,14,40,46088,19993474717,1228185319,21221660036
2020-07-12,G,Non-HKUST,8,12,9003,7611763923,2492589538,10104353461
2020-07-12,G,Others(HKUST),5,10,259197,2157882805,229229369,2387112174
2020-07-12,G,RPG,55,150,182351,26897367991,1605667366,28503035357
2020-07-12,G,Staff,29,134,527040,41187573556,7184513675,48372087231
2020-07-12,G,TPG,17,54,87127,12661587472,1248806373,13910393845
2020-07-12,G,Total,181,554,1401709,141292909060,18063400255,159356309315
2020-07-12,G,UG,53,154,290903,30783258596,4074408615,34857667211
2020-07-12,LG1,Alumni,6,13,13319,2066895973,57118112,2124014085
2020-07-12,LG1,Non-HKUST,4,23,59579,14608701760,9522616928,24131318688
2020-07-12,LG1,Others(HKUST),2,18,622044,25394004487,4125870024,29519874511
2020-07-12,LG1,RPG,24,175,317896,27338778810,14780206965,42118985775
2020-07-12,LG1,Staff,13,44,55448,12494638183,523628791,13018266974
2020-07-12,LG1,TPG,8,66,212416,50214657603,3262797519,53477455122
2020-07-12,LG1,Total,97,522,1899918,185737707308,35874493849,221612201157
2020-07-12,LG1,UG,40,183,619216,53620030492,3602255510,57222286002
2020-07-12,LG3,Alumni,6,28,35096,15469857968,669391606,16139249574
2020-07-12,LG3,Non-HKUST,7,7,0,30964310,1319828,32284138
2020-07-12,LG3,Others(HKUST),1,2,0,3820848,200187,4021035
2020-07-12,LG3,RPG,43,98,102436,30344728880,2561526588,32906255468
2020-07-12,LG3,Staff,29,47,15300,986133709,57819829,1043953538
2020-07-12,LG3,TPG,8,15,87848,14497325958,669744300,15167070258
2020-07-12,LG3,Total,141,296,461008,102241386936,6415839958,108657226894
2020-07-12,LG3,UG,47,99,220328,40908555263,2455837620,43364392883
2020-07-12,LG4,Alumni,9,28,99545,13475223937,794834847,14270058784
2020-07-12,LG4,Non-HKUST,6,13,14404,47556655,13989482,61546137
2020-07-12,LG4,Others(HKUST),4,15,190805,24329021086,3747788167,28076809253
2020-07-12,LG4,RPG,98,129,79756,3093299078,1604530828,4697829906
2020-07-12,LG4,Staff,41,56,22680,1094377839,225566519,1319944358
2020-07-12,LG4,TPG,11,27,43564,42692173034,2261956139,44954129173
2020-07-12,LG4,Total,248,414,603762,333344048206,27492959416,360837007622
2020-07-12,LG4,UG,79,146,153008,248612396577,18844293434,267456690011
2020-07-13,1,Alumni,1,6,10443,1523826638,105724422,1629551060
2020-07-13,1,Non-HKUST,0,0,0,0,0,0
2020-07-13,1,Others(HKUST),6,27,229888,4169755477,218031822,4387787299
2020-07-13,1,RPG,24,201,523190,40207306640,7866166331,48073472971
2020-07-13,1,Staff,60,562,1421270,47018706592,12429579084,59448285676
2020-07-13,1,TPG,4,35,74686,8181594337,537406437,8719000774
2020-07-13,1,Total,110,931,2604300,131811266746,29667461872,161478728618
2020-07-13,1,UG,15,100,344823,30710077062,8510553776,39220630838
2020-07-13,All-Floors,Alumni,15,246,378141,61171530411,8611448346,69782978757
2020-07-13,All-Floors,Non-HKUST,10,67,144199,13840375730,634676027,14475051757
2020-07-13,All-Floors,Others(HKUST),22,187,1668034,353621984659,22347300403,375969285062
2020-07-13,All-Floors,RPG,218,1465,2729031,452689448785,39301486259,491990935044
2020-07-13,All-Floors,Staff,228,1910,3208857,2120052537720,175600108142,2295652645862
2020-07-13,All-Floors,TPG,47,687,1545412,235494795691,29448830669,264943626360
2020-07-13,All-Floors,Total,710,5915,12649845,3668165414536,344991930841,4013157345377
2020-07-13,All-Floors,UG,170,1353,2976171,431294741540,69048080995,500342822535
2020-07-13,G,Alumni,8,29,1799,4677804475,912554638,5590359113
2020-07-13,G,Non-HKUST,7,27,43935,3443315797,241311959,3684627756
2020-07-13,G,Others(HKUST),10,33,368640,10693183697,735949497,11429133194
2020-07-13,G,RPG,98,417,560984,91199861218,8658972117,99858833335
2020-07-13,G,Staff,116,625,1239233,80255398085,20175798062,100431196147
2020-07-13,G,TPG,40,198,289966,46573840310,4620375571,51194215881
2020-07-13,G,Total,386,1722,3196426,323940660862,47057646056,370998306918
2020-07-13,G,UG,107,393,691869,87097257280,11712684212,98809941492
2020-07-13,LG1,Alumni,6,122,188621,25297641913,4610588417,29908230330
2020-07-13,LG1,Non-HKUST,2,8,11160,231930085,12341673,244271758
2020-07-13,LG1,Others(HKUST),9,40,852801,60404255469,9432028787,69836284256
2020-07-13,LG1,RPG,55,443,956735,94712530039,11633333563,106345863602
2020-07-13,LG1,Staff,47,241,323155,42549152669,3024111433,45573264102
2020-07-13,LG1,TPG,26,288,749309,124879917190,16581703476,141461620666
2020-07-13,LG1,Total,216,1573,4166797,503386538893,72574864248,575961403141
2020-07-13,LG1,UG,71,431,1085016,155311111528,27280756899,182591868427
2020-07-13,LG3,Alumni,6,36,67859,20825098467,2047422279,22872520746
2020-07-13,LG3,Non-HKUST,3,11,49134,651158326,75281440,726439766
2020-07-13,LG3,Others(HKUST),6,26,13875,1070218065,100139412,1170357477
2020-07-13,LG3,RPG,82,243,438794,206929648388,8578716506,215508364894
2020-07-13,LG3,Staff,89,310,121491,1927418361415,136257555570,2063675916985
2020-07-13,LG3,TPG,15,46,36694,9480583872,870172415,10350756287
2020-07-13,LG3,Total,259,854,1138568,2264529971638,152725692414,2417255664052
2020-07-13,LG3,UG,58,182,410721,98154903105,4796404792,102951307897
2020-07-13,LG4,Alumni,5,53,109419,8847158918,935158590,9782317508
2020-07-13,LG4,Non-HKUST,5,21,39970,9513971522,305740955,9819712477
2020-07-13,LG4,Others(HKUST),11,61,202830,277284571951,11861150885,289145722836
2020-07-13,LG4,RPG,76,161,249328,19640102500,2564297742,22204400242
2020-07-13,LG4,Staff,67,172,103708,22810918959,3713063993,26523982952
2020-07-13,LG4,TPG,13,120,394757,46378859982,6839172770,53218032752
2020-07-13,LG4,Total,219,835,1543754,444496976397,42966266251,487463242648
2020-07-13,LG4,UG,42,247,443742,60021392565,16747681316,76769073881
2020-07-14,1,Alumni,2,9,28799,4504077697,1476916463,5980994160
2020-07-14,1,Non-HKUST,2,18,5222,96435032,10234056,106669088
2020-07-14,1,Others(HKUST),3,9,149603,318562574,115308806,433871380
2020-07-14,1,RPG,12,141,346270,20032422957,3285833563,23318256520
2020-07-14,1,Staff,50,493,1341534,36880858856,4218946433,41099805289
2020-07-14,1,TPG,8,93,223873,16850880133,1413274924,18264155057
2020-07-14,1,Total,90,893,2567455,109516925827,18869477195,128386403022
2020-07-14,1,UG,13,130,472154,30833688578,8348962950,39182651528
2020-07-14,All-Floors,Alumni,22,284,561191,96325783639,11231806678,107557590317
2020-07-14,All-Floors,Non-HKUST,12,67,110943,9614016113,900511666,10514527779
2020-07-14,All-Floors,Others(HKUST),11,82,1458546,59129611226,9312856828,68442468054
2020-07-14,All-Floors,RPG,213,1218,2556574,230502215780,32999107047,263501322827
2020-07-14,All-Floors,Staff,200,1848,3483585,1780388049806,61314472878,1841702522684
2020-07-14,All-Floors,TPG,39,502,1083829,145649542935,22524992686,168174535621
2020-07-14,All-Floors,Total,670,5747,13237733,2938193179111,198539534385,3136732713496
2020-07-14,All-Floors,UG,173,1746,3983065,616583959612,60255786602,676839746214
2020-07-14,G,Alumni,15,49,28441,7786756550,1917891715,9704648265
2020-07-14,G,Non-HKUST,6,10,6855,1734031691,105990731,1840022422
2020-07-14,G,Others(HKUST),5,21,283508,2638805583,339013685,2977819268
2020-07-14,G,RPG,93,368,577956,64389983101,7617583617,72007566718
2020-07-14,G,Staff,121,628,1267534,178017788381,14067122928,192084911309
2020-07-14,G,TPG,31,115,209626,36845731112,6704959971,43550691083
2020-07-14,G,Total,386,1687,3313090,402367432942,41526726760,443894159702
2020-07-14,G,UG,115,496,939170,110954336524,10774164113,121728500637
2020-07-14,LG1,Alumni,9,107,266707,29336879618,1287854842,30624734460
2020-07-14,LG1,Non-HKUST,5,21,44840,4745333328,625134447,5370467775
2020-07-14,LG1,Others(HKUST),8,28,850655,31853420951,5101682031,36955102982
2020-07-14,LG1,RPG,51,308,767954,59383003783,13672265181,73055268964
2020-07-14,LG1,Staff,52,362,590503,99133057623,8405365347,107538422970
2020-07-14,LG1,TPG,20,215,498644,59084717001,10142219043,69226936044
2020-07-14,LG1,Total,225,1692,4674105,525957930396,63601164459,589559094855
2020-07-14,LG1,UG,80,651,1654802,242421518092,24366643568,266788161660
2020-07-14,LG3,Alumni,10,45,73061,42635380195,3101910076,45737290271
2020-07-14,LG3,Non-HKUST,4,7,43404,2638254147,130085741,2768339888
2020-07-14,LG3,Others(HKUST),3,7,181,5242578,2629703,7872281
2020-07-14,LG3,RPG,93,230,543985,57238796826,5825031847,63063828673
2020-07-14,LG3,Staff,65,224,165971,1440827338378,33026772136,1473854110514
2020-07-14,LG3,TPG,6,15,3241,1074643923,985627702,2060271625
2020-07-14,LG3,Total,230,802,1283859,1711618634226,50750031665,1762368665891
2020-07-14,LG3,UG,49,274,454016,167198978179,7677974460,174876952639
2020-07-14,LG4,Alumni,7,74,164183,12062689579,3447233582,15509923161
2020-07-14,LG4,Non-HKUST,3,11,10622,399961915,29066691,429028606
2020-07-14,LG4,Others(HKUST),5,17,174599,24313579540,3754222603,28067802143
2020-07-14,LG4,RPG,72,171,320409,29458009113,2598392839,32056401952
2020-07-14,LG4,Staff,51,141,118043,25529006568,1596266034,27125272602
2020-07-14,LG4,TPG,8,64,148445,31793570766,3278911046,35072481812
2020-07-14,LG4,Total,194,673,1399224,188732255720,23792134306,212524390026
2020-07-14,LG4,UG,48,195,462923,65175438239,9088041511,74263479750
2020-07-15,1,Alumni,2,11,42509,2864443959,760621702,3625065661
2020-07-15,1,Non-HKUST,1,8,17814,174807931,33093070,207901001
2020-07-15,1,Others(HKUST),3,13,151392,3640258982,147510095,3787769077
2020-07-15,1,RPG,15,117,430193,41177404870,6579986308,47757391178
2020-07-15,1,Staff,55,486,1384563,40717301674,3485083237,44202384911
2020-07-15,1,TPG,7,122,225250,24817654827,7212352861,32030007688
2020-07-15,1,Total,96,846,2598448,133705161156,19797533245,153502694401
2020-07-15,1,UG,13,89,346727,20313288913,1578885972,21892174885
2020-07-15,All-Floors,Alumni,28,375,765188,121412021234,16650974377,138062995611
2020-07-15,All-Floors,Non-HKUST,13,77,159702,6929137733,494338515,7423476248
2020-07-15,All-Floors,Others(HKUST),18,116,1333008,55062273936,8259001383,63321275319
2020-07-15,All-Floors,RPG,231,1144,2391334,351365294576,41544732536,392910027112
2020-07-15,All-Floors,Staff,227,1754,3132311,2156206519745,156478409415,2312684929160
2020-07-15,All-Floors,TPG,51,790,1640557,268089615244,44768822354,312858437598
2020-07-15,All-Floors,Total,716,5764,12772872,3542916543457,364969986022,3907886529479
2020-07-15,All-Floors,UG,148,1508,3350772,583851680989,96773707442,680625388431
2020-07-15,G,Alumni,20,65,105851,19313458837,2278794323,21592253160
2020-07-15,G,Non-HKUST,5,23,43940,1091179734,85641752,1176821486
2020-07-15,G,Others(HKUST),9,29,361063,4810070479,511306683,5321377162
2020-07-15,G,RPG,78,293,416804,80029127906,6647335504,86676463410
2020-07-15,G,Staff,116,619,1259809,143352326592,19538413270,162890739862
2020-07-15,G,TPG,43,207,393556,64628665837,9046727832,73675393669
2020-07-15,G,Total,359,1579,3198643,420579232270,52488566187,473067798457
2020-07-15,G,UG,88,343,617620,107354402885,14380346823,121734749708
2020-07-15,LG1,Alumni,13,159,338039,43775114531,6629882713,50404997244
2020-07-15,LG1,Non-HKUST,6,31,76518,5523477656,361893531,5885371187
2020-07-15,LG1,Others(HKUST),8,44,732893,34139801367,5703223742,39843025109
2020-07-15,LG1,RPG,42,333,728087,95224920210,16237784531,111462704741
2020-07-15,LG1,Staff,53,242,323229,58297239250,8014910328,66312149578
2020-07-15,LG1,TPG,26,317,650290,97817923219,12248569244,110066492463
2020-07-15,LG1,Total,220,1803,4409894,590421044006,85441247496,675862291502
2020-07-15,LG1,UG,72,677,1560838,255642567773,36244983407,291887551180
2020-07-15,LG3,Alumni,7,39,39418,18837319811,2656411805,21493731616
2020-07-15,LG3,Non-HKUST,2,2,1081,5483688,1962929,7446617
2020-07-15,LG3,Others(HKUST),6,17,901,273313548,13917569,287231117
2020-07-15,LG3,RPG,103,248,619326,103411612525,5581864649,108993477174
2020-07-15,LG3,Staff,92,275,103159,1739610593584,113610462713,1853221056297
2020-07-15,LG3,TPG,10,34,111201,26843466403,1431671378,28275137781
2020-07-15,LG3,Total,263,836,1286587,2023447864353,156831852732,2180279717085
2020-07-15,LG3,UG,43,221,411501,134466074794,33535561689,168001636483
2020-07-15,LG4,Alumni,11,101,239371,36621684096,4325263834,40946947930
2020-07-15,LG4,Non-HKUST,5,13,20349,134188724,11747233,145935957
2020-07-15,LG4,Others(HKUST),7,13,86759,12198829560,1883043294,14081872854
2020-07-15,LG4,RPG,77,153,196924,31522229065,6497761544,38019990609
2020-07-15,LG4,Staff,53,132,61551,174229058645,11829539867,186058598512
2020-07-15,LG4,TPG,10,110,260260,53981904958,14829501039,68811405997
2020-07-15,LG4,Total,205,700,1279300,374763241672,50410786362,425174028034
2020-07-15,LG4,UG,42,178,414086,66075346624,11033929551,77109276175
2020-07-16,1,Alumni,1,3,361,362603,199049,561652
2020-07-16,1,Non-HKUST,1,2,22148,81513533,5330952,86844485
2020-07-16,1,Others(HKUST),3,26,193153,112888724,26893981,139782705
2020-07-16,1,RPG,16,127,354500,33365666196,3222383993,36588050189
2020-07-16,1,Staff,50,505,1200689,54002119841,9944553178,63946673019
2020-07-16,1,TPG,3,27,62282,7275870147,345564358,7621434505
2020-07-16,1,Total,86,806,2126388,114599909181,15296917718,129896826899
2020-07-16,1,UG,12,116,293255,19761488137,1751992207,21513480344
2020-07-16,All-Floors,Alumni,18,289,499842,122548019484,22451581631,144999601115
2020-07-16,All-Floors,Non-HKUST,7,61,198208,19637868074,972247027,20610115101
2020-07-16,All-Floors,Others(HKUST),16,107,1625774,66378733779,10328804922,76707538701
2020-07-16,All-Floors,RPG,214,1190,2438644,262568038452,28441528518,291009566970
2020-07-16,All-Floors,Staff,232,1725,2908105,257313680002,45088885318,302402565320
2020-07-16,All-Floors,TPG,51,556,1207394,225719732446,17627472881,243347205327
2020-07-16,All-Floors,Total,707,5832,12681141,1795711992324,236178181626,2031890173950
2020-07-16,All-Floors,UG,169,1904,3803174,841545920087,111267661329,952813581416
2020-07-16,G,Alumni,12,64,75594,10913985134,3323363574,14237348708
2020-07-16,G,Non-HKUST,6,12,1260,810804280,117062313,927866593
2020-07-16,G,Others(HKUST),6,16,359290,3464423510,444461531,3908885041
2020-07-16,G,RPG,87,297,335161,40688741794,4956971565,45645713359
2020-07-16,G,Staff,124,680,1243848,127513324661,27611216189,155124540850
2020-07-16,G,TPG,38,149,276817,48378971821,3640975120,52019946941
2020-07-16,G,Total,388,1627,3018206,373935295054,55943014283,429878309337
2020-07-16,G,UG,115,409,726236,142165043854,15848963991,158014007845
2020-07-16,LG1,Alumni,8,103,185616,29433680445,13286963028,42720643473
2020-07-16,LG1,Non-HKUST,3,37,119521,13519358131,723614829,14242972960
2020-07-16,LG1,Others(HKUST),4,18,895325,25853664541,4160598259,30014262800
2020-07-16,LG1,RPG,47,379,911640,91790913021,13993096236,105784009257
2020-07-16,LG1,Staff,49,208,276915,31719308966,2749840520,34469149486
2020-07-16,LG1,TPG,25,265,598736,73806505243,5337388339,79143893582
2020-07-16,LG1,Total,216,1881,4736986,568951043355,94608837727,663559881082
2020-07-16,LG1,UG,80,871,1749233,302827613008,54357336516,357184949524
2020-07-16,LG3,Alumni,7,64,88541,46671049965,3411378778,50082428743
2020-07-16,LG3,Non-HKUST,3,9,55279,5221405589,124376568,5345782157
2020-07-16,LG3,Others(HKUST),8,25,5040,414869564,43761114,458630678
2020-07-16,LG3,RPG,91,221,483992,62409865492,3739882030,66149747522
2020-07-16,LG3,Staff,92,187,116660,28173711137,3678069805,31851780942
2020-07-16,LG3,TPG,17,40,35109,27119403963,1683671123,28803075086
2020-07-16,LG3,Total,262,783,1171984,413366661199,20138636651,433505297850
2020-07-16,LG3,UG,44,237,387363,243356355489,7457497233,250813852722
2020-07-16,LG4,Alumni,8,55,149730,35528941337,2429677202,37958618539
2020-07-16,LG4,Non-HKUST,1,1,0,4786541,1862365,6648906
2020-07-16,LG4,Others(HKUST),7,22,172966,36532887440,5653090037,42185977477
2020-07-16,LG4,RPG,73,166,353351,34312851949,2529194694,36842046643
2020-07-16,LG4,Staff,74,145,69993,15905215397,1105205626,17010421023
2020-07-16,LG4,TPG,9,75,234450,69138981272,6619873941,75758855213
2020-07-16,LG4,Total,221,735,1627577,324859083535,50190775247,375049858782
2020-07-16,LG4,UG,49,271,647087,133435419599,31851871382,165287290981
2020-07-17,1,Alumni,2,3,5749,1061743152,76365898,1138109050
2020-07-17,1,Non-HKUST,0,0,0,0,0,0
2020-07-17,1,Others(HKUST),5,32,261233,5945889361,327295498,6273184859
2020-07-17,1,RPG,17,74,276179,12527212701,2285964745,14813177446
2020-07-17,1,Staff,51,406,1212218,38553052492,2604961249,41158013741
2020-07-17,1,TPG,2,39,114993,12533710059,1268274975,13801985034
2020-07-17,1,Total,88,673,2142259,99656437272,8335375393,107991812665
2020-07-17,1,UG,11,119,271887,29034829507,1772513028,30807342535
2020-07-17,All-Floors,Alumni,25,314,710201,102737176317,20473820147,123210996464
2020-07-17,All-Floors,Non-HKUST,7,41,100292,4491866727,473965301,4965832028
2020-07-17,All-Floors,Others(HKUST),16,122,1733435,114699830797,15064499256,129764330053
2020-07-17,All-Floors,RPG,207,1066,2148057,297659066869,39876774013,337535840882
2020-07-17,All-Floors,Staff,212,1612,2660645,165689974988,23335411777,189025386765
2020-07-17,All-Floors,TPG,51,549,1415456,194163874024,17653315834,211817189858
2020-07-17,All-Floors,Total,678,5413,11960486,1533079723873,179696039928,1712775763801
2020-07-17,All-Floors,UG,160,1709,3192400,653637934151,62818253600,716456187751
2020-07-17,G,Alumni,17,79,170486,17142916517,6642511660,23785428177
2020-07-17,G,Non-HKUST,4,10,8462,1622194161,201955291,1824149452
2020-07-17,G,Others(HKUST),7,24,378549,4292561261,473029715,4765590976
2020-07-17,G,RPG,81,289,331051,63840577140,10403380100,74243957240
2020-07-17,G,Staff,103,674,1023618,53288009591,12174766046,65462775637
2020-07-17,G,TPG,42,146,270555,33571114973,4935251019,38506365992
2020-07-17,G,Total,363,1627,2760986,290203097801,46860587711,337063685512
2020-07-17,G,UG,109,405,578265,116445724158,12029693880,128475418038
2020-07-17,LG1,Alumni,10,102,200317,30854492021,4090710195,34945202216
2020-07-17,LG1,Non-HKUST,1,1,13305,988001675,160066447,1148068122
2020-07-17,LG1,Others(HKUST),6,24,897484,28732843425,4213674452,32946517877
2020-07-17,LG1,RPG,49,418,1008880,127885565652,20187798324,148073363976
2020-07-17,LG1,Staff,56,231,251672,35827867367,3867738859,39695606226
2020-07-17,LG1,TPG,31,254,762317,79097010574,8325976811,87422987385
2020-07-17,LG1,Total,233,1768,4747685,500613463740,63361796201,563975259941
2020-07-17,LG1,UG,80,738,1613710,197227683026,22515831113,219743514139
2020-07-17,LG3,Alumni,8,61,113533,34756372807,4873935781,39630308588
2020-07-17,LG3,Non-HKUST,1,5,45198,1222544201,65350697,1287894898
2020-07-17,LG3,Others(HKUST),7,26,32223,24812086325,2380446927,27192533252
2020-07-17,LG3,RPG,76,179,439421,79799789959,5871655076,85671445035
2020-07-17,LG3,Staff,69,134,97371,30479598581,3723053955,34202652536
2020-07-17,LG3,TPG,12,39,64249,23973528071,1180941524,25154469595
2020-07-17,LG3,Total,218,613,1121554,300413680539,24832672159,325246352698
2020-07-17,LG3,UG,45,169,329559,105369760595,6737288199,112107048794
2020-07-17,LG4,Alumni,9,69,220116,18921651820,4790296613,23711948433
2020-07-17,LG4,Non-HKUST,4,25,33327,659126690,46592866,705719556
2020-07-17,LG4,Others(HKUST),6,16,163946,50916450425,7670052664,58586503089
2020-07-17,LG4,RPG,71,106,92526,13605921417,1127975768,14733897185
2020-07-17,LG4,Staff,65,167,75766,7541446957,964891668,8506338625
2020-07-17,LG4,TPG,9,71,203342,44988510347,1942871505,46931381852
2020-07-17,LG4,Total,212,732,1188002,342193044521,36305608464,378498652985
2020-07-17,LG4,UG,48,278,398979,205559936865,19762927380,225322864245
2020-07-18,1,Alumni,4,16,26277,7589908480,720489262,8310397742
2020-07-18,1,Non-HKUST,0,0,0,0,0,0
2020-07-18,1,Others(HKUST),1,2,172798,31656864,13238560,44895424
2020-07-18,1,RPG,13,69,254753,17460794275,1390163438,18850957713
2020-07-18,1,Staff,6,35,467269,5171349791,287729233,5459079024
2020-07-18,1,TPG,2,51,53467,58482293738,24771733385,83254027123
2020-07-18,1,Total,33,204,1120195,96783996422,27739594532,124523590954
2020-07-18,1,UG,7,31,145631,8047993274,556240654,8604233928
2020-07-18,All-Floors,Alumni,23,203,408463,65302925391,4480517039,69783442430
2020-07-18,All-Floors,Non-HKUST,4,21,81371,3365305658,348829946,3714135604
2020-07-18,All-Floors,Others(HKUST),7,52,1321167,50613718057,7877624419,58491342476
2020-07-18,All-Floors,RPG,151,717,1421042,195362579436,26521710975,221884290411
2020-07-18,All-Floors,Staff,62,457,1172512,19777812058781,18901507722610,38679319781391
2020-07-18,All-Floors,TPG,39,434,986478,163098084684,45857732612,208955817296
2020-07-18,All-Floors,Total,422,3311,8115249,20713819561010,19027878397902,39741697958912
2020-07-18,All-Floors,UG,136,1427,2724216,458264889003,41284260301,499549149304
2020-07-18,G,Alumni,14,47,77775,7761319866,378577979,8139897845
2020-07-18,G,Non-HKUST,2,6,28616,620735161,73193758,693928919
2020-07-18,G,Others(HKUST),4,10,263878,2901744182,343334571,3245078753
2020-07-18,G,RPG,53,174,170644,45582374516,2573211350,48155585866
2020-07-18,G,Staff,26,195,506535,60119607030,13389848847,73509455877
2020-07-18,G,TPG,28,124,186149,29102941832,6903205903,36006147735
2020-07-18,G,Total,219,965,1725591,237048368458,34522308562,271570677020
2020-07-18,G,UG,92,409,491994,90959645871,10860936154,101820582025
2020-07-18,LG1,Alumni,9,91,150138,25063031629,1145188742,26208220371
2020-07-18,LG1,Non-HKUST,3,7,35110,1979087576,211691900,2190779476
2020-07-18,LG1,Others(HKUST),1,11,710254,22990534787,3706902469,26697437256
2020-07-18,LG1,RPG,40,263,573364,59264375982,9973472940,69237848922
2020-07-18,LG1,Staff,9,14,8817,1903611990,115921762,2019533752
2020-07-18,LG1,TPG,18,183,567037,61223519162,7130048062,68353567224
2020-07-18,LG1,Total,166,1265,3714936,359494901992,43318649186,402813551178
2020-07-18,LG1,UG,86,696,1670216,187070740866,21035423311,208106164177
2020-07-18,LG3,Alumni,5,32,41225,13678887440,936406501,14615293941
2020-07-18,LG3,Non-HKUST,1,8,17645,765482921,63944288,829427209
2020-07-18,LG3,Others(HKUST),3,13,719,286031809,35968213,322000022
2020-07-18,LG3,RPG,61,138,295909,56903798342,9600227178,66504025520
2020-07-18,LG3,Staff,29,172,160553,19705035431314,18887397782520,38592433213834
2020-07-18,LG3,TPG,5,16,38340,2723347656,338870372,3062218028
2020-07-18,LG3,Total,139,509,801010,19876335596885,18903510737771,38779846334656
2020-07-18,LG3,UG,35,130,246619,96942617403,5137538699,102080156102
2020-07-18,LG4,Alumni,10,17,113048,11209777976,1299854555,12509632531
2020-07-18,LG4,Non-HKUST,0,0,0,0,0,0
2020-07-18,LG4,Others(HKUST),2,16,173518,24403750415,3778180606,28181931021
2020-07-18,LG4,RPG,41,73,126372,16151236321,2984636069,19135872390
2020-07-18,LG4,Staff,18,41,29338,5582058656,316440248,5898498904
2020-07-18,LG4,TPG,10,60,141485,11565982296,6713874890,18279857186
2020-07-18,LG4,Total,109,368,753517,144156697253,18787107851,162943805104
2020-07-18,LG4,UG,28,161,169756,75243891589,3694121483,78938013072
2020-07-19,1,Alumni,2,7,20702,3971235949,152044411,4123280360
2020-07-19,1,Non-HKUST,0,0,0,0,0,0
2020-07-19,1,Others(HKUST),2,12,185043,274838322,42411048,317249370
2020-07-19,1,RPG,7,34,150125,2146034583,311539179,2457573762
2020-07-19,1,Staff,5,25,424264,3490450416,193431677,3683882093
2020-07-19,1,TPG,3,9,19798,2647205946,89649873,2736855819
2020-07-19,1,Total,22,108,927742,21388004134,1683155226,23071159360
2020-07-19,1,UG,3,21,127810,8858238918,894079038,9752317956
2020-07-19,All-Floors,Alumni,18,188,284768,121826040048,9937694654,131763734702
2020-07-19,All-Floors,Non-HKUST,7,34,58143,14192700421,935702586,15128403007
2020-07-19,All-Floors,Others(HKUST),8,58,1574792,53502909992,8289631098,61792541090
2020-07-19,All-Floors,RPG,102,480,1022245,120807434916,14870257407,135677692323
2020-07-19,All-Floors,Staff,42,212,952576,61078920396,12221614488,73300534884
2020-07-19,All-Floors,TPG,32,265,714283,79804152111,11654950455,91459102566
2020-07-19,All-Floors,Total,288,1899,6003079,741946837756,86310259990,828257097746
2020-07-19,All-Floors,UG,79,662,1396272,290734679872,28400409302,319135089174
2020-07-19,G,Alumni,15,29,20876,9676710216,677184975,10353895191
2020-07-19,G,Non-HKUST,3,19,27359,11122799775,666485106,11789284881
2020-07-19,G,Others(HKUST),3,8,347027,4957310389,624895070,5582205459
2020-07-19,G,RPG,45,151,275410,61341797107,5508906253,66850703360
2020-07-19,G,Staff,15,113,476474,53286529922,11571265040,64857794962
2020-07-19,G,TPG,29,78,161661,22518322886,4756669363,27274992249
2020-07-19,G,Total,155,569,1562616,222740843142,30246651780,252987494922
2020-07-19,G,UG,45,171,253809,59837372847,6441245973,66278618820
2020-07-19,LG1,Alumni,6,76,98284,12459081239,879651265,13338732504
2020-07-19,LG1,Non-HKUST,3,4,6118,1189212907,53965999,1243178906
2020-07-19,LG1,Others(HKUST),1,11,863621,22850963133,3733366150,26584329283
2020-07-19,LG1,RPG,29,131,208632,24341529518,1666044198,26007573716
2020-07-19,LG1,Staff,8,21,5760,1121291477,77334788,1198626265
2020-07-19,LG1,TPG,16,133,426978,46680206812,6356515302,53036722114
2020-07-19,LG1,Total,94,683,2328335,202143831733,23901326875,226045158608
2020-07-19,LG1,UG,31,307,718942,93501546647,11134449173,104635995820
2020-07-19,LG3,Alumni,6,65,96666,92617550562,8158513212,100776063774
2020-07-19,LG3,Non-HKUST,3,7,24486,1612586059,148882204,1761468263
2020-07-19,LG3,Others(HKUST),5,16,5403,909626990,88591546,998218536
2020-07-19,LG3,RPG,44,100,269094,22261670329,4081678868,26343349197
2020-07-19,LG3,Staff,17,32,10799,2097758216,199034350,2296792566
2020-07-19,LG3,TPG,5,27,30600,3423424997,245241994,3668666991
2020-07-19,LG3,Total,111,318,606600,143390624132,14080899927,157471524059
2020-07-19,LG3,UG,31,71,169552,20468006979,1158957753,21626964732
2020-07-19,LG4,Alumni,5,11,48240,3101462082,70300791,3171762873
2020-07-19,LG4,Non-HKUST,1,4,180,268101680,66369277,334470957
2020-07-19,LG4,Others(HKUST),5,11,173698,24510171158,3800367284,28310538442
2020-07-19,LG4,RPG,29,64,118984,10716403379,3302088909,14018492288
2020-07-19,LG4,Staff,13,21,35279,1082890365,180548633,1263438998
2020-07-19,LG4,TPG,6,18,75246,4534991470,206873923,4741865393
2020-07-19,LG4,Total,78,221,577786,152283534615,16398226182,168681760797
2020-07-19,LG4,UG,19,92,126159,108069514481,8771677365,116841191846
2020-07-20,1,Alumni,0,0,0,0,0,0
2020-07-20,1,Non-HKUST,1,8,8448,5683202289,183879981,5867082270
2020-07-20,1,Others(HKUST),3,16,131787,10682823895,104268238,10787092133
2020-07-20,1,RPG,13,119,247557,12723587743,934729280,13658317023
2020-07-20,1,Staff,43,430,1111966,43084287357,5500826515,48585113872
2020-07-20,1,TPG,2,18,60141,2967312326,2419487226,5386799552
2020-07-20,1,Total,68,641,1632287,81512895216,9745237813,91258133029
2020-07-20,1,UG,6,50,72388,6371681606,602046573,6973728179
2020-07-20,All-Floors,Alumni,18,259,468106,67350144738,16011303805,83361448543
2020-07-20,All-Floors,Non-HKUST,13,77,153777,34013564379,1583517309,35597081688
2020-07-20,All-Floors,Others(HKUST),14,98,1186949,63264068947,7157119126,70421188073
2020-07-20,All-Floors,RPG,163,880,1533163,294848515326,37325099173,332173614499
2020-07-20,All-Floors,Staff,184,1594,2640148,208625272340,35115576204,243740848544
2020-07-20,All-Floors,TPG,43,470,901270,192973338747,34019823028,226993161775
2020-07-20,All-Floors,Total,559,4639,9202155,1227259630736,175775888228,1403035518964
2020-07-20,All-Floors,UG,124,1261,2318742,366184726259,44563449583,410748175842
2020-07-20,G,Alumni,14,91,134690,14185743667,4683924853,18869668520
2020-07-20,G,Non-HKUST,6,24,29884,11795379993,483856576,12279236569
2020-07-20,G,Others(HKUST),6,24,272735,3020910649,401228092,3422138741
2020-07-20,G,RPG,64,197,262885,45980633789,7104222673,53084856462
2020-07-20,G,Staff,102,618,1172174,91472410244,18015065021,109487475265
2020-07-20,G,TPG,36,116,177924,26087300874,3942856574,30030157448
2020-07-20,G,Total,310,1387,2493074,270297029870,50058722942,320355752812
2020-07-20,G,UG,82,317,442782,77754650654,15427569153,93182219807
2020-07-20,LG1,Alumni,7,79,154496,37036139824,8351324114,45387463938
2020-07-20,LG1,Non-HKUST,6,23,63032,13325893671,719347344,14045241015
2020-07-20,LG1,Others(HKUST),5,34,568225,13229103492,2151429101,15380532593
2020-07-20,LG1,RPG,50,285,548102,77475083426,19241629778,96716713204
2020-07-20,LG1,Staff,44,157,129098,14864322370,4559266276,19423588646
2020-07-20,LG1,TPG,24,262,479896,100283186794,25267098296,125550285090
2020-07-20,LG1,Total,201,1431,3127772,420120994584,76094621829,496215616413
2020-07-20,LG1,UG,65,591,1184923,163907265007,15804526920,179711791927
2020-07-20,LG3,Alumni,5,33,42473,6622840602,568244502,7191085104
2020-07-20,LG3,Non-HKUST,3,12,38365,853952562,53921668,907874230
2020-07-20,LG3,Others(HKUST),4,13,35280,11933165851,712245227,12645411078
2020-07-20,LG3,RPG,67,194,327699,102504762206,6747326668,109252088874
2020-07-20,LG3,Staff,79,183,63926,34061552773,3124306278,37185859051
2020-07-20,LG3,TPG,10,25,23039,16734681778,481692346,17216374124
2020-07-20,LG3,Total,197,595,834212,223606280872,15502827046,239109107918
2020-07-20,LG3,UG,29,135,303430,50895325100,3815090357,54710415457
2020-07-20,LG4,Alumni,5,56,136447,9505420645,2407810336,11913230981
2020-07-20,LG4,Non-HKUST,4,10,14048,2355135864,142511740,2497647604
2020-07-20,LG4,Others(HKUST),4,11,178922,24398065060,3787948468,28186013528
2020-07-20,LG4,RPG,42,85,146920,56164448162,3297190774,59461638936
2020-07-20,LG4,Staff,47,206,162984,25142699596,3916112114,29058811710
2020-07-20,LG4,TPG,13,49,160270,46900856975,1908688586,48809545561
2020-07-20,LG4,Total,148,585,1114810,231722430194,24374478598,256096908792
2020-07-20,LG4,UG,33,168,315219,67255803892,8914216580,76170020472
2020-07-21,1,Alumni,0,0,0,0,0,0
2020-07-21,1,Non-HKUST,0,0,0,0,0,0
2020-07-21,1,Others(HKUST),3,31,194220,1175514713,147076180,1322590893
2020-07-21,1,RPG,0,0,0,0,0,0
2020-07-21,1,Staff,31,305,682644,40023340619,7149256599,47172597218
2020-07-21,1,TPG,0,0,0,0,0,0
2020-07-21,1,Total,37,400,932165,47898750487,7888419766,55787170253
2020-07-21,1,UG,3,64,55301,6699895155,592086987,7291982142
2020-07-21,All-Floors,Alumni,4,5,181,1158437182,38994334,1197431516
2020-07-21,All-Floors,Non-HKUST,3,3,899,104163646,3815329,107978975
2020-07-21,All-Floors,Others(HKUST),11,81,1377847,59198909458,8639337621,67838247079
2020-07-21,All-Floors,RPG,76,81,5757,2439675999,132327678,2572003677
2020-07-21,All-Floors,Staff,112,880,1361386,125300588769,27342372716,152642961485
2020-07-21,All-Floors,TPG,2,2,0,321331533,12096855,333428388
2020-07-21,All-Floors,Total,260,1236,2864011,232805189522,40914613951,273719803473
2020-07-21,All-Floors,UG,52,184,117941,44282082935,4745669418,49027752353
2020-07-21,G,Alumni,0,0,0,0,0,0
2020-07-21,G,Non-HKUST,1,1,718,485709,429485,915194
2020-07-21,G,Others(HKUST),5,10,146688,214376471,24593396,238969867
2020-07-21,G,RPG,2,4,0,5682513,892915,6575428
2020-07-21,G,Staff,37,283,636969,70791164529,18811768680,89602933209
2020-07-21,G,TPG,0,0,0,0,0,0
2020-07-21,G,Total,46,303,791939,71242650724,18857181282,90099832006
2020-07-21,G,UG,1,5,7564,230941502,19496806,250438308
2020-07-21,LG1,Alumni,0,0,0,0,0,0
2020-07-21,LG1,Non-HKUST,1,1,181,16636034,806026,17442060
2020-07-21,LG1,Others(HKUST),3,17,863420,27066171757,4417629029,31483800786
2020-07-21,LG1,RPG,5,5,1619,586886146,35039812,621925958
2020-07-21,LG1,Staff,28,64,14936,1362552001,385084878,1747636879
2020-07-21,LG1,TPG,0,0,0,0,0,0
2020-07-21,LG1,Total,45,98,885197,29196476336,4857112550,34053588886
2020-07-21,LG1,UG,8,11,5041,164230398,18552805,182783203
2020-07-21,LG3,Alumni,4,4,181,859968925,29628083,889597008
2020-07-21,LG3,Non-HKUST,0,0,0,0,0,0
2020-07-21,LG3,Others(HKUST),4,5,0,34301384,3291654,37593038
2020-07-21,LG3,RPG,47,49,3239,1198759600,53670348,1252429948
2020-07-21,LG3,Staff,71,141,6663,9929173273,553033271,10482206544
2020-07-21,LG3,TPG,1,1,0,304694212,5689825,310384037
2020-07-21,LG3,Total,161,248,27373,14310175623,781493876,15091669499
2020-07-21,LG3,UG,34,48,17290,1983278229,136180695,2119458924
2020-07-21,LG4,Alumni,1,1,0,298468257,9366251,307834508
2020-07-21,LG4,Non-HKUST,1,1,0,87041903,2579818,89621721
2020-07-21,LG4,Others(HKUST),4,18,173519,30708545133,4046747362,34755292495
2020-07-21,LG4,RPG,23,23,899,648347740,42724603,691072343
2020-07-21,LG4,Staff,27,87,20174,3194358347,443229288,3637587635
2020-07-21,LG4,TPG,1,1,0,16637321,6407030,23044351
2020-07-21,LG4,Total,70,187,227337,70157136352,8530406477,78687542829
2020-07-21,LG4,UG,13,56,32745,35203737651,3979352125,39183089776
2020-07-22,1,Alumni,0,0,0,0,0,0
2020-07-22,1,Non-HKUST,1,1,14043,1773581,467811,2241392
2020-07-22,1,Others(HKUST),2,16,192428,1619412980,190066073,1809479053
2020-07-22,1,RPG,0,0,0,0,0,0
2020-07-22,1,Staff,22,180,728540,25598743761,15928232532,41526976293
2020-07-22,1,TPG,0,0,0,0,0,0
2020-07-22,1,Total,28,237,987595,42888471973,16971200278,59859672251
2020-07-22,1,UG,3,40,52584,15668541651,852433862,16520975513
2020-07-22,All-Floors,Alumni,6,9,3063,5287188714,96325503,5383514217
2020-07-22,All-Floors,Non-HKUST,6,9,14403,304681841,27741313,332423154
2020-07-22,All-Floors,Others(HKUST),7,39,1315795,34218572108,5441152984,39659725092
2020-07-22,All-Floors,RPG,84,99,4679,4149931627,405903289,4555834916
2020-07-22,All-Floors,Staff,122,698,1466767,102637532912,50632552515,153270085427
2020-07-22,All-Floors,TPG,3,3,179,16813486,4417032,21230518
2020-07-22,All-Floors,Total,271,987,2892218,185025021544,59639197965,244664219509
2020-07-22,All-Floors,UG,43,130,87332,38410300856,3031105329,41441406185
2020-07-22,G,Alumni,1,4,2162,5103584157,80353366,5183937523
2020-07-22,G,Non-HKUST,0,0,0,0,0,0
2020-07-22,G,Others(HKUST),1,2,172798,65609988,20358442,85968430
2020-07-22,G,RPG,6,7,0,431739134,90881890,522621024
2020-07-22,G,Staff,36,198,627107,43445571695,15330424149,58775995844
2020-07-22,G,TPG,0,0,0,0,0,0
2020-07-22,G,Total,52,220,806210,49448300402,15551060050,64999360452
2020-07-22,G,UG,8,9,4143,401795428,29042203,430837631
2020-07-22,LG1,Alumni,1,1,0,11809431,2064720,13874151
2020-07-22,LG1,Non-HKUST,1,1,0,23351,16708,40059
2020-07-22,LG1,Others(HKUST),2,11,863990,20292037482,3317222656,23609260138
2020-07-22,LG1,RPG,10,11,1620,221045094,48712364,269757458
2020-07-22,LG1,Staff,21,69,61956,21905461316,12887946038,34793407354
2020-07-22,LG1,TPG,1,1,179,640632,2978773,3619405
2020-07-22,LG1,Total,43,104,930623,43784446664,16933880025,60718326689
2020-07-22,LG1,UG,7,10,2878,1353429358,674938766,2028368124
2020-07-22,LG3,Alumni,2,2,0,116974430,7926316,124900746
2020-07-22,LG3,Non-HKUST,5,6,360,302884909,27256794,330141703
2020-07-22,LG3,Others(HKUST),3,5,180,45175246,15208287,60383533
2020-07-22,LG3,RPG,43,48,3059,3127186006,239172454,3366358460
2020-07-22,LG3,Staff,75,161,29908,9319116488,4080817777,13399934265
2020-07-22,LG3,TPG,2,2,0,16172854,1438259,17611113
2020-07-22,LG3,Total,145,242,33507,16325861986,4514933860,20840795846
2020-07-22,LG3,UG,15,18,0,3398352053,143113973,3541466026
2020-07-22,LG4,Alumni,2,2,901,54820696,5981101,60801797
2020-07-22,LG4,Non-HKUST,1,1,0,0,0,0
2020-07-22,LG4,Others(HKUST),2,5,86399,12196336412,1898297526,14094633938
2020-07-22,LG4,RPG,33,33,0,369961393,27136581,397097974
2020-07-22,LG4,Staff,35,90,19256,2368639652,2405132019,4773771671
2020-07-22,LG4,TPG,0,0,0,0,0,0
2020-07-22,LG4,Total,87,184,134283,32577940519,5668123752,38246064271
2020-07-22,LG4,UG,14,53,27727,17588182366,1331576525,18919758891
2020-07-23,1,Alumni,0,0,0,0,0,0
2020-07-23,1,Non-HKUST,0,0,0,0,0,0
2020-07-23,1,Others(HKUST),1,2,172798,109472270,52247880,161720150
2020-07-23,1,RPG,2,2,0,11548920,2667904,14216824
2020-07-23,1,Staff,26,244,1057971,13819951930,3668671232,17488623162
2020-07-23,1,TPG,0,0,0,0,0,0
2020-07-23,1,Total,32,266,1255619,16095484485,3876337432,19971821917
2020-07-23,1,UG,3,18,24850,2154511365,152750416,2307261781
2020-07-23,All-Floors,Alumni,6,7,8096,2021071120,145033808,2166104928
2020-07-23,All-Floors,Non-HKUST,4,4,0,112479032,5097413,117576445
2020-07-23,All-Floors,Others(HKUST),8,31,1325464,57537003111,9115671368,66652674479
2020-07-23,All-Floors,RPG,81,92,7913,1535207566,233380651,1768588217
2020-07-23,All-Floors,Staff,110,913,2036833,121655028220,27004651949,148659680169
2020-07-23,All-Floors,TPG,7,7,720,335593797,14579071,350172868
2020-07-23,All-Floors,Total,256,1177,3439841,199767952771,37408748714,237176701485
2020-07-23,All-Floors,UG,40,123,60815,16571569925,890334454,17461904379
2020-07-23,G,Alumni,0,0,0,0,0,0
2020-07-23,G,Non-HKUST,1,1,0,13765,30300,44065
2020-07-23,G,Others(HKUST),1,3,114086,4682289,3887171,8569460
2020-07-23,G,RPG,4,4,539,30166813,2764260,32931073
2020-07-23,G,Staff,33,285,718893,74884825424,17667810456,92552635880
2020-07-23,G,TPG,0,0,0,0,0,0
2020-07-23,G,Total,42,298,835675,75724435499,17730214138,93454649637
2020-07-23,G,UG,3,5,2157,804747208,55721951,860469159
2020-07-23,LG1,Alumni,0,0,0,0,0,0
2020-07-23,LG1,Non-HKUST,0,0,0,0,0,0
2020-07-23,LG1,Others(HKUST),3,12,863990,20581813235,3346815968,23928629203
2020-07-23,LG1,RPG,5,5,897,84307527,7330555,91638082
2020-07-23,LG1,Staff,25,81,129475,3144286015,522913918,3667199933
2020-07-23,LG1,TPG,1,1,720,13247219,1774348,15021567
2020-07-23,LG1,Total,42,108,997241,23873884161,3884643969,27758528130
2020-07-23,LG1,UG,8,9,2159,50230165,5809180,56039345
2020-07-23,LG3,Alumni,4,5,8096,1462478074,124664488,1587142562
2020-07-23,LG3,Non-HKUST,1,1,0,0,0,0
2020-07-23,LG3,Others(HKUST),3,7,1801,138279874,8389542,146669416
2020-07-23,LG3,RPG,55,59,4318,1045129357,97090884,1142220241
2020-07-23,LG3,Staff,73,206,72166,23983321185,3549754468,27533075653
2020-07-23,LG3,TPG,4,4,0,319104124,9950103,329054227
2020-07-23,LG3,Total,163,309,90342,28934769904,3910745518,32845515422
2020-07-23,LG3,UG,23,27,3961,1986457290,120896033,2107353323
2020-07-23,LG4,Alumni,2,2,0,558593046,20369320,578962366
2020-07-23,LG4,Non-HKUST,2,2,0,112465267,5067113,117532380
2020-07-23,LG4,Others(HKUST),2,7,172789,36702755443,5704330807,42407086250
2020-07-23,LG4,RPG,22,22,2159,364054949,123527048,487581997
2020-07-23,LG4,Staff,25,97,58328,5822643666,1595501875,7418145541
2020-07-23,LG4,TPG,2,2,0,3242454,2854620,6097074
2020-07-23,LG4,Total,67,196,260964,55139378722,8006807657,63146186379
2020-07-23,LG4,UG,12,64,27688,11575623897,555156874,12130780771
2020-07-24,1,Alumni,0,0,0,0,0,0
2020-07-24,1,Non-HKUST,0,0,0,0,0,0
2020-07-24,1,Others(HKUST),3,4,172978,212924798,59071283,271996081
2020-07-24,1,RPG,1,1,0,14358531,824922,15183453
2020-07-24,1,Staff,23,251,963460,35921773036,4313500731,40235273767
2020-07-24,1,TPG,0,0,0,0,0,0
2020-07-24,1,Total,28,257,1137158,36149061857,4373399424,40522461281
2020-07-24,1,UG,1,1,720,5492,2488,7980
2020-07-24,All-Floors,Alumni,2,4,0,278204154,9345483,287549637
2020-07-24,All-Floors,Non-HKUST,2,3,0,25983574,2933711,28917285
2020-07-24,All-Floors,Others(HKUST),10,38,1310037,42356229787,6759924904,49116154691
2020-07-24,All-Floors,RPG,75,86,12773,3010993851,437067789,3448061640
2020-07-24,All-Floors,Staff,99,810,1866039,178522758721,29541819222,208064577943
2020-07-24,All-Floors,TPG,8,8,0,430902436,22379851,453282287
2020-07-24,All-Floors,Total,233,1038,3215309,276985289858,38176022185,315161312043
2020-07-24,All-Floors,UG,37,89,26460,52360217335,1402551225,53762768560
2020-07-24,G,Alumni,0,0,0,0,0,0
2020-07-24,G,Non-HKUST,0,0,0,0,0,0
2020-07-24,G,Others(HKUST),3,11,185228,179388214,26100438,205488652
2020-07-24,G,RPG,3,3,0,166921702,6862712,173784414
2020-07-24,G,Staff,36,266,686999,68223741265,14399911019,82623652284
2020-07-24,G,TPG,0,0,0,0,0,0
2020-07-24,G,Total,44,282,872586,68586818654,14434157545,83020976199
2020-07-24,G,UG,2,2,359,16767473,1283376,18050849
2020-07-24,LG1,Alumni,0,0,0,0,0,0
2020-07-24,LG1,Non-HKUST,0,0,0,0,0,0
2020-07-24,LG1,Others(HKUST),2,12,777952,17506311016,2860009780,20366320796
2020-07-24,LG1,RPG,4,4,1438,190092562,5330248,195422810
2020-07-24,LG1,Staff,19,74,51862,39813910729,7692032849,47505943578
2020-07-24,LG1,TPG,0,0,0,0,0,0
2020-07-24,LG1,Total,33,99,833052,57540993323,10565488526,68106481849
2020-07-24,LG1,UG,8,9,1800,30679016,8115649,38794665
2020-07-24,LG3,Alumni,2,3,0,835972,209803,1045775
2020-07-24,LG3,Non-HKUST,2,2,0,25973422,2928576,28901998
2020-07-24,LG3,Others(HKUST),6,6,901,31672037,6481982,38154019
2020-07-24,LG3,RPG,51,59,11335,2488373505,401054738,2889428243
2020-07-24,LG3,Staff,59,128,52937,11482601359,1502556903,12985158262
2020-07-24,LG3,TPG,6,6,0,430582691,22160493,452743184
2020-07-24,LG3,Total,138,220,69493,15193947719,2103196289,17297144008
2020-07-24,LG3,UG,12,16,4320,733908733,167803794,901712527
2020-07-24,LG4,Alumni,1,1,0,277368182,9135680,286503862
2020-07-24,LG4,Non-HKUST,1,1,0,10152,5135,15287
2020-07-24,LG4,Others(HKUST),2,5,172978,24425933722,3808261421,28234195143
2020-07-24,LG4,RPG,19,19,0,151247551,22995169,174242720
2020-07-24,LG4,Staff,35,91,110781,23080732332,1633817720,24714550052
2020-07-24,LG4,TPG,2,2,0,319745,219358,539103
2020-07-24,LG4,Total,77,180,303020,99514468305,6699780401,106214248706
2020-07-24,LG4,UG,17,61,19261,51578856621,1225345918,52804202539
2020-07-25,1,Alumni,0,0,0,0,0,0
2020-07-25,1,Non-HKUST,0,0,0,0,0,0
2020-07-25,1,Others(HKUST),1,2,172798,120360076,59728372,180088448
2020-07-25,1,RPG,0,0,0,0,0,0
2020-07-25,1,Staff,7,32,440456,4410350129,306068883,4716419012
2020-07-25,1,TPG,0,0,0,0,0,0
2020-07-25,1,Total,9,35,613973,4530770669,365830817,4896601486
2020-07-25,1,UG,1,1,719,60464,33562,94026
2020-07-25,All-Floors,Alumni,2,2,0,26801238,4460208,31261446
2020-07-25,All-Floors,Non-HKUST,0,0,0,0,0,0
2020-07-25,All-Floors,Others(HKUST),6,23,1281209,56156897695,8586010947,64742908642
2020-07-25,All-Floors,RPG,75,86,6841,3043670654,386704771,3430375425
2020-07-25,All-Floors,Staff,30,98,794332,45191556637,11866756446,57058313083
2020-07-25,All-Floors,TPG,5,7,181,182624525,30351239,212975764
2020-07-25,All-Floors,Total,147,314,2118910,142254945600,22812937194,165067882794
2020-07-25,All-Floors,UG,29,98,36347,37653394851,1938653583,39592048434
2020-07-25,G,Alumni,0,0,0,0,0,0
2020-07-25,G,Non-HKUST,0,0,0,0,0,0
2020-07-25,G,Others(HKUST),1,2,172798,528682008,44623928,573305936
2020-07-25,G,RPG,3,3,0,9613272,2599206,12212478
2020-07-25,G,Staff,11,35,352615,40057681331,11522641518,51580322849
2020-07-25,G,TPG,1,1,0,26990300,21118122,48108422
2020-07-25,G,Total,23,61,527393,41592326116,11724494968,53316821084
2020-07-25,G,UG,7,20,1980,969359205,133512194,1102871399
2020-07-25,LG1,Alumni,0,0,0,0,0,0
2020-07-25,LG1,Non-HKUST,0,0,0,0,0,0
2020-07-25,LG1,Others(HKUST),1,11,762634,26931856714,4398851167,31330707881
2020-07-25,LG1,RPG,5,5,180,542478876,13942939,556421815
2020-07-25,LG1,Staff,6,6,721,4814617,642388,5457005
2020-07-25,LG1,TPG,0,0,0,0,0,0
2020-07-25,LG1,Total,15,25,766414,27509033655,4455618679,31964652334
2020-07-25,LG1,UG,3,3,2879,29883448,42182185,72065633
2020-07-25,LG3,Alumni,2,2,0,26801238,4460208,31261446
2020-07-25,LG3,Non-HKUST,0,0,0,0,0,0
2020-07-25,LG3,Others(HKUST),3,3,0,413247876,77405181,490653057
2020-07-25,LG3,RPG,51,52,3602,1698559697,110161513,1808721210
2020-07-25,LG3,Staff,13,17,540,521943624,27641803,549585427
2020-07-25,LG3,TPG,4,5,181,155595578,9220111,164815689
2020-07-25,LG3,Total,93,107,11698,4886754709,478894539,5365649248
2020-07-25,LG3,UG,20,28,7375,2070606696,250005723,2320612419
2020-07-25,LG4,Alumni,0,0,0,0,0,0
2020-07-25,LG4,Non-HKUST,0,0,0,0,0,0
2020-07-25,LG4,Others(HKUST),3,5,172979,28162751021,4005402299,32168153320
2020-07-25,LG4,RPG,25,26,3059,793018809,260001113,1053019922
2020-07-25,LG4,Staff,7,8,0,196766936,9761854,206528790
2020-07-25,LG4,TPG,1,1,0,38647,13006,51653
2020-07-25,LG4,Total,44,86,199432,63736060451,5788098191,69524158642
2020-07-25,LG4,UG,8,46,23394,34583485038,1512919919,36096404957
2020-07-26,1,Alumni,0,0,0,0,0,0
2020-07-26,1,Non-HKUST,0,0,0,0,0,0
2020-07-26,1,Others(HKUST),1,1,86399,66288731,31660090,97948821
2020-07-26,1,RPG,0,0,0,0,0,0
2020-07-26,1,Staff,6,38,341107,2431472951,209864434,2641337385
2020-07-26,1,TPG,0,0,0,0,0,0
2020-07-26,1,Total,7,39,427506,2497761682,241524524,2739286206
2020-07-26,1,UG,0,0,0,0,0,0
2020-07-26,All-Floors,Alumni,1,7,7198,3378252677,82686696,3460939373
2020-07-26,All-Floors,Non-HKUST,2,3,0,19816085,875266,20691351
2020-07-26,All-Floors,Others(HKUST),6,31,1151621,76065646233,7443850016,83509496249
2020-07-26,All-Floors,RPG,51,56,1801,1148231821,85867905,1234099726
2020-07-26,All-Floors,Staff,21,69,520028,24660821634,6118615432,30779437066
2020-07-26,All-Floors,TPG,3,3,720,323546972,48992941,372539913
2020-07-26,All-Floors,Total,116,242,1756243,145116324780,16519524939,161635849719
2020-07-26,All-Floors,UG,32,73,74875,39520009358,2738636683,42258646041
2020-07-26,G,Alumni,0,0,0,0,0,0
2020-07-26,G,Non-HKUST,0,0,0,0,0,0
2020-07-26,G,Others(HKUST),1,2,172798,588367492,57714242,646081734
2020-07-26,G,RPG,1,1,0,1825074,603001,2428075
2020-07-26,G,Staff,5,16,176939,21420981675,5870209767,27291191442
2020-07-26,G,TPG,0,0,0,0,0,0
2020-07-26,G,Total,7,19,349737,22011174241,5928527010,27939701251
2020-07-26,G,UG,0,0,0,0,0,0
2020-07-26,LG1,Alumni,0,0,0,0,0,0
2020-07-26,LG1,Non-HKUST,0,0,0,0,0,0
2020-07-26,LG1,Others(HKUST),1,9,690823,17067211042,2791214446,19858425488
2020-07-26,LG1,RPG,3,3,1441,136526,75813,212339
2020-07-26,LG1,Staff,5,5,1262,108845568,6484922,115330490
2020-07-26,LG1,TPG,1,1,720,318641208,47836781,366477989
2020-07-26,LG1,Total,16,24,695687,17754602832,2862234170,20616837002
2020-07-26,LG1,UG,6,6,1441,259768488,16622208,276390696
2020-07-26,LG3,Alumni,1,4,4139,2237160033,44329661,2281489694
2020-07-26,LG3,Non-HKUST,2,2,0,19715232,812452,20527684
2020-07-26,LG3,Others(HKUST),1,12,28443,33877758282,742342837,34620101119
2020-07-26,LG3,RPG,28,31,180,597394380,59314479,656708859
2020-07-26,LG3,Staff,6,7,0,684497752,28369570,712867322
2020-07-26,LG3,TPG,2,2,0,4905764,1156160,6061924
2020-07-26,LG3,Total,53,71,32762,39183779616,1994030388,41177810004
2020-07-26,LG3,UG,13,13,0,1762348173,1117705229,2880053402
2020-07-26,LG4,Alumni,1,3,3059,1141092644,38357035,1179449679
2020-07-26,LG4,Non-HKUST,1,1,0,100853,62814,163667
2020-07-26,LG4,Others(HKUST),3,7,173158,24466020686,3820918401,28286939087
2020-07-26,LG4,RPG,20,21,180,548875841,25874612,574750453
2020-07-26,LG4,Staff,3,3,720,15023688,3686739,18710427
2020-07-26,LG4,TPG,0,0,0,0,0,0
2020-07-26,LG4,Total,43,89,250551,63669006409,5493208847,69162215256
2020-07-26,LG4,UG,15,54,73434,37497892697,1604309246,39102201943
2020-07-27,1,Alumni,0,0,0,0,0,0
2020-07-27,1,Non-HKUST,0,0,0,0,0,0
2020-07-27,1,Others(HKUST),2,4,172609,208450665,99013108,307463773
2020-07-27,1,RPG,2,2,0,686939,359437,1046376
2020-07-27,1,Staff,29,264,757404,18059152061,1901341342,19960493403
2020-07-27,1,TPG,0,0,0,0,0,0
2020-07-27,1,Total,36,322,976829,37175432897,2705636786,39881069683
2020-07-27,1,UG,3,52,46816,18907143232,704922899,19612066131
2020-07-27,All-Floors,Alumni,3,5,7557,510943975,68569397,579513372
2020-07-27,All-Floors,Non-HKUST,5,5,1442,85753275,5049939,90803214
2020-07-27,All-Floors,Others(HKUST),7,91,1431528,54866823569,8788801284,63655624853
2020-07-27,All-Floors,RPG,89,101,13859,3231584186,154748915,3386333101
2020-07-27,All-Floors,Staff,114,976,1557177,116067932245,24109078303,140177010548
2020-07-27,All-Floors,TPG,3,4,180,31538562,12949062,44487624
2020-07-27,All-Floors,Total,270,1424,3200218,250996659419,37069136600,288065796019
2020-07-27,All-Floors,UG,49,242,188475,76202083607,3929939700,80132023307
2020-07-27,G,Alumni,0,0,0,0,0,0
2020-07-27,G,Non-HKUST,1,1,722,1023662,156804,1180466
2020-07-27,G,Others(HKUST),4,14,190625,1400894214,165842226,1566736440
2020-07-27,G,RPG,5,5,0,243334088,26671595,270005683
2020-07-27,G,Staff,41,236,718736,73776213243,20363732254,94139945497
2020-07-27,G,TPG,1,1,0,7864666,1097820,8962486
2020-07-27,G,Total,57,274,918728,84498595861,20913257738,105411853599
2020-07-27,G,UG,5,17,8645,9069265988,355757039,9425023027
2020-07-27,LG1,Alumni,0,0,0,0,0,0
2020-07-27,LG1,Non-HKUST,1,1,720,38754697,741957,39496654
2020-07-27,LG1,Others(HKUST),3,20,866677,25574726559,4179423966,29754150525
2020-07-27,LG1,RPG,4,4,1439,25023491,1529874,26553365
2020-07-27,LG1,Staff,26,121,39984,5444205764,556666954,6000872718
2020-07-27,LG1,TPG,0,0,0,0,0,0
2020-07-27,LG1,Total,39,182,929527,36222341910,5041279586,41263621496
2020-07-27,LG1,UG,5,36,20707,5139631399,302916835,5442548234
2020-07-27,LG3,Alumni,2,4,7557,435504910,50378617,485883527
2020-07-27,LG3,Non-HKUST,3,3,0,45974916,4151178,50126094
2020-07-27,LG3,Others(HKUST),3,34,23420,2859581221,396853548,3256434769
2020-07-27,LG3,RPG,44,50,6301,1163944302,55347962,1219292264
2020-07-27,LG3,Staff,76,250,27731,11575776793,901285237,12477062030
2020-07-27,LG3,TPG,1,2,180,83580,48269,131849
2020-07-27,LG3,Total,154,393,125828,29575016637,2317011129,31892027766
2020-07-27,LG3,UG,25,50,60639,13494150915,908946318,14403097233
2020-07-27,LG4,Alumni,1,1,0,75439065,18190780,93629845
2020-07-27,LG4,Non-HKUST,0,0,0,0,0,0
2020-07-27,LG4,Others(HKUST),4,19,178197,24823170910,3947668436,28770839346
2020-07-27,LG4,RPG,40,40,6119,1798595366,70840047,1869435413
2020-07-27,LG4,Staff,35,105,13322,7212584384,386052516,7598636900
2020-07-27,LG4,TPG,1,1,0,23590316,11802973,35393289
2020-07-27,LG4,Total,103,253,249306,63525272114,6091951361,69617223475
2020-07-27,LG4,UG,22,87,51668,29591892073,1657396609,31249288682
2020-07-28,1,Alumni,0,0,0,0,0,0
2020-07-28,1,Non-HKUST,1,5,24496,191011825,349382318,540394143
2020-07-28,1,Others(HKUST),2,37,109848,1346299480,279660511,1625959991
2020-07-28,1,RPG,1,1,719,28598,30461,59059
2020-07-28,1,Staff,28,332,754101,24776578306,3676205844,28452784150
2020-07-28,1,TPG,1,1,360,758908957,25399068,784308025
2020-07-28,1,Total,35,411,935627,29362708092,4499733117,33862441209
2020-07-28,1,UG,2,35,46103,2289880926,169054915,2458935841
2020-07-28,All-Floors,Alumni,1,1,0,12182,5856,18038
2020-07-28,All-Floors,Non-HKUST,10,25,58889,764233055,404003811,1168236866
2020-07-28,All-Floors,Others(HKUST),11,187,1250013,70899174341,11990739908,82889914249
2020-07-28,All-Floors,RPG,82,99,11520,5031845415,220215319,5252060734
2020-07-28,All-Floors,Staff,111,1127,1863615,138937615773,69487843528,208425459301
2020-07-28,All-Floors,TPG,9,12,902,871924758,54798770,926723528
2020-07-28,All-Floors,Total,270,1663,3565835,242405409997,84676957235,327082367232
2020-07-28,All-Floors,UG,46,212,380896,25900604473,2519350043,28419954516
2020-07-28,G,Alumni,0,0,0,0,0,0
2020-07-28,G,Non-HKUST,3,5,0,35920342,7440543,43360885
2020-07-28,G,Others(HKUST),6,8,86940,525681227,52149675,577830902
2020-07-28,G,RPG,7,9,540,101768858,4580646,106349504
2020-07-28,G,Staff,39,318,750619,71110784161,55416082264,126526866425
2020-07-28,G,TPG,0,0,0,0,0,0
2020-07-28,G,Total,64,359,838099,73095683382,55560422240,128656105622
2020-07-28,G,UG,9,19,0,1321528794,80169112,1401697906
2020-07-28,LG1,Alumni,0,0,0,0,0,0
2020-07-28,LG1,Non-HKUST,2,7,34393,47823013,26872025,74695038
2020-07-28,LG1,Others(HKUST),5,51,935478,37881495624,6496466470,44377962094
2020-07-28,LG1,RPG,3,3,720,15216396,500993,15717389
2020-07-28,LG1,Staff,20,239,267794,33606162430,4918845141,38525007571
2020-07-28,LG1,TPG,1,1,0,0,0,0
2020-07-28,LG1,Total,44,391,1551568,86310544239,13156893147,99467437386
2020-07-28,LG1,UG,13,90,313183,14759846776,1714208518,16474055294
2020-07-28,LG3,Alumni,1,1,0,12182,5856,18038
2020-07-28,LG3,Non-HKUST,5,6,0,211768716,14473575,226242291
2020-07-28,LG3,Others(HKUST),5,70,19813,16181962457,2650240377,18832202834
2020-07-28,LG3,RPG,49,56,6483,3835613217,153675861,3989289078
2020-07-28,LG3,Staff,70,131,8466,4299740471,4647655798,8947396269
2020-07-28,LG3,TPG,5,7,362,41715354,7813496,49528850
2020-07-28,LG3,Total,156,303,39283,26490051192,7738051977,34228103169
2020-07-28,LG3,UG,21,32,4159,1919238795,264187014,2183425809
2020-07-28,LG4,Alumni,0,0,0,0,0,0
2020-07-28,LG4,Non-HKUST,2,2,0,277709159,5835350,283544509
2020-07-28,LG4,Others(HKUST),6,21,97934,14963735553,2512222875,17475958428
2020-07-28,LG4,RPG,29,30,3058,1079218346,61427358,1140645704
2020-07-28,LG4,Staff,33,107,82635,5144350405,829054481,5973404886
2020-07-28,LG4,TPG,3,3,180,71300447,21586206,92886653
2020-07-28,LG4,Total,84,199,201258,27146423092,3721856754,30868279846
2020-07-28,LG4,UG,11,36,17451,5610109182,291730484,5901839666
2020-07-29,1,Alumni,0,0,0,0,0,0
2020-07-29,1,Non-HKUST,1,4,24313,38517906,3386419,41904325
2020-07-29,1,Others(HKUST),3,29,36012,2984177642,98258776,3082436418
2020-07-29,1,RPG,0,0,0,0,0,0
2020-07-29,1,Staff,35,300,926944,29640751608,2663410228,32304161836
2020-07-29,1,TPG,0,0,0,0,0,0
2020-07-29,1,Total,42,373,1037149,37258263911,3063370726,40321634637
2020-07-29,1,UG,3,40,49880,4594816755,298315303,4893132058
2020-07-29,All-Floors,Alumni,1,1,0,55638,17063,72701
2020-07-29,All-Floors,Non-HKUST,5,10,25214,67350548,6187634,73538182
2020-07-29,All-Floors,Others(HKUST),7,99,1208698,67279122894,9984023705,77263146599
2020-07-29,All-Floors,RPG,83,107,17464,2384850045,302476473,2687326518
2020-07-29,All-Floors,Staff,130,1005,1738198,144874790774,20216802252,165091593026
2020-07-29,All-Floors,TPG,4,4,1982,2817114,5162793,7979907
2020-07-29,All-Floors,Total,294,1462,3111105,281706041008,33991366980,315697407988
2020-07-29,All-Floors,UG,64,236,119549,67097053995,3476697060,70573751055
2020-07-29,G,Alumni,0,0,0,0,0,0
2020-07-29,G,Non-HKUST,1,2,0,28224738,2471245,30695983
2020-07-29,G,Others(HKUST),4,14,99524,1989993772,220894615,2210888387
2020-07-29,G,RPG,3,4,180,72045439,34775719,106821158
2020-07-29,G,Staff,38,356,727892,67493654187,14749751922,82243406109
2020-07-29,G,TPG,0,0,0,0,0,0
2020-07-29,G,Total,53,404,837321,80921800040,15547715086,96469515126
2020-07-29,G,UG,7,28,9725,11337881904,539821585,11877703489
2020-07-29,LG1,Alumni,0,0,0,0,0,0
2020-07-29,LG1,Non-HKUST,0,0,0,0,0,0
2020-07-29,LG1,Others(HKUST),2,13,864529,21567132667,3513409116,25080541783
2020-07-29,LG1,RPG,3,3,900,700323,364844,1065167
2020-07-29,LG1,Staff,15,55,20884,25813889944,528134428,26342024372
2020-07-29,LG1,TPG,1,1,900,67620,47441,115061
2020-07-29,LG1,Total,32,139,917282,79135227527,5736881144,84872108671
2020-07-29,LG1,UG,11,67,30069,31753436973,1694925315,33448362288
2020-07-29,LG3,Alumni,1,1,0,55638,17063,72701
2020-07-29,LG3,Non-HKUST,1,1,0,299037,129715,428752
2020-07-29,LG3,Others(HKUST),4,35,36023,3729777803,376949972,4106727775
2020-07-29,LG3,RPG,53,62,10440,1385649371,180265624,1565914995
2020-07-29,LG3,Staff,78,187,24481,17338086222,1823922226,19162008448
2020-07-29,LG3,TPG,3,3,1082,2749494,5115352,7864846
2020-07-29,LG3,Total,173,337,79222,30229015036,2834482885,33063497921
2020-07-29,LG3,UG,33,48,7196,7772397471,448082933,8220480404
2020-07-29,LG4,Alumni,0,0,0,0,0,0
2020-07-29,LG4,Non-HKUST,3,3,901,308867,200255,509122
2020-07-29,LG4,Others(HKUST),3,8,172610,37008041010,5774511226,42782552236
2020-07-29,LG4,RPG,31,38,5944,926454912,87070286,1013525198
2020-07-29,LG4,Staff,42,107,37997,4588408813,451583448,5039992261
2020-07-29,LG4,TPG,0,0,0,0,0,0
2020-07-29,LG4,Total,103,209,240131,54161734494,6808917139,60970651633
2020-07-29,LG4,UG,24,53,22679,11638520892,495551924,12134072816
2020-07-30,1,Alumni,0,0,0,0,0,0
2020-07-30,1,Non-HKUST,1,2,1980,42748876,1912689,44661565
2020-07-30,1,Others(HKUST),3,23,69787,100830194,19394835,120225029
2020-07-30,1,RPG,2,2,0,59929739,2097402,62027141
2020-07-30,1,Staff,30,278,704838,26597537092,29440980760,56038517852
2020-07-30,1,TPG,0,0,0,0,0,0
2020-07-30,1,Total,37,317,805777,41071402885,30138124819,71209527704
2020-07-30,1,UG,1,12,29172,14270356984,673739133,14944096117
2020-07-30,All-Floors,Alumni,4,5,1261,4849163721,188940558,5038104279
2020-07-30,All-Floors,Non-HKUST,4,7,2160,43161909,2118004,45279913
2020-07-30,All-Floors,Others(HKUST),11,105,1180138,40609333766,6455438647,47064772413
2020-07-30,All-Floors,RPG,82,100,26440,2895962477,207221297,3103183774
2020-07-30,All-Floors,Staff,121,941,1682170,131750857670,60242945129,191993802799
2020-07-30,All-Floors,TPG,4,15,4682,252679695,58038600,310718295
2020-07-30,All-Floors,Total,258,1321,2981083,209360468929,68738445450,278098914379
2020-07-30,All-Floors,UG,32,148,84232,28959309691,1583743215,30543052906
2020-07-30,G,Alumni,0,0,0,0,0,0
2020-07-30,G,Non-HKUST,0,0,0,0,0,0
2020-07-30,G,Others(HKUST),5,13,234839,110070151,24948510,135018661
2020-07-30,G,RPG,1,1,0,425857,158030,583887
2020-07-30,G,Staff,40,236,753686,57545988999,19173760532,76719749531
2020-07-30,G,TPG,0,0,0,0,0,0
2020-07-30,G,Total,53,263,988885,60981363208,19375388239,80356751447
2020-07-30,G,UG,7,13,360,3324878201,176521167,3501399368
2020-07-30,LG1,Alumni,0,0,0,0,0,0
2020-07-30,LG1,Non-HKUST,0,0,0,0,0,0
2020-07-30,LG1,Others(HKUST),5,37,698395,15489766224,2544261160,18034027384
2020-07-30,LG1,RPG,4,4,360,15231543,2349339,17580882
2020-07-30,LG1,Staff,29,129,109669,18398563507,8361857569,26760421076
2020-07-30,LG1,TPG,0,0,0,0,0,0
2020-07-30,LG1,Total,42,221,828398,36038977435,11144636330,47183613765
2020-07-30,LG1,UG,4,51,19974,2135416161,236168262,2371584423
2020-07-30,LG3,Alumni,3,3,1261,4724079022,160639468,4884718490
2020-07-30,LG3,Non-HKUST,2,2,0,75792,36189,111981
2020-07-30,LG3,Others(HKUST),6,17,3600,215274731,13678716,228953447
2020-07-30,LG3,RPG,61,72,19966,2504892068,151371166,2656263234
2020-07-30,LG3,Staff,69,163,52389,8113439987,2143771707,10257211694
2020-07-30,LG3,TPG,4,11,3241,152981485,40297630,193279115
2020-07-30,LG3,Total,159,282,83876,18710455309,2622550705,21333006014
2020-07-30,LG3,UG,14,14,3419,2999712224,112755829,3112468053
2020-07-30,LG4,Alumni,2,2,0,125084699,28301090,153385789
2020-07-30,LG4,Non-HKUST,2,3,180,337241,169126,506367
2020-07-30,LG4,Others(HKUST),5,15,173517,24693392466,3853155426,28546547892
2020-07-30,LG4,RPG,21,21,6114,315483270,51245360,366728630
2020-07-30,LG4,Staff,39,135,61588,21095328085,1122574561,22217902646
2020-07-30,LG4,TPG,2,4,1441,99698210,17740970,117439180
2020-07-30,LG4,Total,85,238,274147,52558270092,5457745357,58016015449
2020-07-30,LG4,UG,14,58,31307,6228946121,384558824,6613504945
2020-07-31,1,Alumni,0,0,0,0,0,0
2020-07-31,1,Non-HKUST,0,0,0,0,0,0
2020-07-31,1,Others(HKUST),2,5,157147,18440833,7021444,25462277
2020-07-31,1,RPG,1,1,719,66357,48565,114922
2020-07-31,1,Staff,25,308,841713,29848177445,3405726263,33253903708
2020-07-31,1,TPG,0,0,0,0,0,0
2020-07-31,1,Total,29,321,1027673,33713365369,3601960542,37315325911
2020-07-31,1,UG,1,7,28094,3846680734,189164270,4035845004
2020-07-31,All-Floors,Alumni,0,0,0,0,0,0
2020-07-31,All-Floors,Non-HKUST,6,6,720,347394623,58361306,405755929
2020-07-31,All-Floors,Others(HKUST),8,52,1546357,53599608405,8540413489,62140021894
2020-07-31,All-Floors,RPG,105,123,16907,4132652714,497444060,4630096774
2020-07-31,All-Floors,Staff,105,811,1474490,119030037293,22463290822,141493328115
2020-07-31,All-Floors,TPG,11,19,49294,1797574389,1164939366,2962513755
2020-07-31,All-Floors,Total,289,1178,3222608,217874430733,34595687347,252470118080
2020-07-31,All-Floors,UG,54,167,134840,38967163309,1871238304,40838401613
2020-07-31,G,Alumni,0,0,0,0,0,0
2020-07-31,G,Non-HKUST,1,1,0,779282,4462924,5242206
2020-07-31,G,Others(HKUST),3,8,351719,185855879,40031754,225887633
2020-07-31,G,RPG,6,6,720,370030836,14820950,384851786
2020-07-31,G,Staff,33,169,524415,56309521973,14023324949,70332846922
2020-07-31,G,TPG,0,0,0,0,0,0
2020-07-31,G,Total,44,185,876854,56896852575,14083856892,70980709467
2020-07-31,G,UG,1,1,0,30664605,1216315,31880920
2020-07-31,LG1,Alumni,0,0,0,0,0,0
2020-07-31,LG1,Non-HKUST,0,0,0,0,0,0
2020-07-31,LG1,Others(HKUST),2,14,863795,28243086691,4617046534,32860133225
2020-07-31,LG1,RPG,4,4,900,543400,305459,848859
2020-07-31,LG1,Staff,17,81,39256,3884460985,1202429883,5086890868
2020-07-31,LG1,TPG,0,0,0,0,0,0
2020-07-31,LG1,Total,28,140,958506,46949256239,6621176250,53570432489
2020-07-31,LG1,UG,5,41,54555,14821165163,801394374,15622559537
2020-07-31,LG3,Alumni,0,0,0,0,0,0
2020-07-31,LG3,Non-HKUST,4,4,720,346565417,53867458,400432875
2020-07-31,LG3,Others(HKUST),4,10,0,74502054,3583074,78085128
2020-07-31,LG3,RPG,67,74,7556,3168977431,423210643,3592188074
2020-07-31,LG3,Staff,63,147,46245,12851130973,1749049377,14600180350
2020-07-31,LG3,TPG,8,13,46236,1327144366,633196682,1960341048
2020-07-31,LG3,Total,181,289,116233,21368501329,3052850052,24421351381
2020-07-31,LG3,UG,35,41,15476,3600181088,189942818,3790123906
2020-07-31,LG4,Alumni,0,0,0,0,0,0
2020-07-31,LG4,Non-HKUST,1,1,0,49924,30924,80848
2020-07-31,LG4,Others(HKUST),4,15,173696,25077722948,3872730683,28950453631
2020-07-31,LG4,RPG,37,38,7012,593034690,59058443,652093133
2020-07-31,LG4,Staff,41,106,22861,16136745917,2082760350,18219506267
2020-07-31,LG4,TPG,6,6,3058,470430023,531742684,1002172707
2020-07-31,LG4,Total,111,243,243342,58946455221,7235843611,66182298832
2020-07-31,LG4,UG,22,77,36715,16668471719,689520527,17357992246
