Date,Floor,User-Group,User-Count,WiFi-Conn,Duration-Sec,Traffic-In-Byte,Traffic-Out-Byte,Traffic-Both-Byte
2020-08-01,1,Alumni,0,0,0,0,0,0
2020-08-01,1,Non-HKUST,0,0,0,0,0,0
2020-08-01,1,Others(HKUST),1,2,172798,7595712,6107002,13702714
2020-08-01,1,RPG,0,0,0,0,0,0
2020-08-01,1,Staff,4,28,257039,1222379624,177952628,1400332252
2020-08-01,1,TPG,0,0,0,0,0,0
2020-08-01,1,Total,5,30,429837,1229975336,184059630,1414034966
2020-08-01,1,UG,0,0,0,0,0,0
2020-08-01,All-Floors,Alumni,2,2,0,28042026,2420091,30462117
2020-08-01,All-Floors,Non-HKUST,1,1,719,254963,165642,420605
2020-08-01,All-Floors,Others(HKUST),6,39,1399838,44666838711,6888791570,51555630281
2020-08-01,All-Floors,RPG,69,81,4317,3822955678,124243291,3947198969
2020-08-01,All-Floors,Staff,36,69,450545,25230619006,7205991425,32436610431
2020-08-01,All-Floors,TPG,5,8,6300,337994577,23777569,361772146
2020-08-01,All-Floors,Total,160,296,1947210,89903373547,17268685915,107172059462
2020-08-01,All-Floors,UG,41,96,85491,15816668586,3023296327,18839964913
2020-08-01,G,Alumni,0,0,0,0,0,0
2020-08-01,G,Non-HKUST,0,0,0,0,0,0
2020-08-01,G,Others(HKUST),2,4,345596,232378252,52638174,285016426
2020-08-01,G,RPG,2,2,0,6445157,1191985,7637142
2020-08-01,G,Staff,7,8,172798,23604148727,6477011550,30081160277
2020-08-01,G,TPG,0,0,0,0,0,0
2020-08-01,G,Total,15,18,518575,23969396736,6538319468,30507716204
2020-08-01,G,UG,4,4,181,126424600,7477759,133902359
2020-08-01,LG1,Alumni,0,0,0,0,0,0
2020-08-01,LG1,Non-HKUST,1,1,719,254963,165642,420605
2020-08-01,LG1,Others(HKUST),1,8,691192,17737058097,2901215627,20638273724
2020-08-01,LG1,RPG,0,0,0,0,0,0
2020-08-01,LG1,Staff,3,3,360,11606659,2524251,14130910
2020-08-01,LG1,TPG,0,0,0,0,0,0
2020-08-01,LG1,Total,7,14,692992,17775408521,2920483983,20695892504
2020-08-01,LG1,UG,2,2,721,26488802,16578463,43067265
2020-08-01,LG3,Alumni,0,0,0,0,0,0
2020-08-01,LG3,Non-HKUST,0,0,0,0,0,0
2020-08-01,LG3,Others(HKUST),3,18,16554,1791255107,61119255,1852374362
2020-08-01,LG3,RPG,46,51,3778,1780256403,63858655,1844115058
2020-08-01,LG3,Staff,17,21,19629,243475933,539334359,782810292
2020-08-01,LG3,TPG,4,5,4320,277410480,19917816,297328296
2020-08-01,LG3,Total,94,126,66958,7053894987,1462486350,8516381337
2020-08-01,LG3,UG,24,31,22677,2961497064,778256265,3739753329
2020-08-01,LG4,Alumni,2,2,0,28042026,2420091,30462117
2020-08-01,LG4,Non-HKUST,0,0,0,0,0,0
2020-08-01,LG4,Others(HKUST),4,7,173698,24898551543,3867711512,28766263055
2020-08-01,LG4,RPG,26,28,539,2036254118,59192651,2095446769
2020-08-01,LG4,Staff,9,9,719,149008063,9168637,158176700
2020-08-01,LG4,TPG,3,3,1980,60584097,3859753,64443850
2020-08-01,LG4,Total,64,108,238848,39874697967,6163336484,46038034451
2020-08-01,LG4,UG,20,59,61912,12702258120,2220983840,14923241960
2020-08-02,1,Alumni,0,0,0,0,0,0
2020-08-02,1,Non-HKUST,0,0,0,0,0,0
2020-08-02,1,Others(HKUST),1,2,172798,12374768,9659276,22034044
2020-08-02,1,RPG,1,1,720,5540,3475,9015
2020-08-02,1,Staff,2,22,163797,624801785,94820817,719622602
2020-08-02,1,TPG,0,0,0,0,0,0
2020-08-02,1,Total,4,25,337315,637182093,104483568,741665661
2020-08-02,1,UG,0,0,0,0,0,0
2020-08-02,All-Floors,Alumni,2,2,0,44734270,4072531,48806801
2020-08-02,All-Floors,Non-HKUST,0,0,0,0,0,0
2020-08-02,All-Floors,Others(HKUST),6,25,1468405,51994927891,8222607227,60217535118
2020-08-02,All-Floors,RPG,65,84,14760,8060842928,400504240,8461347168
2020-08-02,All-Floors,Staff,22,56,516933,72030749662,19740082960,91770832622
2020-08-02,All-Floors,TPG,1,2,1979,1090223212,29447274,1119670486
2020-08-02,All-Floors,Total,142,267,2058054,147536508861,31349742280,178886251141
2020-08-02,All-Floors,UG,46,98,55977,14315030898,2953028048,17268058946
2020-08-02,G,Alumni,0,0,0,0,0,0
2020-08-02,G,Non-HKUST,0,0,0,0,0,0
2020-08-02,G,Others(HKUST),2,4,345596,351653168,66567556,418220724
2020-08-02,G,RPG,1,1,0,30168086,2632752,32800838
2020-08-02,G,Staff,6,12,345577,71365433163,19639181228,91004614391
2020-08-02,G,TPG,0,0,0,0,0,0
2020-08-02,G,Total,11,19,691173,71747672810,19708657287,91456330097
2020-08-02,G,UG,2,2,0,418393,275751,694144
2020-08-02,LG1,Alumni,0,0,0,0,0,0
2020-08-02,LG1,Non-HKUST,0,0,0,0,0,0
2020-08-02,LG1,Others(HKUST),1,11,776853,26255621891,4267605938,30523227829
2020-08-02,LG1,RPG,1,2,0,261455,80245,341700
2020-08-02,LG1,Staff,5,10,6660,2505300,1585414,4090714
2020-08-02,LG1,TPG,0,0,0,0,0,0
2020-08-02,LG1,Total,9,25,784233,26258873647,4269656964,30528530611
2020-08-02,LG1,UG,2,2,720,485001,385367,870368
2020-08-02,LG3,Alumni,1,1,0,99085,21143,120228
2020-08-02,LG3,Non-HKUST,0,0,0,0,0,0
2020-08-02,LG3,Others(HKUST),1,1,0,372546210,3999386,376545596
2020-08-02,LG3,RPG,41,49,11159,3612974617,246280991,3859255608
2020-08-02,LG3,Staff,5,7,899,8381697,1855674,10237371
2020-08-02,LG3,TPG,1,2,1979,1090223212,29447274,1119670486
2020-08-02,LG3,Total,78,96,26440,9129841114,2812468521,11942309635
2020-08-02,LG3,UG,29,36,12403,4045616293,2530864053,6576480346
2020-08-02,LG4,Alumni,1,1,0,44635185,4051388,48686573
2020-08-02,LG4,Non-HKUST,0,0,0,0,0,0
2020-08-02,LG4,Others(HKUST),3,7,173158,25002731854,3874775071,28877506925
2020-08-02,LG4,RPG,27,31,2881,4417433230,151506777,4568940007
2020-08-02,LG4,Staff,5,5,0,29627717,2639827,32267544
2020-08-02,LG4,TPG,0,0,0,0,0,0
2020-08-02,LG4,Total,55,102,218893,39762939197,4454475940,44217415137
2020-08-02,LG4,UG,19,58,42854,10268511211,421502877,10690014088
2020-08-03,1,Alumni,0,0,0,0,0,0
2020-08-03,1,Non-HKUST,1,1,13692,63892673,1813529,65706202
2020-08-03,1,Others(HKUST),3,24,187747,355031402,47917181,402948583
2020-08-03,1,RPG,1,1,0,19523,16931,36454
2020-08-03,1,Staff,34,346,646122,13833161413,30974159311,44807320724
2020-08-03,1,TPG,0,0,0,0,0,0
2020-08-03,1,Total,41,387,887903,20673892520,31321227245,51995119765
2020-08-03,1,UG,2,15,40342,6421787509,297320293,6719107802
2020-08-03,All-Floors,Alumni,5,8,11878,432961277,32779315,465740592
2020-08-03,All-Floors,Non-HKUST,7,10,13692,302319764,22584112,324903876
2020-08-03,All-Floors,Others(HKUST),12,73,1433334,36758305149,5809640441,42567945590
2020-08-03,All-Floors,RPG,89,115,30199,3831434288,253778242,4085212530
2020-08-03,All-Floors,Staff,117,944,1602561,80223226424,61950524787,142173751211
2020-08-03,All-Floors,TPG,7,11,3419,412942149,106778069,519720218
2020-08-03,All-Floors,Total,286,1284,3190297,151634972363,70542462164,222177434527
2020-08-03,All-Floors,UG,49,123,95214,29673783312,2366377198,32040160510
2020-08-03,G,Alumni,0,0,0,0,0,0
2020-08-03,G,Non-HKUST,1,2,0,77183686,2908876,80092562
2020-08-03,G,Others(HKUST),6,13,291067,586264344,68015134,654279478
2020-08-03,G,RPG,3,4,0,96199922,5503184,101703106
2020-08-03,G,Staff,41,256,820282,57351907309,22459533102,79811440411
2020-08-03,G,TPG,0,0,0,0,0,0
2020-08-03,G,Total,55,280,1111349,58340425147,22543618400,80884043547
2020-08-03,G,UG,4,5,0,228869886,7658104,236527990
2020-08-03,LG1,Alumni,0,0,0,0,0,0
2020-08-03,LG1,Non-HKUST,0,0,0,0,0,0
2020-08-03,LG1,Others(HKUST),2,14,863983,22602570961,3695119028,26297689989
2020-08-03,LG1,RPG,0,0,0,0,0,0
2020-08-03,LG1,Staff,16,63,79237,2440722283,300280756,2741003039
2020-08-03,LG1,TPG,1,2,540,236310,258172,494482
2020-08-03,LG1,Total,23,83,944661,25065755099,3999663534,29065418633
2020-08-03,LG1,UG,4,4,901,22225545,4005578,26231123
2020-08-03,LG3,Alumni,5,5,0,162220924,7043493,169264417
2020-08-03,LG3,Non-HKUST,4,4,0,154497242,16506945,171004187
2020-08-03,LG3,Others(HKUST),4,11,3055,611942104,46437074,658379178
2020-08-03,LG3,RPG,53,60,17975,2259644190,140604042,2400248232
2020-08-03,LG3,Staff,75,190,34759,4400871207,7502701268,11903572475
2020-08-03,LG3,TPG,5,6,1978,192497505,9079989,201577494
2020-08-03,LG3,Total,165,302,67291,10497358321,8386179553,18883537874
2020-08-03,LG3,UG,19,26,9524,2715685149,663806742,3379491891
2020-08-03,LG4,Alumni,1,3,11878,270740353,25735822,296476175
2020-08-03,LG4,Non-HKUST,3,3,0,6746163,1354762,8100925
2020-08-03,LG4,Others(HKUST),6,11,87482,12602496338,1952152024,14554648362
2020-08-03,LG4,RPG,40,50,12224,1475570653,107654085,1583224738
2020-08-03,LG4,Staff,32,89,22161,2196564212,713850350,2910414562
2020-08-03,LG4,TPG,2,3,901,220208334,97439908,317648242
2020-08-03,LG4,Total,109,232,179093,37057541276,4291773432,41349314708
2020-08-03,LG4,UG,25,73,44447,20285215223,1393586481,21678801704
2020-08-04,1,Alumni,0,0,0,0,0,0
2020-08-04,1,Non-HKUST,1,2,14053,52676373,236331166,289007539
2020-08-04,1,Others(HKUST),2,15,183251,143445780,28901147,172346927
2020-08-04,1,RPG,1,1,0,37518,51407,88925
2020-08-04,1,Staff,27,266,805800,23491978770,8612461210,32104439980
2020-08-04,1,TPG,0,0,0,0,0,0
2020-08-04,1,Total,33,289,1031200,26196834366,8988176537,35185010903
2020-08-04,1,UG,2,5,28096,2508695925,110431607,2619127532
2020-08-04,All-Floors,Alumni,2,2,0,19935417,29479750,49415167
2020-08-04,All-Floors,Non-HKUST,5,6,18014,137473759,256805937,394279696
2020-08-04,All-Floors,Others(HKUST),8,52,1480298,60816102458,9645836934,70461939392
2020-08-04,All-Floors,RPG,98,133,38851,7619799869,351573689,7971373558
2020-08-04,All-Floors,Staff,108,795,1563979,136363926466,40339726618,176703653084
2020-08-04,All-Floors,TPG,6,7,4493,521658281,18865718,540523999
2020-08-04,All-Floors,Total,261,1098,3175133,250421550933,52709694420,303131245353
2020-08-04,All-Floors,UG,34,103,69498,44942654683,2067405774,47010060457
2020-08-04,G,Alumni,0,0,0,0,0,0
2020-08-04,G,Non-HKUST,1,1,0,15925574,15792590,31718164
2020-08-04,G,Others(HKUST),2,5,259729,792333510,117975611,910309121
2020-08-04,G,RPG,4,5,179,160717301,12494176,173211477
2020-08-04,G,Staff,32,175,647613,66809667124,20744607552,87554274676
2020-08-04,G,TPG,0,0,0,0,0,0
2020-08-04,G,Total,41,188,907521,67874000104,20894687113,88768687217
2020-08-04,G,UG,2,2,0,95356595,3817184,99173779
2020-08-04,LG1,Alumni,0,0,0,0,0,0
2020-08-04,LG1,Non-HKUST,1,1,0,0,0,0
2020-08-04,LG1,Others(HKUST),1,10,863990,22450875726,3674292460,26125168186
2020-08-04,LG1,RPG,3,3,1258,6855507,881771,7737278
2020-08-04,LG1,Staff,16,51,25207,14787177766,6249488667,21036666433
2020-08-04,LG1,TPG,0,0,0,0,0,0
2020-08-04,LG1,Total,23,67,891175,37305741191,9937235633,47242976824
2020-08-04,LG1,UG,2,2,720,60832192,12572735,73404927
2020-08-04,LG3,Alumni,0,0,0,0,0,0
2020-08-04,LG3,Non-HKUST,1,1,3961,67434945,4375171,71810116
2020-08-04,LG3,Others(HKUST),3,8,179,3416596,626074,4042670
2020-08-04,LG3,RPG,62,75,17800,4021858781,171859036,4193717817
2020-08-04,LG3,Staff,66,186,29895,18294312849,2523539747,20817852596
2020-08-04,LG3,TPG,4,4,1439,208615540,8572824,217188364
2020-08-04,LG3,Total,155,296,57960,23488224345,3285649590,26773873935
2020-08-04,LG3,UG,19,22,4686,892585634,576676738,1469262372
2020-08-04,LG4,Alumni,2,2,0,19935417,29479750,49415167
2020-08-04,LG4,Non-HKUST,1,1,0,1436867,307010,1743877
2020-08-04,LG4,Others(HKUST),5,14,173149,37426030846,5824041642,43250072488
2020-08-04,LG4,RPG,40,49,19614,3430330762,166287299,3596618061
2020-08-04,LG4,Staff,40,117,55464,12980789957,2209629442,15190419399
2020-08-04,LG4,TPG,3,3,3054,313042741,10292894,323335635
2020-08-04,LG4,Total,105,258,287277,95556750927,9603945547,105160696474
2020-08-04,LG4,UG,14,72,35996,41385184337,1363907510,42749091847
2020-08-05,1,Alumni,0,0,0,0,0,0
2020-08-05,1,Non-HKUST,0,0,0,0,0,0
2020-08-05,1,Others(HKUST),2,3,86759,63734144,12581533,76315677
2020-08-05,1,RPG,0,0,0,0,0,0
2020-08-05,1,Staff,23,221,787706,18583517947,2386399411,20969917358
2020-08-05,1,TPG,0,0,0,0,0,0
2020-08-05,1,Total,28,239,912105,22823636677,2623239138,25446875815
2020-08-05,1,UG,3,15,37640,4176384586,224258194,4400642780
2020-08-05,All-Floors,Alumni,4,6,720,742554780,66430479,808985259
2020-08-05,All-Floors,Non-HKUST,5,6,0,81109586,10970363,92079949
2020-08-05,All-Floors,Others(HKUST),11,68,1358824,46149527065,7806294734,53955821799
2020-08-05,All-Floors,RPG,91,116,26263,2914354580,177183526,3091538106
2020-08-05,All-Floors,Staff,106,692,1488240,92861213952,20512475672,113373689624
2020-08-05,All-Floors,TPG,6,8,0,1052927001,53021177,1105948178
2020-08-05,All-Floors,Total,266,1008,2991410,171698859830,30500189096,202199048926
2020-08-05,All-Floors,UG,43,112,117363,27897172866,1873813145,29770986011
2020-08-05,G,Alumni,0,0,0,0,0,0
2020-08-05,G,Non-HKUST,1,1,0,3542115,758281,4300396
2020-08-05,G,Others(HKUST),6,16,367542,1832416064,390243477,2222659541
2020-08-05,G,RPG,4,6,2517,129841794,9749347,139591141
2020-08-05,G,Staff,28,145,580772,64710779796,17013343096,81724122892
2020-08-05,G,TPG,0,0,0,0,0,0
2020-08-05,G,Total,43,177,956238,67490730427,17488030722,84978761149
2020-08-05,G,UG,4,9,5407,814150658,73936521,888087179
2020-08-05,LG1,Alumni,0,0,0,0,0,0
2020-08-05,LG1,Non-HKUST,0,0,0,0,0,0
2020-08-05,LG1,Others(HKUST),3,14,691734,16213274571,2626585052,18839859623
2020-08-05,LG1,RPG,2,2,718,633661,272239,905900
2020-08-05,LG1,Staff,20,80,30618,1002826472,119686452,1122512924
2020-08-05,LG1,TPG,1,1,0,129825,72240,202065
2020-08-05,LG1,Total,31,115,732982,18362847046,2845506887,21208353933
2020-08-05,LG1,UG,5,18,9912,1145982517,98890904,1244873421
2020-08-05,LG3,Alumni,4,6,720,742554780,66430479,808985259
2020-08-05,LG3,Non-HKUST,4,5,0,77567471,10212082,87779553
2020-08-05,LG3,Others(HKUST),6,19,37649,2961126767,882532842,3843659609
2020-08-05,LG3,RPG,46,59,13134,1756196100,106489295,1862685395
2020-08-05,LG3,Staff,66,160,41962,6120172152,731235246,6851407398
2020-08-05,LG3,TPG,3,3,0,976004437,50187360,1026191797
2020-08-05,LG3,Total,152,285,134844,18962932721,2483455592,21446388313
2020-08-05,LG3,UG,23,33,41379,6329311014,636368288,6965679302
2020-08-05,LG4,Alumni,0,0,0,0,0,0
2020-08-05,LG4,Non-HKUST,0,0,0,0,0,0
2020-08-05,LG4,Others(HKUST),6,16,175140,25078975519,3894351830,28973327349
2020-08-05,LG4,RPG,43,49,9894,1027683025,60672645,1088355670
2020-08-05,LG4,Staff,33,86,47182,2443917585,261811467,2705729052
2020-08-05,LG4,TPG,4,4,0,76792739,2761577,79554316
2020-08-05,LG4,Total,98,192,255241,44058712959,5059956757,49118669716
2020-08-05,LG4,UG,12,37,23025,15431344091,840359238,16271703329
2020-08-06,1,Alumni,0,0,0,0,0,0
2020-08-06,1,Non-HKUST,1,4,12252,7477071,1557568,9034639
2020-08-06,1,Others(HKUST),1,3,172430,62541812,34111572,96653384
2020-08-06,1,RPG,0,0,0,0,0,0
2020-08-06,1,Staff,31,299,638771,20693915273,3367547561,24061462834
2020-08-06,1,TPG,0,0,0,0,0,0
2020-08-06,1,Total,35,325,855148,26100957146,3756077646,29857034792
2020-08-06,1,UG,2,19,31695,5337022990,352860945,5689883935
2020-08-06,All-Floors,Alumni,5,9,0,160366570,32018706,192385276
2020-08-06,All-Floors,Non-HKUST,4,10,12432,128321824,14994423,143316247
2020-08-06,All-Floors,Others(HKUST),8,74,1571008,73979148116,10171684640,84150832756
2020-08-06,All-Floors,RPG,106,141,36511,4957269164,408134091,5365403255
2020-08-06,All-Floors,Staff,115,823,1544568,129045657102,25131969261,154177626363
2020-08-06,All-Floors,TPG,4,5,0,142455143,11376396,153831539
2020-08-06,All-Floors,Total,286,1182,3258317,252217225191,38837785497,291055010688
2020-08-06,All-Floors,UG,44,120,93798,43804007272,3067607980,46871615252
2020-08-06,G,Alumni,0,0,0,0,0,0
2020-08-06,G,Non-HKUST,3,4,0,5963571,1178356,7141927
2020-08-06,G,Others(HKUST),3,7,323989,157439404,48601083,206040487
2020-08-06,G,RPG,4,4,721,314803810,5261515,320065325
2020-08-06,G,Staff,33,166,728589,62212191546,15512006240,77724197786
2020-08-06,G,TPG,0,0,0,0,0,0
2020-08-06,G,Total,44,183,1053299,64315243401,15608333912,79923577313
2020-08-06,G,UG,1,2,0,1624845070,41286718,1666131788
2020-08-06,LG1,Alumni,0,0,0,0,0,0
2020-08-06,LG1,Non-HKUST,1,1,180,108738,30375,139113
2020-08-06,LG1,Others(HKUST),1,12,863250,29432026564,4813567935,34245594499
2020-08-06,LG1,RPG,5,5,899,1722114,394899,2117013
2020-08-06,LG1,Staff,15,79,114179,32139281397,2694981555,34834262952
2020-08-06,LG1,TPG,0,0,0,0,0,0
2020-08-06,LG1,Total,30,107,982646,64275149896,7597615827,71872765723
2020-08-06,LG1,UG,8,10,4138,2702011083,88641063,2790652146
2020-08-06,LG3,Alumni,3,4,0,113354054,8050053,121404107
2020-08-06,LG3,Non-HKUST,1,1,0,114772444,12228124,127000568
2020-08-06,LG3,Others(HKUST),4,42,36561,18968117042,1360600807,20328717849
2020-08-06,LG3,RPG,65,84,26618,3284572794,301369058,3585941852
2020-08-06,LG3,Staff,78,168,25035,8245559642,1843866888,10089426530
2020-08-06,LG3,TPG,3,3,0,109563079,9194980,118758059
2020-08-06,LG3,Total,176,331,95953,37861219452,4365922452,42227141904
2020-08-06,LG3,UG,22,29,7739,7025280397,830612542,7855892939
2020-08-06,LG4,Alumni,3,5,0,47012516,23968653,70981169
2020-08-06,LG4,Non-HKUST,0,0,0,0,0,0
2020-08-06,LG4,Others(HKUST),4,10,174778,25359023294,3914803243,29273826537
2020-08-06,LG4,RPG,44,48,8273,1356170446,101108619,1457279065
2020-08-06,LG4,Staff,28,111,37994,5754709244,1713567017,7468276261
2020-08-06,LG4,TPG,2,2,0,32892064,2181416,35073480
2020-08-06,LG4,Total,102,236,271271,59664655296,7509835660,67174490956
2020-08-06,LG4,UG,21,60,50226,27114847732,1754206712,28869054444
2020-08-07,1,Alumni,0,0,0,0,0,0
2020-08-07,1,Non-HKUST,0,0,0,0,0,0
2020-08-07,1,Others(HKUST),3,5,172798,62318720,25713149,88031869
2020-08-07,1,RPG,0,0,0,0,0,0
2020-08-07,1,Staff,27,258,561274,13483957992,1118739075,14602697067
2020-08-07,1,TPG,0,0,0,0,0,0
2020-08-07,1,Total,34,319,800359,20976335939,2481178414,23457514353
2020-08-07,1,UG,4,56,66287,7430059227,1336726190,8766785417
2020-08-07,All-Floors,Alumni,7,9,361,345760822,23144242,368905064
2020-08-07,All-Floors,Non-HKUST,5,6,1441,78551170,18599534,97150704
2020-08-07,All-Floors,Others(HKUST),11,66,1388512,56080049895,9901128383,65981178278
2020-08-07,All-Floors,RPG,84,97,35815,6579767588,1409847813,7989615401
2020-08-07,All-Floors,Staff,98,783,1147324,58087842742,11321116460,69408959202
2020-08-07,All-Floors,TPG,8,14,1080,1722641921,171022499,1893664420
2020-08-07,All-Floors,Total,284,1185,2702530,163209292008,27336727736,190546019744
2020-08-07,All-Floors,UG,71,210,127997,40314677870,4491868805,44806546675
2020-08-07,G,Alumni,2,3,361,14030872,2567910,16598782
2020-08-07,G,Non-HKUST,2,2,721,738644,228095,966739
2020-08-07,G,Others(HKUST),5,15,361446,2607530445,266401237,2873931682
2020-08-07,G,RPG,4,4,0,891773908,368941170,1260715078
2020-08-07,G,Staff,30,156,418384,32156085619,8034132514,40190218133
2020-08-07,G,TPG,1,1,180,0,0,0
2020-08-07,G,Total,57,207,787752,39431915425,9331309857,48763225282
2020-08-07,G,UG,13,26,6660,3761755937,659038931,4420794868
2020-08-07,LG1,Alumni,1,1,0,2152497,1011173,3163670
2020-08-07,LG1,Non-HKUST,0,0,0,0,0,0
2020-08-07,LG1,Others(HKUST),3,11,637701,21790893991,3575789868,25366683859
2020-08-07,LG1,RPG,2,2,0,411726,99723,511449
2020-08-07,LG1,Staff,19,54,55818,702729400,283031157,985760557
2020-08-07,LG1,TPG,1,1,0,26005,24813,50818
2020-08-07,LG1,Total,29,72,694959,22734957118,3873808756,26608765874
2020-08-07,LG1,UG,3,3,1440,238743499,13852022,252595521
2020-08-07,LG3,Alumni,4,4,0,329542204,19552101,349094305
2020-08-07,LG3,Non-HKUST,2,3,720,2962823,942565,3905388
2020-08-07,LG3,Others(HKUST),3,22,41065,6493541799,2130151332,8623693131
2020-08-07,LG3,RPG,49,57,33478,3476052039,188444442,3664496481
2020-08-07,LG3,Staff,57,129,2159,3757639686,478240813,4235880499
2020-08-07,LG3,TPG,6,8,360,131317043,5810220,137127263
2020-08-07,LG3,Total,154,263,89658,16527834740,3158222986,19686057726
2020-08-07,LG3,UG,33,40,11876,2336779146,335081513,2671860659
2020-08-07,LG4,Alumni,1,1,0,35249,13058,48307
2020-08-07,LG4,Non-HKUST,1,1,0,74849703,17428874,92278577
2020-08-07,LG4,Others(HKUST),5,13,175502,25125764940,3903072797,29028837737
2020-08-07,LG4,RPG,33,34,2337,2211529915,852362478,3063892393
2020-08-07,LG4,Staff,46,186,109689,7987430045,1406972901,9394402946
2020-08-07,LG4,TPG,2,4,540,1591298873,165187466,1756486339
2020-08-07,LG4,Total,122,324,329802,63538248786,8492207723,72030456509
2020-08-07,LG4,UG,34,85,41734,26547340061,2147170149,28694510210
2020-08-08,1,Alumni,0,0,0,0,0,0
2020-08-08,1,Non-HKUST,0,0,0,0,0,0
2020-08-08,1,Others(HKUST),1,2,172798,48496094,25255892,73751986
2020-08-08,1,RPG,1,1,0,20662236,2209776,22872012
2020-08-08,1,Staff,3,28,248204,24750702,8758379,33509081
2020-08-08,1,TPG,0,0,0,0,0,0
2020-08-08,1,Total,5,31,421002,93909032,36224047,130133079
2020-08-08,1,UG,0,0,0,0,0,0
2020-08-08,All-Floors,Alumni,1,1,0,20175,9766,29941
2020-08-08,All-Floors,Non-HKUST,0,0,0,0,0,0
2020-08-08,All-Floors,Others(HKUST),6,26,1468765,53447116484,8496225378,61943341862
2020-08-08,All-Floors,RPG,61,70,8101,4501279052,322704394,4823983446
2020-08-08,All-Floors,Staff,35,71,601160,80392149888,21751449887,102143599775
2020-08-08,All-Floors,TPG,5,6,0,61426112,4110302,65536414
2020-08-08,All-Floors,Total,153,278,2121243,162258300002,34813495105,197071795107
2020-08-08,All-Floors,UG,45,104,43217,23856308291,4238995378,28095303669
2020-08-08,G,Alumni,0,0,0,0,0,0
2020-08-08,G,Non-HKUST,0,0,0,0,0,0
2020-08-08,G,Others(HKUST),2,4,345596,311951338,75526076,387477414
2020-08-08,G,RPG,1,1,0,61527762,2351074,63878836
2020-08-08,G,Staff,4,8,345219,78792677709,21677453454,100470131163
2020-08-08,G,TPG,1,1,0,2420983,1205334,3626317
2020-08-08,G,Total,10,16,690815,79559680729,21779963836,101339644565
2020-08-08,G,UG,2,2,0,391102937,23427898,414530835
2020-08-08,LG1,Alumni,0,0,0,0,0,0
2020-08-08,LG1,Non-HKUST,0,0,0,0,0,0
2020-08-08,LG1,Others(HKUST),1,11,776853,27288697785,4446809561,31735507346
2020-08-08,LG1,RPG,5,5,900,2731644,735438,3467082
2020-08-08,LG1,Staff,5,5,1620,24282648,3084638,27367286
2020-08-08,LG1,TPG,0,0,0,0,0,0
2020-08-08,LG1,Total,19,30,782793,27487400390,4470814853,31958215243
2020-08-08,LG1,UG,8,9,3420,171688313,20185216,191873529
2020-08-08,LG3,Alumni,0,0,0,0,0,0
2020-08-08,LG3,Non-HKUST,0,0,0,0,0,0
2020-08-08,LG3,Others(HKUST),2,4,540,2462108,210521,2672629
2020-08-08,LG3,RPG,37,41,6662,3113867895,126644951,3240512846
2020-08-08,LG3,Staff,18,21,4319,1455141648,45937754,1501079402
2020-08-08,LG3,TPG,2,3,0,33436163,1668369,35104532
2020-08-08,LG3,Total,79,89,12601,5743382637,817198095,6560580732
2020-08-08,LG3,UG,20,20,1080,1138474823,642736500,1781211323
2020-08-08,LG4,Alumni,1,1,0,20175,9766,29941
2020-08-08,LG4,Non-HKUST,0,0,0,0,0,0
2020-08-08,LG4,Others(HKUST),3,5,172978,25795509159,3948423328,29743932487
2020-08-08,LG4,RPG,19,22,539,1302489515,190763155,1493252670
2020-08-08,LG4,Staff,7,9,1798,95297181,16215662,111512843
2020-08-08,LG4,TPG,2,2,0,25568966,1236599,26805565
2020-08-08,LG4,Total,49,112,214032,49373927214,7709294274,57083221488
2020-08-08,LG4,UG,17,73,38717,22155042218,3552645764,25707687982
2020-08-09,1,Alumni,0,0,0,0,0,0
2020-08-09,1,Non-HKUST,0,0,0,0,0,0
2020-08-09,1,Others(HKUST),1,2,172798,50973098,26039784,77012882
2020-08-09,1,RPG,2,2,1440,206564,110962,317526
2020-08-09,1,Staff,3,23,250020,22473839,8667634,31141473
2020-08-09,1,TPG,1,1,179,19305,19688,38993
2020-08-09,1,Total,7,28,424437,73672806,34838068,108510874
2020-08-09,1,UG,0,0,0,0,0,0
2020-08-09,All-Floors,Alumni,2,6,1619,594541291,65045844,659587135
2020-08-09,All-Floors,Non-HKUST,1,1,540,412952,274227,687179
2020-08-09,All-Floors,Others(HKUST),7,28,1469675,36916178780,5961845565,42878024345
2020-08-09,All-Floors,RPG,41,58,13861,3600885602,194859319,3795744921
2020-08-09,All-Floors,Staff,20,47,602094,53590110448,14687360709,68277471157
2020-08-09,All-Floors,TPG,3,3,179,24278021,4041921,28319942
2020-08-09,All-Floors,Total,129,248,2125584,107706266294,22673981625,130380247919
2020-08-09,All-Floors,UG,55,105,37616,12979859200,1760554040,14740413240
2020-08-09,G,Alumni,0,0,0,0,0,0
2020-08-09,G,Non-HKUST,0,0,0,0,0,0
2020-08-09,G,Others(HKUST),4,6,345596,538216915,92101269,630318184
2020-08-09,G,RPG,2,2,0,321541370,16107065,337648435
2020-08-09,G,Staff,3,7,348655,53039561948,14645183612,67684745560
2020-08-09,G,TPG,0,0,0,0,0,0
2020-08-09,G,Total,16,27,696052,54872608699,14810160599,69682769298
2020-08-09,G,UG,7,12,1801,973288466,56768653,1030057119
2020-08-09,LG1,Alumni,0,0,0,0,0,0
2020-08-09,LG1,Non-HKUST,1,1,540,412952,274227,687179
2020-08-09,LG1,Others(HKUST),1,11,863622,23729613219,3881065041,27610678260
2020-08-09,LG1,RPG,1,1,180,0,0,0
2020-08-09,LG1,Staff,2,2,720,70752,107243,177995
2020-08-09,LG1,TPG,0,0,0,0,0,0
2020-08-09,LG1,Total,10,22,867042,24073168029,3897753662,27970921691
2020-08-09,LG1,UG,5,7,1980,343071106,16307151,359378257
2020-08-09,LG3,Alumni,1,4,180,517535578,56757762,574293340
2020-08-09,LG3,Non-HKUST,0,0,0,0,0,0
2020-08-09,LG3,Others(HKUST),3,4,0,15429443,7752165,23181608
2020-08-09,LG3,RPG,20,26,7561,1869549979,111174061,1980724040
2020-08-09,LG3,Staff,9,10,180,165547910,11987902,177535812
2020-08-09,LG3,TPG,1,1,0,24203357,3985261,28188618
2020-08-09,LG3,Total,64,77,24121,3977408303,295653106,4273061409
2020-08-09,LG3,UG,30,32,16200,1385142036,103995955,1489137991
2020-08-09,LG4,Alumni,1,2,1439,77005713,8288082,85293795
2020-08-09,LG4,Non-HKUST,0,0,0,0,0,0
2020-08-09,LG4,Others(HKUST),3,5,87659,12581946105,1954887306,14536833411
2020-08-09,LG4,RPG,21,27,4680,1409587689,67467231,1477054920
2020-08-09,LG4,Staff,4,5,2519,362455999,21414318,383870317
2020-08-09,LG4,TPG,1,1,0,55359,36972,92331
2020-08-09,LG4,Total,49,94,113932,24709408457,3635576190,28344984647
2020-08-09,LG4,UG,19,54,17635,10278357592,1583482281,11861839873
2020-08-10,1,Alumni,0,0,0,0,0,0
2020-08-10,1,Non-HKUST,1,2,13511,10996820,837448,11834268
2020-08-10,1,Others(HKUST),3,35,199639,962801628,480128462,1442930090
2020-08-10,1,RPG,1,1,719,6315189,1080006,7395195
2020-08-10,1,Staff,30,285,745523,33893195396,10850283755,44743479151
2020-08-10,1,TPG,0,0,0,0,0,0
2020-08-10,1,Total,37,374,1004056,74589367528,13048280711,87637648239
2020-08-10,1,UG,2,51,44664,39716058495,1715951040,41432009535
2020-08-10,All-Floors,Alumni,2,2,0,157612982,4824007,162436989
2020-08-10,All-Floors,Non-HKUST,6,8,13511,1231013943,30857368,1261871311
2020-08-10,All-Floors,Others(HKUST),9,68,1497238,62817785314,10279436788,73097222102
2020-08-10,All-Floors,RPG,75,90,13132,6824588487,2193975104,9018563591
2020-08-10,All-Floors,Staff,110,931,1678590,124459610078,47179583701,171639193779
2020-08-10,All-Floors,TPG,4,5,0,15306720,3021189,18327909
2020-08-10,All-Floors,Total,248,1254,3272336,258655441060,62935719538,321591160598
2020-08-10,All-Floors,UG,42,150,69865,63149523536,3244021381,66393544917
2020-08-10,G,Alumni,0,0,0,0,0,0
2020-08-10,G,Non-HKUST,0,0,0,0,0,0
2020-08-10,G,Others(HKUST),3,5,259918,490101028,76011198,566112226
2020-08-10,G,RPG,2,2,0,33344189,3170577,36514766
2020-08-10,G,Staff,39,246,745425,69643575363,24324289992,93967865355
2020-08-10,G,TPG,0,0,0,0,0,0
2020-08-10,G,Total,49,262,1006425,75454075594,24735784309,100189859903
2020-08-10,G,UG,5,9,1082,5287055014,332312542,5619367556
2020-08-10,LG1,Alumni,0,0,0,0,0,0
2020-08-10,LG1,Non-HKUST,0,0,0,0,0,0
2020-08-10,LG1,Others(HKUST),1,10,863990,23543915720,3844109876,27388025596
2020-08-10,LG1,RPG,2,2,541,345811,178438,524249
2020-08-10,LG1,Staff,16,47,88418,2349049358,1039853943,3388903301
2020-08-10,LG1,TPG,0,0,0,0,0,0
2020-08-10,LG1,Total,27,70,956729,27994200255,4998206064,32992406319
2020-08-10,LG1,UG,8,11,3780,2100889366,114063807,2214953173
2020-08-10,LG3,Alumni,1,1,0,74496,23036,97532
2020-08-10,LG3,Non-HKUST,3,4,0,1218886969,29933257,1248820226
2020-08-10,LG3,Others(HKUST),3,6,0,34442062,5929529,40371591
2020-08-10,LG3,RPG,39,44,1799,3870106229,1038391766,4908497995
2020-08-10,LG3,Staff,70,210,47174,10104319517,8949791256,19054110773
2020-08-10,LG3,TPG,2,2,0,9729394,422830,10152224
2020-08-10,LG3,Total,140,291,49332,18870940243,10270055785,29140996028
2020-08-10,LG3,UG,22,24,359,3633381576,245564111,3878945687
2020-08-10,LG4,Alumni,1,1,0,157538486,4800971,162339457
2020-08-10,LG4,Non-HKUST,2,2,0,1130154,86663,1216817
2020-08-10,LG4,Others(HKUST),4,12,173691,37786524876,5873257723,43659782599
2020-08-10,LG4,RPG,37,41,10073,2914477069,1151154317,4065631386
2020-08-10,LG4,Staff,38,143,52050,8469470444,2015364755,10484835199
2020-08-10,LG4,TPG,2,3,0,5577326,2598359,8175685
2020-08-10,LG4,Total,99,257,255794,61746857440,9883392669,71630250109
2020-08-10,LG4,UG,15,55,19980,12412139085,836129881,13248268966
2020-08-11,1,Alumni,0,0,0,0,0,0
2020-08-11,1,Non-HKUST,0,0,0,0,0,0
2020-08-11,1,Others(HKUST),3,43,138457,9452813487,2768516982,12221330469
2020-08-11,1,RPG,1,1,180,26572,21203,47775
2020-08-11,1,Staff,37,453,1144802,47767508549,18232598419,66000106968
2020-08-11,1,TPG,0,0,0,0,0,0
2020-08-11,1,Total,43,542,1319277,82442064584,22083697697,104525762281
2020-08-11,1,UG,2,45,35838,25221715976,1082561093,26304277069
2020-08-11,All-Floors,Alumni,0,0,0,0,0,0
2020-08-11,All-Floors,Non-HKUST,2,2,0,49036655,13216652,62253307
2020-08-11,All-Floors,Others(HKUST),9,129,1391981,96047209829,12274600518,108321810347
2020-08-11,All-Floors,RPG,82,138,40449,9468052893,2248714873,11716767766
2020-08-11,All-Floors,Staff,120,1037,2206706,204157473320,56857590041,261015063361
2020-08-11,All-Floors,TPG,6,8,1258,268154434,18205033,286359467
2020-08-11,All-Floors,Total,254,1482,3712221,422155140350,75435477812,497590618162
2020-08-11,All-Floors,UG,35,168,71827,112165213219,4023150695,116188363914
2020-08-11,G,Alumni,0,0,0,0,0,0
2020-08-11,G,Non-HKUST,1,1,0,42640301,13079154,55719455
2020-08-11,G,Others(HKUST),5,12,261347,3138243375,194453803,3332697178
2020-08-11,G,RPG,3,4,539,178404911,20644930,199049841
2020-08-11,G,Staff,45,225,835769,82193987119,18645990847,100839977966
2020-08-11,G,TPG,1,1,0,805743,411760,1217503
2020-08-11,G,Total,60,255,1101971,92874095938,19146260304,112020356242
2020-08-11,G,UG,5,12,4316,7320014489,271679810,7591694299
2020-08-11,LG1,Alumni,0,0,0,0,0,0
2020-08-11,LG1,Non-HKUST,0,0,0,0,0,0
2020-08-11,LG1,Others(HKUST),3,11,777950,20522432360,3329422795,23851855155
2020-08-11,LG1,RPG,4,4,0,3235154,410477,3645631
2020-08-11,LG1,Staff,17,55,88601,7259442502,1406139236,8665581738
2020-08-11,LG1,TPG,0,0,0,0,0,0
2020-08-11,LG1,Total,25,71,866551,27786351878,4736139622,32522491500
2020-08-11,LG1,UG,1,1,0,1241862,167114,1408976
2020-08-11,LG3,Alumni,0,0,0,0,0,0
2020-08-11,LG3,Non-HKUST,1,1,0,6396354,137498,6533852
2020-08-11,LG3,Others(HKUST),3,48,39626,36542739891,2018800060,38561539951
2020-08-11,LG3,RPG,38,63,27328,7186500350,1544133834,8730634184
2020-08-11,LG3,Staff,82,216,72527,48310092376,15749737455,64059829831
2020-08-11,LG3,TPG,4,4,1258,162867963,8667731,171535694
2020-08-11,LG3,Total,149,367,142539,98102282860,19484323278,117586606138
2020-08-11,LG3,UG,21,35,1800,5893685926,162846700,6056532626
2020-08-11,LG4,Alumni,0,0,0,0,0,0
2020-08-11,LG4,Non-HKUST,0,0,0,0,0,0
2020-08-11,LG4,Others(HKUST),6,15,174601,26390980716,3963406878,30354387594
2020-08-11,LG4,RPG,47,66,12402,2099885906,683504429,2783390335
2020-08-11,LG4,Staff,30,88,65007,18626442774,2823124084,21449566858
2020-08-11,LG4,TPG,2,3,0,104480728,9125542,113606270
2020-08-11,LG4,Total,99,247,281883,120950345090,9985056911,130935402001
2020-08-11,LG4,UG,14,75,29873,73728554966,2505895978,76234450944
2020-08-12,1,Alumni,0,0,0,0,0,0
2020-08-12,1,Non-HKUST,0,0,0,0,0,0
2020-08-12,1,Others(HKUST),2,26,206304,5450181005,991319574,6441500579
2020-08-12,1,RPG,0,0,0,0,0,0
2020-08-12,1,Staff,42,497,1294716,73723372206,5831071471,79554443677
2020-08-12,1,TPG,0,0,0,0,0,0
2020-08-12,1,Total,47,545,1548936,96530176024,7588121107,104118297131
2020-08-12,1,UG,3,22,47916,17356622813,765730062,18122352875
2020-08-12,All-Floors,Alumni,2,2,0,442446377,246510479,688956856
2020-08-12,All-Floors,Non-HKUST,3,3,0,429334,154367,583701
2020-08-12,All-Floors,Others(HKUST),10,103,1534150,61248000504,10971921914,72219922418
2020-08-12,All-Floors,RPG,86,111,26987,4371432516,343393804,4714826320
2020-08-12,All-Floors,Staff,125,1108,2383134,200162216402,28001362103,228163578505
2020-08-12,All-Floors,TPG,5,6,0,100597040,4530463,105127503
2020-08-12,All-Floors,Total,283,1462,4037011,313256173830,44283098142,357539271972
2020-08-12,All-Floors,UG,52,129,92740,46931051657,4715225012,51646276669
2020-08-12,G,Alumni,1,1,0,388446372,241695975,630142347
2020-08-12,G,Non-HKUST,0,0,0,0,0,0
2020-08-12,G,Others(HKUST),4,11,345407,2168899684,719419710,2888319394
2020-08-12,G,RPG,2,2,0,10281108,796055,11077163
2020-08-12,G,Staff,48,267,786827,94433208925,19115129657,113548338582
2020-08-12,G,TPG,0,0,0,0,0,0
2020-08-12,G,Total,61,294,1139979,105883020801,20458886621,126341907422
2020-08-12,G,UG,6,13,7745,8882184712,381845224,9264029936
2020-08-12,LG1,Alumni,0,0,0,0,0,0
2020-08-12,LG1,Non-HKUST,1,1,0,0,0,0
2020-08-12,LG1,Others(HKUST),1,10,777222,23837459056,3902585719,27740044775
2020-08-12,LG1,RPG,2,2,0,32171914,1372900,33544814
2020-08-12,LG1,Staff,14,80,153824,7511182047,1344745172,8855927219
2020-08-12,LG1,TPG,0,0,0,0,0,0
2020-08-12,LG1,Total,23,108,940593,34644711721,5339085176,39983796897
2020-08-12,LG1,UG,5,15,9547,3263898704,90381385,3354280089
2020-08-12,LG3,Alumni,0,0,0,0,0,0
2020-08-12,LG3,Non-HKUST,2,2,0,429334,154367,583701
2020-08-12,LG3,Others(HKUST),5,43,30976,4369157261,1415889342,5785046603
2020-08-12,LG3,RPG,53,64,15470,3076770429,175149898,3251920327
2020-08-12,LG3,Staff,84,194,136781,19198702096,1239550348,20438252444
2020-08-12,LG3,TPG,4,5,0,100506213,4477340,104983553
2020-08-12,LG3,Total,184,351,191509,33323317131,5890843118,39214160249
2020-08-12,LG3,UG,36,43,8282,6577751798,3055621823,9633373621
2020-08-12,LG4,Alumni,1,1,0,54000005,4814504,58814509
2020-08-12,LG4,Non-HKUST,0,0,0,0,0,0
2020-08-12,LG4,Others(HKUST),5,13,174241,25422303498,3942707569,29365011067
2020-08-12,LG4,RPG,38,43,11517,1252209065,166074951,1418284016
2020-08-12,LG4,Staff,34,70,10986,5295751128,470865455,5766616583
2020-08-12,LG4,TPG,1,1,0,90827,53123,143950
2020-08-12,LG4,Total,95,164,215994,42874948153,5006162120,47881110273
2020-08-12,LG4,UG,16,36,19250,10850593630,421646518,11272240148
2020-08-13,1,Alumni,0,0,0,0,0,0
2020-08-13,1,Non-HKUST,0,0,0,0,0,0
2020-08-13,1,Others(HKUST),2,4,173881,125102407,40963401,166065808
2020-08-13,1,RPG,2,2,720,32408,400280,432688
2020-08-13,1,Staff,34,218,949291,14543585250,2763034322,17306619572
2020-08-13,1,TPG,0,0,0,0,0,0
2020-08-13,1,Total,39,238,1150536,23437708852,3256398993,26694107845
2020-08-13,1,UG,1,14,26644,8768988787,452000990,9220989777
2020-08-13,All-Floors,Alumni,4,5,22839,2452278385,138917541,2591195926
2020-08-13,All-Floors,Non-HKUST,7,8,2517,892396233,31206971,923603204
2020-08-13,All-Floors,Others(HKUST),9,59,1406877,58622358741,8789173783,67411532524
2020-08-13,All-Floors,RPG,87,95,7379,2272513904,148269246,2420783150
2020-08-13,All-Floors,Staff,113,877,1634214,78320262723,21822919235,100143181958
2020-08-13,All-Floors,TPG,7,8,0,252789237,13686414,266475651
2020-08-13,All-Floors,Total,264,1149,3124935,169007404628,32709976319,201717380947
2020-08-13,All-Floors,UG,37,97,51109,26194805405,1765803129,27960608534
2020-08-13,G,Alumni,0,0,0,0,0,0
2020-08-13,G,Non-HKUST,1,1,0,0,0,0
2020-08-13,G,Others(HKUST),3,5,345596,1128251620,168040724,1296292344
2020-08-13,G,RPG,5,5,0,90354691,6188999,96543690
2020-08-13,G,Staff,36,223,430673,46104793558,14406212309,60511005867
2020-08-13,G,TPG,0,0,0,0,0,0
2020-08-13,G,Total,46,235,776269,47798868593,14594161940,62393030533
2020-08-13,G,UG,1,1,0,475468724,13719908,489188632
2020-08-13,LG1,Alumni,0,0,0,0,0,0
2020-08-13,LG1,Non-HKUST,0,0,0,0,0,0
2020-08-13,LG1,Others(HKUST),2,10,690824,22642508096,3722179993,26364688089
2020-08-13,LG1,RPG,6,7,3059,238768842,11830915,250599757
2020-08-13,LG1,Staff,22,79,105357,3487995370,891864467,4379859837
2020-08-13,LG1,TPG,0,0,0,0,0,0
2020-08-13,LG1,Total,33,102,800137,28871743964,4754202857,33625946821
2020-08-13,LG1,UG,3,6,897,2502471656,128327482,2630799138
2020-08-13,LG3,Alumni,0,0,0,0,0,0
2020-08-13,LG3,Non-HKUST,5,6,538,627105894,21707075,648812969
2020-08-13,LG3,Others(HKUST),4,25,19092,9292600794,918342035,10210942829
2020-08-13,LG3,RPG,53,56,3600,1648241166,110364071,1758605237
2020-08-13,LG3,Staff,73,192,116675,8278151021,2662242888,10940393909
2020-08-13,LG3,TPG,3,3,0,11057008,1054111,12111119
2020-08-13,LG3,Total,161,308,142244,24491474804,4004094128,28495568932
2020-08-13,LG3,UG,23,26,2339,4634318921,290383948,4924702869
2020-08-13,LG4,Alumni,4,5,22839,2452278385,138917541,2591195926
2020-08-13,LG4,Non-HKUST,1,1,1979,265290339,9499896,274790235
2020-08-13,LG4,Others(HKUST),5,15,177484,25433895824,3939647630,29373543454
2020-08-13,LG4,RPG,25,25,0,295116797,19484981,314601778
2020-08-13,LG4,Staff,32,165,32218,5905737524,1099565249,7005302773
2020-08-13,LG4,TPG,4,5,0,241732229,12632303,254364532
2020-08-13,LG4,Total,87,266,255749,44407608415,6101118401,50508726816
2020-08-13,LG4,UG,16,50,21229,9813557317,881370801,10694928118
2020-08-14,1,Alumni,0,0,0,0,0,0
2020-08-14,1,Non-HKUST,0,0,0,0,0,0
2020-08-14,1,Others(HKUST),3,23,201423,296501877,96000784,392502661
2020-08-14,1,RPG,0,0,0,0,0,0
2020-08-14,1,Staff,24,228,833332,21780596338,1309607691,23090204029
2020-08-14,1,TPG,0,0,0,0,0,0
2020-08-14,1,Total,29,275,1079053,36801551696,1944651357,38746203053
2020-08-14,1,UG,2,24,44298,14724453481,539042882,15263496363
2020-08-14,All-Floors,Alumni,3,7,20704,726994271,52171234,779165505
2020-08-14,All-Floors,Non-HKUST,8,12,3238,565239655,20534647,585774302
2020-08-14,All-Floors,Others(HKUST),10,60,1505497,55876347265,9057060937,64933408202
2020-08-14,All-Floors,RPG,90,108,29693,2870290937,277640426,3147931363
2020-08-14,All-Floors,Staff,116,646,1513821,131729935652,26563583074,158293518726
2020-08-14,All-Floors,TPG,5,7,1260,894946748,26235852,921182600
2020-08-14,All-Floors,Total,274,940,3144606,224531759964,37177154365,261708914329
2020-08-14,All-Floors,UG,42,100,70393,31868005436,1179928195,33047933631
2020-08-14,G,Alumni,0,0,0,0,0,0
2020-08-14,G,Non-HKUST,1,5,2519,16061135,9715723,25776858
2020-08-14,G,Others(HKUST),3,8,350462,1488205605,193376244,1681581849
2020-08-14,G,RPG,7,7,0,43493611,8354598,51848209
2020-08-14,G,Staff,33,123,519169,93181849425,23971848329,117153697754
2020-08-14,G,TPG,0,0,0,0,0,0
2020-08-14,G,Total,47,152,872330,102660654356,24469015289,127129669645
2020-08-14,G,UG,3,9,180,7931044580,285720395,8216764975
2020-08-14,LG1,Alumni,0,0,0,0,0,0
2020-08-14,LG1,Non-HKUST,2,2,719,184457,134780,319237
2020-08-14,LG1,Others(HKUST),2,13,777212,28415220300,4626991895,33042212195
2020-08-14,LG1,RPG,8,8,3780,2371149,912157,3283306
2020-08-14,LG1,Staff,13,76,107846,3653692263,430655616,4084347879
2020-08-14,LG1,TPG,0,0,0,0,0,0
2020-08-14,LG1,Total,25,99,889557,32071468169,5058694448,37130162617
2020-08-14,LG1,UG,0,0,0,0,0,0
2020-08-14,LG3,Alumni,3,6,20704,726402887,51780118,778183005
2020-08-14,LG3,Non-HKUST,2,2,0,138940162,3912319,142852481
2020-08-14,LG3,Others(HKUST),3,5,181,15315636,4527831,19843467
2020-08-14,LG3,RPG,51,58,18537,2542581811,246990278,2789572089
2020-08-14,LG3,Staff,78,143,36018,9836155479,609330877,10445486356
2020-08-14,LG3,TPG,4,5,1260,894747823,26078514,920826337
2020-08-14,LG3,Total,165,245,77779,14559568004,977849820,15537417824
2020-08-14,LG3,UG,24,26,1079,405424206,35229883,440654089
2020-08-14,LG4,Alumni,1,1,0,591384,391116,982500
2020-08-14,LG4,Non-HKUST,3,3,0,410053901,6771825,416825726
2020-08-14,LG4,Others(HKUST),5,11,176219,25661103847,4136164183,29797268030
2020-08-14,LG4,RPG,31,35,7376,281844366,21383393,303227759
2020-08-14,LG4,Staff,34,76,17456,3277642147,242140561,3519782708
2020-08-14,LG4,TPG,2,2,0,198925,157338,356263
2020-08-14,LG4,Total,94,169,225887,38438517739,4726943451,43165461190
2020-08-14,LG4,UG,18,41,24836,8807083169,319935035,9127018204
2020-08-15,1,Alumni,0,0,0,0,0,0
2020-08-15,1,Non-HKUST,1,1,0,114965,24146,139111
2020-08-15,1,Others(HKUST),1,2,172798,83004914,32511758,115516672
2020-08-15,1,RPG,2,2,360,99129,54963,154092
2020-08-15,1,Staff,5,35,347393,3817541325,108388999,3925930324
2020-08-15,1,TPG,0,0,0,0,0,0
2020-08-15,1,Total,9,40,520551,3900760333,140979866,4041740199
2020-08-15,1,UG,0,0,0,0,0,0
2020-08-15,All-Floors,Alumni,3,4,3062,1145250221,29149994,1174400215
2020-08-15,All-Floors,Non-HKUST,5,10,1259,5606507,24780487,30386994
2020-08-15,All-Floors,Others(HKUST),5,26,1468953,39180735671,6275974967,45456710638
2020-08-15,All-Floors,RPG,57,64,8280,3286873283,175884730,3462758013
2020-08-15,All-Floors,Staff,40,95,697680,63257894601,16249923765,79507818366
2020-08-15,All-Floors,TPG,2,3,721,4251109,407549,4658658
2020-08-15,All-Floors,Total,146,272,2207659,118528766009,23344980946,141873746955
2020-08-15,All-Floors,UG,34,70,27704,11648154617,588859454,12237014071
2020-08-15,G,Alumni,0,0,0,0,0,0
2020-08-15,G,Non-HKUST,2,6,1259,4146861,1145355,5292216
2020-08-15,G,Others(HKUST),3,6,345596,1573000534,206517343,1779517877
2020-08-15,G,RPG,1,1,0,20048571,1375946,21424517
2020-08-15,G,Staff,7,17,346137,58525205856,15911652349,74436858205
2020-08-15,G,TPG,0,0,0,0,0,0
2020-08-15,G,Total,15,32,692992,60125438936,16121199545,76246638481
2020-08-15,G,UG,2,2,0,3037114,508552,3545666
2020-08-15,LG1,Alumni,1,1,0,0,0,0
2020-08-15,LG1,Non-HKUST,0,0,0,0,0,0
2020-08-15,LG1,Others(HKUST),1,11,863621,24731294202,4062742209,28794036411
2020-08-15,LG1,RPG,4,4,2159,163181,121200,284381
2020-08-15,LG1,Staff,7,9,2710,23777273,5607661,29384934
2020-08-15,LG1,TPG,1,1,721,3889651,228806,4118457
2020-08-15,LG1,Total,17,29,869211,24931605270,4078101031,29009706301
2020-08-15,LG1,UG,3,3,0,172480963,9401155,181882118
2020-08-15,LG3,Alumni,0,0,0,0,0,0
2020-08-15,LG3,Non-HKUST,2,2,0,845439,23429253,24274692
2020-08-15,LG3,Others(HKUST),1,1,0,82252967,1619313,83872280
2020-08-15,LG3,RPG,33,37,4681,2438672220,80838880,2519511100
2020-08-15,LG3,Staff,22,25,1440,632126194,197056113,829182307
2020-08-15,LG3,TPG,1,1,0,257066,98233,355299
2020-08-15,LG3,Total,71,82,8821,3375032844,318361279,3693394123
2020-08-15,LG3,UG,12,16,2700,220878958,15319487,236198445
2020-08-15,LG4,Alumni,2,3,3062,1145250221,29149994,1174400215
2020-08-15,LG4,Non-HKUST,1,1,0,499242,181733,680975
2020-08-15,LG4,Others(HKUST),2,6,86938,12711183054,1972584344,14683767398
2020-08-15,LG4,RPG,20,20,1080,827890182,93493741,921383923
2020-08-15,LG4,Staff,6,9,0,259243953,27218643,286462596
2020-08-15,LG4,TPG,1,1,0,104392,80510,184902
2020-08-15,LG4,Total,52,89,116084,26195928626,2686339225,28882267851
2020-08-15,LG4,UG,20,49,25004,11251757582,563630260,11815387842
2020-08-16,1,Alumni,0,0,0,0,0,0
2020-08-16,1,Non-HKUST,0,0,0,0,0,0
2020-08-16,1,Others(HKUST),1,2,172798,84868270,33111396,117979666
2020-08-16,1,RPG,0,0,0,0,0,0
2020-08-16,1,Staff,5,39,449440,2874340198,81914749,2956254947
2020-08-16,1,TPG,0,0,0,0,0,0
2020-08-16,1,Total,6,41,622238,2959208468,115026145,3074234613
2020-08-16,1,UG,0,0,0,0,0,0
2020-08-16,All-Floors,Alumni,3,3,0,529194938,35473365,564668303
2020-08-16,All-Floors,Non-HKUST,1,1,0,2070329,980739,3051068
2020-08-16,All-Floors,Others(HKUST),5,25,1468594,64224784118,10144581310,74369365428
2020-08-16,All-Floors,RPG,63,71,27900,3629851899,218229193,3848081092
2020-08-16,All-Floors,Staff,44,97,807998,64016544251,16252346875,80268891126
2020-08-16,All-Floors,TPG,2,2,0,3788679,1090373,4879052
2020-08-16,All-Floors,Total,168,309,2343383,145631244405,27787173663,173418418068
2020-08-16,All-Floors,UG,50,110,38891,13225010191,1134471808,14359481999
2020-08-16,G,Alumni,0,0,0,0,0,0
2020-08-16,G,Non-HKUST,1,1,0,2070329,980739,3051068
2020-08-16,G,Others(HKUST),2,3,259197,1547286077,173504932,1720791009
2020-08-16,G,RPG,2,3,539,674551889,36485582,711037471
2020-08-16,G,Staff,9,15,354054,59040163998,16118385040,75158549038
2020-08-16,G,TPG,0,0,0,0,0,0
2020-08-16,G,Total,14,22,613790,61264072293,16329356293,77593428586
2020-08-16,G,UG,0,0,0,0,0,0
2020-08-16,LG1,Alumni,1,1,0,511921692,31686310,543608002
2020-08-16,LG1,Non-HKUST,0,0,0,0,0,0
2020-08-16,LG1,Others(HKUST),1,10,863990,24405050398,4005776326,28410826724
2020-08-16,LG1,RPG,5,5,900,64157832,2170734,66328566
2020-08-16,LG1,Staff,5,6,901,731215,568975,1300190
2020-08-16,LG1,TPG,0,0,0,0,0,0
2020-08-16,LG1,Total,15,25,867410,25002063868,4040980740,29043044608
2020-08-16,LG1,UG,3,3,1619,20202731,778395,20981126
2020-08-16,LG3,Alumni,1,1,0,0,0,0
2020-08-16,LG3,Non-HKUST,0,0,0,0,0,0
2020-08-16,LG3,Others(HKUST),1,2,0,5816681,115351,5932032
2020-08-16,LG3,RPG,31,32,9902,1954357803,96195472,2050553275
2020-08-16,LG3,Staff,17,24,3603,216115664,14226425,230342089
2020-08-16,LG3,TPG,1,1,0,2474495,859133,3333628
2020-08-16,LG3,Total,80,93,19805,3437625842,406634791,3844260633
2020-08-16,LG3,UG,29,33,6300,1258861199,295238410,1554099609
2020-08-16,LG4,Alumni,1,1,0,17273246,3787055,21060301
2020-08-16,LG4,Non-HKUST,0,0,0,0,0,0
2020-08-16,LG4,Others(HKUST),3,8,172609,38181762692,5932073305,44113835997
2020-08-16,LG4,RPG,28,31,16559,936784375,83377405,1020161780
2020-08-16,LG4,Staff,12,13,0,1885193176,37251686,1922444862
2020-08-16,LG4,TPG,1,1,0,1314184,231240,1545424
2020-08-16,LG4,Total,68,128,220140,52968273934,6895175694,59863449628
2020-08-16,LG4,UG,23,74,30972,11945946261,838455003,12784401264
2020-08-17,1,Alumni,0,0,0,0,0,0
2020-08-17,1,Non-HKUST,1,4,23773,76879640,70221912,147101552
2020-08-17,1,Others(HKUST),3,21,100276,650165460,389956668,1040122128
2020-08-17,1,RPG,0,0,0,0,0,0
2020-08-17,1,Staff,33,326,810659,12791993506,2124894848,14916888354
2020-08-17,1,TPG,0,0,0,0,0,0
2020-08-17,1,Total,40,370,985326,23040222539,2943237593,25983460132
2020-08-17,1,UG,3,19,50618,9521183933,358164165,9879348098
2020-08-17,All-Floors,Alumni,2,4,905,101429004,9821020,111250024
2020-08-17,All-Floors,Non-HKUST,6,10,23773,133507748,75029905,208537653
2020-08-17,All-Floors,Others(HKUST),13,87,1312015,48767149525,8072791819,56839941344
2020-08-17,All-Floors,RPG,113,141,21394,4083327759,472091103,4555418862
2020-08-17,All-Floors,Staff,122,1057,1784945,119519076196,30049932331,149569008527
2020-08-17,All-Floors,TPG,5,9,0,604006317,19139671,623145988
2020-08-17,All-Floors,Total,316,1458,3270689,208305845446,40260526473,248566371919
2020-08-17,All-Floors,UG,55,150,127657,35097348897,1561720624,36659069521
2020-08-17,G,Alumni,0,0,0,0,0,0
2020-08-17,G,Non-HKUST,2,2,0,22408437,2138143,24546580
2020-08-17,G,Others(HKUST),3,7,259189,1481011829,223297191,1704309020
2020-08-17,G,RPG,4,5,0,40966558,1778160,42744718
2020-08-17,G,Staff,42,280,835449,80668912135,17721300398,98390212533
2020-08-17,G,TPG,0,0,0,0,0,0
2020-08-17,G,Total,55,301,1096618,83857980630,18012361529,101870342159
2020-08-17,G,UG,4,7,1980,1644681671,63847637,1708529308
2020-08-17,LG1,Alumni,0,0,0,0,0,0
2020-08-17,LG1,Non-HKUST,0,0,0,0,0,0
2020-08-17,LG1,Others(HKUST),3,14,777772,21003903871,3456660260,24460564131
2020-08-17,LG1,RPG,4,4,1259,45972417,5208619,51181036
2020-08-17,LG1,Staff,25,80,76358,14900466680,8008772460,22909239140
2020-08-17,LG1,TPG,1,1,0,37898,40616,78514
2020-08-17,LG1,Total,40,106,858806,36052881398,11475115123,47527996521
2020-08-17,LG1,UG,7,7,3417,102500532,4433168,106933700
2020-08-17,LG3,Alumni,0,0,0,0,0,0
2020-08-17,LG3,Non-HKUST,0,0,0,0,0,0
2020-08-17,LG3,Others(HKUST),5,14,180,40638604,15365707,56004311
2020-08-17,LG3,RPG,62,71,9712,2497999364,374210467,2872209831
2020-08-17,LG3,Staff,70,205,21432,7111417310,1639885542,8751302852
2020-08-17,LG3,TPG,3,4,0,543965971,15942155,559908126
2020-08-17,LG3,Total,166,330,48773,12250410765,2385609917,14636020682
2020-08-17,LG3,UG,26,36,17449,2056389516,340206046,2396595562
2020-08-17,LG4,Alumni,2,4,905,101429004,9821020,111250024
2020-08-17,LG4,Non-HKUST,4,4,0,34219671,2669850,36889521
2020-08-17,LG4,Others(HKUST),9,31,174598,25591429761,3987511993,29578941754
2020-08-17,LG4,RPG,55,61,10423,1498389420,90893857,1589283277
2020-08-17,LG4,Staff,49,166,41047,4046286565,555079083,4601365648
2020-08-17,LG4,TPG,2,4,0,60002448,3156900,63159348
2020-08-17,LG4,Total,147,351,281166,53104350114,5444202311,58548552425
2020-08-17,LG4,UG,26,81,54193,21772593245,795069608,22567662853
2020-08-18,1,Alumni,0,0,0,0,0,0
2020-08-18,1,Non-HKUST,2,9,18183,900140927,61640907,961781834
2020-08-18,1,Others(HKUST),2,6,86771,399973618,601760994,1001734612
2020-08-18,1,RPG,0,0,0,0,0,0
2020-08-18,1,Staff,36,322,1025514,19206576817,3328027756,22534604573
2020-08-18,1,TPG,0,0,0,0,0,0
2020-08-18,1,Total,42,351,1169736,26184651964,4283236037,30467888001
2020-08-18,1,UG,2,14,39268,5677960602,291806380,5969766982
2020-08-18,All-Floors,Alumni,3,3,0,3553818684,170560036,3724378720
2020-08-18,All-Floors,Non-HKUST,5,15,18722,1060454488,77704515,1138159003
2020-08-18,All-Floors,Others(HKUST),10,51,1388683,56018473930,8988320008,65006793938
2020-08-18,All-Floors,RPG,100,125,48930,6490395307,1224809803,7715205110
2020-08-18,All-Floors,Staff,125,1028,1790635,66829070494,17193120994,84022191488
2020-08-18,All-Floors,TPG,6,8,5943,1116075656,49685967,1165761623
2020-08-18,All-Floors,Total,299,1349,3323147,169422941098,29382626637,198805567735
2020-08-18,All-Floors,UG,50,119,70234,34354652539,1678425314,36033077853
2020-08-18,G,Alumni,0,0,0,0,0,0
2020-08-18,G,Non-HKUST,1,3,0,145948111,13560566,159508677
2020-08-18,G,Others(HKUST),4,11,349731,5231646807,346776867,5578423674
2020-08-18,G,RPG,2,2,180,4550127,1256910,5807037
2020-08-18,G,Staff,35,233,525797,26318625742,5946686131,32265311873
2020-08-18,G,TPG,0,0,0,0,0,0
2020-08-18,G,Total,43,250,875708,31931274472,6315873591,38247148063
2020-08-18,G,UG,1,1,0,230503685,7593117,238096802
2020-08-18,LG1,Alumni,0,0,0,0,0,0
2020-08-18,LG1,Non-HKUST,0,0,0,0,0,0
2020-08-18,LG1,Others(HKUST),2,11,777764,24744850257,4066162934,28811013191
2020-08-18,LG1,RPG,0,0,0,0,0,0
2020-08-18,LG1,Staff,16,104,152903,9430035674,5684588737,15114624411
2020-08-18,LG1,TPG,0,0,0,0,0,0
2020-08-18,LG1,Total,19,116,931207,34174903040,9750760146,43925663186
2020-08-18,LG1,UG,1,1,540,17109,8475,25584
2020-08-18,LG3,Alumni,3,3,0,3553818684,170560036,3724378720
2020-08-18,LG3,Non-HKUST,1,1,539,9422203,2052691,11474894
2020-08-18,LG3,Others(HKUST),5,9,179,22822368,4239696,27062064
2020-08-18,LG3,RPG,50,60,34903,2729965245,654319955,3384285200
2020-08-18,LG3,Staff,86,230,53827,5807539369,885144276,6692683645
2020-08-18,LG3,TPG,3,5,5943,953716249,37114176,990830425
2020-08-18,LG3,Total,178,350,105658,18309439607,2435867472,20745307079
2020-08-18,LG3,UG,30,42,10267,5232155489,682436642,5914592131
2020-08-18,LG4,Alumni,0,0,0,0,0,0
2020-08-18,LG4,Non-HKUST,2,2,0,4943247,450351,5393598
2020-08-18,LG4,Others(HKUST),5,14,174238,25619180880,3969379517,29588560397
2020-08-18,LG4,RPG,57,63,13847,3755879935,569232938,4325112873
2020-08-18,LG4,Staff,39,139,32594,6066292892,1348674094,7414966986
2020-08-18,LG4,TPG,3,3,0,162359407,12571791,174931198
2020-08-18,LG4,Total,130,282,240838,58822672015,6596889391,65419561406
2020-08-18,LG4,UG,24,61,20159,23214015654,696580700,23910596354
2020-08-19,1,Alumni,0,0,0,0,0,0
2020-08-19,1,Non-HKUST,0,0,0,0,0,0
2020-08-19,1,Others(HKUST),0,0,0,0,0,0
2020-08-19,1,RPG,0,0,0,0,0,0
2020-08-19,1,Staff,18,182,574578,5377764575,829086757,6206851332
2020-08-19,1,TPG,0,0,0,0,0,0
2020-08-19,1,Total,19,183,588443,5437638690,834482345,6272121035
2020-08-19,1,UG,1,1,13865,59874115,5395588,65269703
2020-08-19,All-Floors,Alumni,1,1,0,1877453,329402,2206855
2020-08-19,All-Floors,Non-HKUST,5,8,1437,3991864578,181338922,4173203500
2020-08-19,All-Floors,Others(HKUST),7,32,1210118,52717855538,8174342148,60892197686
2020-08-19,All-Floors,RPG,146,181,19792,11801953744,2494835360,14296789104
2020-08-19,All-Floors,Staff,101,658,860989,34435023904,13583222697,48018246601
2020-08-19,All-Floors,TPG,5,6,900,90407133,9068497,99475630
2020-08-19,All-Floors,Total,306,974,2129598,108156757075,24893058447,133049815522
2020-08-19,All-Floors,UG,41,88,36362,5117774725,449921421,5567696146
2020-08-19,G,Alumni,0,0,0,0,0,0
2020-08-19,G,Non-HKUST,1,2,1256,465004,439730,904734
2020-08-19,G,Others(HKUST),2,4,345596,2517267268,283149846,2800417114
2020-08-19,G,RPG,2,3,720,44379735,378901688,423281423
2020-08-19,G,Staff,27,86,163827,10468074778,3405982670,13874057448
2020-08-19,G,TPG,0,0,0,0,0,0
2020-08-19,G,Total,35,98,512120,13038606219,4069376816,17107983035
2020-08-19,G,UG,3,3,721,8419434,902882,9322316
2020-08-19,LG1,Alumni,0,0,0,0,0,0
2020-08-19,LG1,Non-HKUST,0,0,0,0,0,0
2020-08-19,LG1,Others(HKUST),3,11,690824,23474304071,3869010643,27343314714
2020-08-19,LG1,RPG,5,5,1618,342431372,164273456,506704828
2020-08-19,LG1,Staff,25,134,89476,5463296953,3907952630,9371249583
2020-08-19,LG1,TPG,0,0,0,0,0,0
2020-08-19,LG1,Total,34,151,782638,29330666365,7944396723,37275063088
2020-08-19,LG1,UG,1,1,720,50633969,3159994,53793963
2020-08-19,LG3,Alumni,0,0,0,0,0,0
2020-08-19,LG3,Non-HKUST,3,4,0,3585936705,156980289,3742916994
2020-08-19,LG3,Others(HKUST),2,2,0,6584851,1805963,8390814
2020-08-19,LG3,RPG,70,81,8456,4741480780,700368619,5441849399
2020-08-19,LG3,Staff,60,159,16201,5067005215,1905729893,6972735108
2020-08-19,LG3,TPG,4,4,900,85223356,6013011,91236367
2020-08-19,LG3,Total,161,278,26815,15390985364,2891396791,18282382155
2020-08-19,LG3,UG,22,28,1258,1904754457,120499016,2025253473
2020-08-19,LG4,Alumni,1,1,0,1877453,329402,2206855
2020-08-19,LG4,Non-HKUST,2,2,181,405462869,23918903,429381772
2020-08-19,LG4,Others(HKUST),4,15,173698,26719699348,4020375696,30740075044
2020-08-19,LG4,RPG,80,92,8998,6673661857,1251291597,7924953454
2020-08-19,LG4,Staff,41,97,16907,8058882383,3534470747,11593353130
2020-08-19,LG4,TPG,2,2,0,5183777,3055486,8239263
2020-08-19,LG4,Total,149,264,219582,44958860437,9153405772,54112266209
2020-08-19,LG4,UG,19,55,19798,3094092750,319963941,3414056691
2020-08-20,1,Alumni,0,0,0,0,0,0
2020-08-20,1,Non-HKUST,1,1,0,898593754,20681105,919274859
2020-08-20,1,Others(HKUST),1,8,100753,5684163626,175931606713,181615770339
2020-08-20,1,RPG,0,0,0,0,0,0
2020-08-20,1,Staff,33,314,1080064,22355137344,5686931050,28042068394
2020-08-20,1,TPG,0,0,0,0,0,0
2020-08-20,1,Total,38,364,1240610,41406711300,182153636857,223560348157
2020-08-20,1,UG,3,41,59793,12468816576,514417989,12983234565
2020-08-20,All-Floors,Alumni,0,0,0,0,0,0
2020-08-20,All-Floors,Non-HKUST,9,60,25558,35482849857,2291461875,37774311732
2020-08-20,All-Floors,Others(HKUST),7,43,1404107,64655060282,185083037373,249738097655
2020-08-20,All-Floors,RPG,140,178,28223,44851539001,11565123437,56416662438
2020-08-20,All-Floors,Staff,158,1164,1906231,119154339574,34423521478,153577861052
2020-08-20,All-Floors,TPG,4,5,719,764960327,83544863,848505190
2020-08-20,All-Floors,Total,398,1855,3580696,560706714926,249729318991,810436033917
2020-08-20,All-Floors,UG,80,405,215858,295797965885,16282629965,312080595850
2020-08-20,G,Alumni,0,0,0,0,0,0
2020-08-20,G,Non-HKUST,4,18,9714,7636079219,213722604,7849801823
2020-08-20,G,Others(HKUST),2,5,346497,2642199093,304908007,2947107100
2020-08-20,G,RPG,3,6,1078,449651191,34703359,484354550
2020-08-20,G,Staff,42,268,577843,39470138243,10914111546,50384249789
2020-08-20,G,TPG,0,0,0,0,0,0
2020-08-20,G,Total,72,349,941613,73410593376,12441895908,85852489284
2020-08-20,G,UG,21,52,6481,23212525630,974450392,24186976022
2020-08-20,LG1,Alumni,0,0,0,0,0,0
2020-08-20,LG1,Non-HKUST,2,35,15483,25739587600,1980701303,27720288903
2020-08-20,LG1,Others(HKUST),2,16,782621,29569516889,4811057885,34380574774
2020-08-20,LG1,RPG,15,16,5572,3968035932,1665790539,5633826471
2020-08-20,LG1,Staff,32,129,111323,17925906529,2458773891,20384680420
2020-08-20,LG1,TPG,1,2,719,518769865,68381735,587151600
2020-08-20,LG1,Total,69,354,1024810,145062781243,15879973933,160942755176
2020-08-20,LG1,UG,17,156,109092,67340964428,4895268580,72236233008
2020-08-20,LG3,Alumni,0,0,0,0,0,0
2020-08-20,LG3,Non-HKUST,5,5,361,1180252247,65187408,1245439655
2020-08-20,LG3,Others(HKUST),1,2,0,422180572,6659759,428840331
2020-08-20,LG3,RPG,90,96,13122,23386091294,7754046475,31140137769
2020-08-20,LG3,Staff,92,236,65711,19414804533,10069822707,29484627240
2020-08-20,LG3,TPG,2,2,0,239500689,14381220,253881909
2020-08-20,LG3,Total,231,424,98273,207042657323,25299681005,232342338328
2020-08-20,LG3,UG,41,83,19079,162399827988,7389583436,169789411424
2020-08-20,LG4,Alumni,0,0,0,0,0,0
2020-08-20,LG4,Non-HKUST,1,1,0,28337037,11169455,39506492
2020-08-20,LG4,Others(HKUST),4,12,174236,26337000102,4028805009,30365805111
2020-08-20,LG4,RPG,54,60,8451,17047760584,2110583064,19158343648
2020-08-20,LG4,Staff,61,217,71290,19988352925,5293882284,25282235209
2020-08-20,LG4,TPG,1,1,0,6689773,781908,7471681
2020-08-20,LG4,Total,151,364,275390,93783971684,13954131288,107738102972
2020-08-20,LG4,UG,30,73,21413,30375831263,2508909568,32884740831
2020-08-21,1,Alumni,0,0,0,0,0,0
2020-08-21,1,Non-HKUST,0,0,0,0,0,0
2020-08-21,1,Others(HKUST),3,6,231239,3618066323,21737170062,25355236385
2020-08-21,1,RPG,1,1,0,0,0,0
2020-08-21,1,Staff,35,358,818073,62263697217,5618406476,67882103693
2020-08-21,1,TPG,0,0,0,0,0,0
2020-08-21,1,Total,43,428,1105143,95273546216,28615737246,123889283462
2020-08-21,1,UG,4,63,55831,29391782676,1260160708,30651943384
2020-08-21,All-Floors,Alumni,2,2,7736,477431451,22946856,500378307
2020-08-21,All-Floors,Non-HKUST,2,4,13132,1955397115,54446121,2009843236
2020-08-21,All-Floors,Others(HKUST),10,49,1364509,52778456658,28489270054,81267726712
2020-08-21,All-Floors,RPG,88,111,22145,24589019946,2783671221,27372691167
2020-08-21,All-Floors,Staff,129,1049,1498869,172963452446,19835604037,192799056483
2020-08-21,All-Floors,TPG,6,8,0,656511667,34452257,690963924
2020-08-21,All-Floors,Total,285,1488,3043238,319338485746,54643917199,373982402945
2020-08-21,All-Floors,UG,48,265,136847,65918216463,3423526653,69341743116
2020-08-21,G,Alumni,0,0,0,0,0,0
2020-08-21,G,Non-HKUST,1,3,3238,162453235,31334385,193787620
2020-08-21,G,Others(HKUST),3,8,179283,2089063089,287051703,2376114792
2020-08-21,G,RPG,3,4,5762,521670441,19389015,541059456
2020-08-21,G,Staff,41,226,351287,54179237305,10906498165,65085735470
2020-08-21,G,TPG,1,3,0,141117,114542,255659
2020-08-21,G,Total,56,277,546050,66436886665,12219842557,78656729222
2020-08-21,G,UG,7,33,6480,9484321478,975454747,10459776225
2020-08-21,LG1,Alumni,0,0,0,0,0,0
2020-08-21,LG1,Non-HKUST,0,0,0,0,0,0
2020-08-21,LG1,Others(HKUST),2,13,863981,25790785962,4244768954,30035554916
2020-08-21,LG1,RPG,7,8,2518,3593464996,166892056,3760357052
2020-08-21,LG1,Staff,25,100,166919,4718906601,540253806,5259160407
2020-08-21,LG1,TPG,0,0,0,0,0,0
2020-08-21,LG1,Total,38,131,1064759,34428714048,5208487502,39637201550
2020-08-21,LG1,UG,4,10,31341,325556489,256572686,582129175
2020-08-21,LG3,Alumni,1,1,0,299913,188539,488452
2020-08-21,LG3,Non-HKUST,0,0,0,0,0,0
2020-08-21,LG3,Others(HKUST),1,3,0,1952801082,43146373,1995947455
2020-08-21,LG3,RPG,49,57,11884,11406973014,837754781,12244727795
2020-08-21,LG3,Staff,76,193,79354,32604918804,1589248311,34194167115
2020-08-21,LG3,TPG,1,1,0,1321056,267509,1588565
2020-08-21,LG3,Total,152,304,102759,50166800330,2651767048,52818567378
2020-08-21,LG3,UG,24,49,11521,4200486461,181161535,4381647996
2020-08-21,LG4,Alumni,1,1,7736,477131538,22758317,499889855
2020-08-21,LG4,Non-HKUST,1,1,9894,1792943880,23111736,1816055616
2020-08-21,LG4,Others(HKUST),7,19,90006,19327740202,2177132962,21504873164
2020-08-21,LG4,RPG,37,41,1981,9066911495,1759635369,10826546864
2020-08-21,LG4,Staff,47,172,83236,19196692519,1181197279,20377889798
2020-08-21,LG4,TPG,4,4,0,655049494,34070206,689119700
2020-08-21,LG4,Total,124,348,224527,73032538487,5948082846,78980621333
2020-08-21,LG4,UG,27,110,31674,22516069359,750176977,23266246336
2020-08-22,1,Alumni,0,0,0,0,0,0
2020-08-22,1,Non-HKUST,0,0,0,0,0,0
2020-08-22,1,Others(HKUST),2,4,345596,3325613068,247374600,3572987668
2020-08-22,1,RPG,2,2,1438,301297092,63248806,364545898
2020-08-22,1,Staff,4,30,446566,6330216783,250756234,6580973017
2020-08-22,1,TPG,0,0,0,0,0,0
2020-08-22,1,Total,8,36,793600,9957126943,561379640,10518506583
2020-08-22,1,UG,0,0,0,0,0,0
2020-08-22,All-Floors,Alumni,0,0,0,0,0,0
2020-08-22,All-Floors,Non-HKUST,1,1,0,296856369,21188451,318044820
2020-08-22,All-Floors,Others(HKUST),6,32,1554993,75834146661,10883256094,86717402755
2020-08-22,All-Floors,RPG,95,118,13852,27881234254,1380134164,29261368418
2020-08-22,All-Floors,Staff,40,87,672658,26466399704,5684207483,32150607187
2020-08-22,All-Floors,TPG,6,6,0,31172896,3655561,34828457
2020-08-22,All-Floors,Total,199,335,2262198,151287605961,19541326180,170828932141
2020-08-22,All-Floors,UG,51,91,20695,20777796077,1568884427,22346680504
2020-08-22,G,Alumni,0,0,0,0,0,0
2020-08-22,G,Non-HKUST,1,1,0,296856369,21188451,318044820
2020-08-22,G,Others(HKUST),1,2,172798,749106576,134208542,883315118
2020-08-22,G,RPG,5,6,540,732729726,53427458,786157184
2020-08-22,G,Staff,5,6,172798,17085880350,4906000552,21991880902
2020-08-22,G,TPG,0,0,0,0,0,0
2020-08-22,G,Total,12,15,346136,18864573021,5114825003,23979398024
2020-08-22,G,UG,0,0,0,0,0,0
2020-08-22,LG1,Alumni,0,0,0,0,0,0
2020-08-22,LG1,Non-HKUST,0,0,0,0,0,0
2020-08-22,LG1,Others(HKUST),1,10,863990,25443440580,4170655166,29614095746
2020-08-22,LG1,RPG,9,11,540,555834654,45945106,601779760
2020-08-22,LG1,Staff,4,4,900,4232330,1070038,5302368
2020-08-22,LG1,TPG,0,0,0,0,0,0
2020-08-22,LG1,Total,19,30,868489,26092912087,4223078362,30315990449
2020-08-22,LG1,UG,5,5,3059,89404523,5408052,94812575
2020-08-22,LG3,Alumni,0,0,0,0,0,0
2020-08-22,LG3,Non-HKUST,0,0,0,0,0,0
2020-08-22,LG3,Others(HKUST),3,8,179,2498838311,126435546,2625273857
2020-08-22,LG3,RPG,38,46,8095,8257745990,549535835,8807281825
2020-08-22,LG3,Staff,17,34,51852,1546924870,224336347,1771261217
2020-08-22,LG3,TPG,5,5,0,3309301,857868,4167169
2020-08-22,LG3,Total,91,123,61207,14063143317,1251466772,15314610089
2020-08-22,LG3,UG,28,30,1081,1756324845,350301176,2106626021
2020-08-22,LG4,Alumni,0,0,0,0,0,0
2020-08-22,LG4,Non-HKUST,0,0,0,0,0,0
2020-08-22,LG4,Others(HKUST),2,8,172430,43817148126,6204582240,50021730366
2020-08-22,LG4,RPG,47,53,3239,18033626792,667976959,18701603751
2020-08-22,LG4,Staff,11,13,542,1499145371,302044312,1801189683
2020-08-22,LG4,TPG,1,1,0,27863595,2797693,30661288
2020-08-22,LG4,Total,82,131,192766,82309850593,8390576403,90700426996
2020-08-22,LG4,UG,21,56,16555,18932066709,1213175199,20145241908
2020-08-23,1,Alumni,0,0,0,0,0,0
2020-08-23,1,Non-HKUST,0,0,0,0,0,0
2020-08-23,1,Others(HKUST),2,4,345596,3482260944,257390894,3739651838
2020-08-23,1,RPG,1,1,720,59607853,17781023,77388876
2020-08-23,1,Staff,4,32,363589,1613278653,106102176,1719380829
2020-08-23,1,TPG,0,0,0,0,0,0
2020-08-23,1,Total,7,37,709905,5155147450,381274093,5536421543
2020-08-23,1,UG,0,0,0,0,0,0
2020-08-23,All-Floors,Alumni,0,0,0,0,0,0
2020-08-23,All-Floors,Non-HKUST,3,3,900,35580127,8192556,43772683
2020-08-23,All-Floors,Others(HKUST),4,23,1469864,56933147774,8082855428,65016003202
2020-08-23,All-Floors,RPG,59,69,9718,9057428407,7055133134,16112561541
2020-08-23,All-Floors,Staff,30,90,555470,22484073892,5624685405,28108759297
2020-08-23,All-Floors,TPG,2,4,0,89093826,5961649,95055475
2020-08-23,All-Floors,Total,143,288,2065119,128158411705,22086934922,150245346627
2020-08-23,All-Floors,UG,45,99,29167,39559087679,1310106750,40869194429
2020-08-23,G,Alumni,0,0,0,0,0,0
2020-08-23,G,Non-HKUST,0,0,0,0,0,0
2020-08-23,G,Others(HKUST),1,2,172798,4317220,1605864,5923084
2020-08-23,G,RPG,1,1,0,1892928,8211929,10104857
2020-08-23,G,Staff,5,10,172798,17320940464,4908060770,22229001234
2020-08-23,G,TPG,0,0,0,0,0,0
2020-08-23,G,Total,7,13,345596,17327150612,4917878563,22245029175
2020-08-23,G,UG,0,0,0,0,0,0
2020-08-23,LG1,Alumni,0,0,0,0,0,0
2020-08-23,LG1,Non-HKUST,0,0,0,0,0,0
2020-08-23,LG1,Others(HKUST),1,9,777591,21989310205,3604831509,25594141714
2020-08-23,LG1,RPG,2,2,0,105710406,19328932,125039338
2020-08-23,LG1,Staff,5,16,17824,59461645,15858433,75320078
2020-08-23,LG1,TPG,0,0,0,0,0,0
2020-08-23,LG1,Total,9,28,796135,22154488099,3640022366,25794510465
2020-08-23,LG1,UG,1,1,720,5843,3492,9335
2020-08-23,LG3,Alumni,0,0,0,0,0,0
2020-08-23,LG3,Non-HKUST,2,2,900,24999932,4762421,29762353
2020-08-23,LG3,Others(HKUST),0,0,0,0,0,0
2020-08-23,LG3,RPG,33,34,7737,6402311852,692968448,7095280300
2020-08-23,LG3,Staff,14,21,1259,2418915942,278868241,2697784183
2020-08-23,LG3,TPG,1,2,0,7626798,1930183,9556981
2020-08-23,LG3,Total,65,76,10256,13584314147,1130116994,14714431141
2020-08-23,LG3,UG,15,17,360,4730459623,151587701,4882047324
2020-08-23,LG4,Alumni,0,0,0,0,0,0
2020-08-23,LG4,Non-HKUST,1,1,0,10580195,3430135,14010330
2020-08-23,LG4,Others(HKUST),2,8,173879,31457259405,4219027161,35676286566
2020-08-23,LG4,RPG,29,31,1261,2487905368,6316842802,8804748170
2020-08-23,LG4,Staff,10,11,0,1071477188,315795785,1387272973
2020-08-23,LG4,TPG,2,2,0,81467028,4031466,85498494
2020-08-23,LG4,Total,77,134,203227,69937311397,12017642906,81954954303
2020-08-23,LG4,UG,33,81,28087,34828622213,1158515557,35987137770
2020-08-24,1,Alumni,0,0,0,0,0,0
2020-08-24,1,Non-HKUST,0,0,0,0,0,0
2020-08-24,1,Others(HKUST),3,7,346857,3872376812,275256578,4147633390
2020-08-24,1,RPG,0,0,0,0,0,0
2020-08-24,1,Staff,34,377,842484,32095601904,17076222333,49171824237
2020-08-24,1,TPG,0,0,0,0,0,0
2020-08-24,1,Total,40,441,1266788,63420193750,18379388351,81799582101
2020-08-24,1,UG,3,57,77447,27452215034,1027909440,28480124474
2020-08-24,All-Floors,Alumni,2,4,5043,614778813,126064821,740843634
2020-08-24,All-Floors,Non-HKUST,4,11,4677,3511046568,114135621,3625182189
2020-08-24,All-Floors,Others(HKUST),10,40,1440145,61548197068,8620164156,70168361224
2020-08-24,All-Floors,RPG,126,152,22485,39778210669,3481514188,43259724857
2020-08-24,All-Floors,Staff,118,1120,1564891,106302212856,31430045643,137732258499
2020-08-24,All-Floors,TPG,11,17,7913,7019316220,779539488,7798855708
2020-08-24,All-Floors,Total,333,1632,3212187,357398309168,53537961545,410936270713
2020-08-24,All-Floors,UG,62,288,167033,138624546974,8986497628,147611044602
2020-08-24,G,Alumni,0,0,0,0,0,0
2020-08-24,G,Non-HKUST,2,8,4677,3510943754,113952482,3624896236
2020-08-24,G,Others(HKUST),2,4,141826,1089045231,21368009,1110413240
2020-08-24,G,RPG,6,7,360,1149343809,64755550,1214099359
2020-08-24,G,Staff,41,226,521266,27159522843,5855391146,33014913989
2020-08-24,G,TPG,0,0,0,0,0,0
2020-08-24,G,Total,55,275,678926,38253332115,6311568126,44564900241
2020-08-24,G,UG,4,30,10797,5344476478,256100939,5600577417
2020-08-24,LG1,Alumni,0,0,0,0,0,0
2020-08-24,LG1,Non-HKUST,0,0,0,0,0,0
2020-08-24,LG1,Others(HKUST),1,10,777222,25772752476,4229856684,30002609160
2020-08-24,LG1,RPG,3,3,720,682125865,376769327,1058895192
2020-08-24,LG1,Staff,22,131,125169,18863486198,3247777264,22111263462
2020-08-24,LG1,TPG,0,0,0,0,0,0
2020-08-24,LG1,Total,28,146,903832,45333211870,7856815756,53190027626
2020-08-24,LG1,UG,2,2,721,14847331,2412481,17259812
2020-08-24,LG3,Alumni,2,4,5043,614778813,126064821,740843634
2020-08-24,LG3,Non-HKUST,1,1,0,84665,55913,140578
2020-08-24,LG3,Others(HKUST),6,12,1081,4786302293,81819496,4868121789
2020-08-24,LG3,RPG,83,92,12599,25667032379,2070803057,27737835436
2020-08-24,LG3,Staff,71,214,38877,15718828788,2858932076,18577760864
2020-08-24,LG3,TPG,8,11,6293,3276021462,619847819,3895869281
2020-08-24,LG3,Total,206,401,100404,78004559907,7697946506,85702506413
2020-08-24,LG3,UG,35,67,36511,27941511507,1940423324,29881934831
2020-08-24,LG4,Alumni,0,0,0,0,0,0
2020-08-24,LG4,Non-HKUST,1,2,0,18149,127226,145375
2020-08-24,LG4,Others(HKUST),4,7,173159,26027720256,4011863389,30039583645
2020-08-24,LG4,RPG,46,50,8806,12279708616,969186254,13248894870
2020-08-24,LG4,Staff,49,172,37095,12464773123,2391722824,14856495947
2020-08-24,LG4,TPG,4,6,1620,3743294758,159691669,3902986427
2020-08-24,LG4,Total,134,369,262237,132387011526,13292242806,145679254332
2020-08-24,LG4,UG,30,132,41557,77871496624,5759651444,83631148068
2020-08-25,1,Alumni,0,0,0,0,0,0
2020-08-25,1,Non-HKUST,1,6,23417,385601431,17840311,403441742
2020-08-25,1,Others(HKUST),3,12,183079,2024621670,201054176,2225675846
2020-08-25,1,RPG,1,1,0,241675,94739,336414
2020-08-25,1,Staff,36,359,943577,26414297937,5686245565,32100543502
2020-08-25,1,TPG,0,0,0,0,0,0
2020-08-25,1,Total,45,439,1201968,68582483116,7771640563,76354123679
2020-08-25,1,UG,4,61,51895,39757720403,1866405772,41624126175
2020-08-25,All-Floors,Alumni,2,2,180,54522724,5959138,60481862
2020-08-25,All-Floors,Non-HKUST,6,15,26656,2455475752,8375636501,10831112253
2020-08-25,All-Floors,Others(HKUST),8,56,671532,32219547176,4985129191,37204676367
2020-08-25,All-Floors,RPG,91,109,25355,16810395255,2839016528,19649411783
2020-08-25,All-Floors,Staff,118,1150,1801279,78665074527,33708204569,112373279096
2020-08-25,All-Floors,TPG,2,7,7910,466421501,26805533,493227034
2020-08-25,All-Floors,Total,268,1519,2651432,205543561867,54488860675,260032422542
2020-08-25,All-Floors,UG,41,180,118520,74872124932,4548109215,79420234147
2020-08-25,G,Alumni,0,0,0,0,0,0
2020-08-25,G,Non-HKUST,3,5,3239,2050451579,8349366134,10399817713
2020-08-25,G,Others(HKUST),3,10,152998,63331257,9671664,73002921
2020-08-25,G,RPG,1,1,0,14784220,1844735,16628955
2020-08-25,G,Staff,46,289,628447,29838025773,6775046218,36613071991
2020-08-25,G,TPG,0,0,0,0,0,0
2020-08-25,G,Total,58,324,786309,35198174638,15341869439,50540044077
2020-08-25,G,UG,5,19,1625,3231581809,205940688,3437522497
2020-08-25,LG1,Alumni,0,0,0,0,0,0
2020-08-25,LG1,Non-HKUST,0,0,0,0,0,0
2020-08-25,LG1,Others(HKUST),3,17,295288,16536630284,2713771936,19250402220
2020-08-25,LG1,RPG,2,3,1439,7031563,572467,7604030
2020-08-25,LG1,Staff,21,155,154331,7527048233,19013198686,26540246919
2020-08-25,LG1,TPG,0,0,0,0,0,0
2020-08-25,LG1,Total,30,184,467438,24887306740,21795674282,46682981022
2020-08-25,LG1,UG,4,9,16380,816596660,68131193,884727853
2020-08-25,LG3,Alumni,1,1,0,50560722,4584180,55144902
2020-08-25,LG3,Non-HKUST,1,1,0,1729,6656,8385
2020-08-25,LG3,Others(HKUST),2,7,0,488360548,28640465,517001013
2020-08-25,LG3,RPG,56,64,12774,8788758846,1181099759,9969858605
2020-08-25,LG3,Staff,77,187,19630,8435534010,1259515790,9695049800
2020-08-25,LG3,TPG,2,5,7910,432656451,23218246,455874697
2020-08-25,LG3,Total,154,295,60115,20361256964,2583192649,22944449613
2020-08-25,LG3,UG,15,30,19801,2165384658,86127553,2251512211
2020-08-25,LG4,Alumni,1,1,180,3962002,1374958,5336960
2020-08-25,LG4,Non-HKUST,3,3,0,19421013,8423400,27844413
2020-08-25,LG4,Others(HKUST),4,10,40167,13106603417,2031990950,15138594367
2020-08-25,LG4,RPG,38,40,11142,7999578951,1655404828,9654983779
2020-08-25,LG4,Staff,40,160,55294,6450168574,974198310,7424366884
2020-08-25,LG4,TPG,1,2,0,33765050,3587287,37352337
2020-08-25,LG4,Total,108,277,135602,56514340409,6996483742,63510824151
2020-08-25,LG4,UG,21,61,28819,28900841402,2321504009,31222345411
2020-08-26,1,Alumni,0,0,0,0,0,0
2020-08-26,1,Non-HKUST,1,9,23411,907700236,2066132788,2973833024
2020-08-26,1,Others(HKUST),1,3,193154,1320245736,790110353,2110356089
2020-08-26,1,RPG,4,4,0,234128530,30658020,264786550
2020-08-26,1,Staff,32,330,960949,25430714842,12139327233,37570042075
2020-08-26,1,TPG,0,0,0,0,0,0
2020-08-26,1,Total,41,395,1224158,59974101127,16184348288,76158449415
2020-08-26,1,UG,3,49,46644,32081311783,1158119894,33239431677
2020-08-26,All-Floors,Alumni,2,2,0,10322100,3280678,13602778
2020-08-26,All-Floors,Non-HKUST,3,16,25930,1117798095,2097073516,3214871611
2020-08-26,All-Floors,Others(HKUST),9,23,541991,2509217187,1759533074,4268750261
2020-08-26,All-Floors,RPG,92,99,14929,30975207847,3677389657,34652597504
2020-08-26,All-Floors,Staff,108,974,1880286,99433393149,29780061373,129213454522
2020-08-26,All-Floors,TPG,4,4,180,1353983065,28559014,1382542079
2020-08-26,All-Floors,Total,265,1295,2579388,199888680773,40386117621,240274798394
2020-08-26,All-Floors,UG,47,177,116072,64488759330,3040220309,67528979639
2020-08-26,G,Alumni,0,0,0,0,0,0
2020-08-26,G,Non-HKUST,1,6,2519,203976221,30142111,234118332
2020-08-26,G,Others(HKUST),2,4,172978,144158910,507781165,651940075
2020-08-26,G,RPG,0,0,0,0,0,0
2020-08-26,G,Staff,42,228,670838,26407051453,5712014378,32119065831
2020-08-26,G,TPG,0,0,0,0,0,0
2020-08-26,G,Total,51,258,852102,40980501361,6544976552,47525477913
2020-08-26,G,UG,6,20,5767,14225314777,295038898,14520353675
2020-08-26,LG1,Alumni,0,0,0,0,0,0
2020-08-26,LG1,Non-HKUST,0,0,0,0,0,0
2020-08-26,LG1,Others(HKUST),1,2,172798,12942158,8554860,21497018
2020-08-26,LG1,RPG,1,1,0,178784533,8229308,187013841
2020-08-26,LG1,Staff,19,135,195213,8772319955,2686582326,11458902281
2020-08-26,LG1,TPG,0,0,0,0,0,0
2020-08-26,LG1,Total,23,147,370350,11214579483,2778749918,13993329401
2020-08-26,LG1,UG,2,9,2339,2250532837,75383424,2325916261
2020-08-26,LG3,Alumni,2,2,0,10322100,3280678,13602778
2020-08-26,LG3,Non-HKUST,1,1,0,6121638,798617,6920255
2020-08-26,LG3,Others(HKUST),4,6,899,201029739,11876089,212905828
2020-08-26,LG3,RPG,47,49,12593,16071819241,1675817825,17747637066
2020-08-26,LG3,Staff,72,202,24300,24002687964,6340029801,30342717765
2020-08-26,LG3,TPG,3,3,180,1270255683,17610867,1287866550
2020-08-26,LG3,Total,152,310,89032,53958979189,9263263168,63222242357
2020-08-26,LG3,UG,23,47,51060,12396742824,1213849291,13610592115
2020-08-26,LG4,Alumni,0,0,0,0,0,0
2020-08-26,LG4,Non-HKUST,0,0,0,0,0,0
2020-08-26,LG4,Others(HKUST),3,8,2162,830840644,441210607,1272051251
2020-08-26,LG4,RPG,42,45,2336,14490475543,1962684504,16453160047
2020-08-26,LG4,Staff,26,79,28986,14820618935,2902107635,17722726570
2020-08-26,LG4,TPG,1,1,0,83727382,10948147,94675529
2020-08-26,LG4,Total,96,185,43746,33760519613,5614779695,39375299308
2020-08-26,LG4,UG,24,52,10262,3534857109,297828802,3832685911
2020-08-27,1,Alumni,0,0,0,0,0,0
2020-08-27,1,Non-HKUST,0,0,0,0,0,0
2020-08-27,1,Others(HKUST),1,3,184511,125865662,57211145,183076807
2020-08-27,1,RPG,3,3,901,589852539,34214661,624067200
2020-08-27,1,Staff,38,423,1073717,26451004619,3760758788,30211763407
2020-08-27,1,TPG,0,0,0,0,0,0
2020-08-27,1,Total,44,447,1286147,30512569830,4207867618,34720437448
2020-08-27,1,UG,2,18,27018,3345847010,355683024,3701530034
2020-08-27,All-Floors,Alumni,4,8,1440,266867301,31435559,298302860
2020-08-27,All-Floors,Non-HKUST,3,11,8268,5522920867,303030977,5825951844
2020-08-27,All-Floors,Others(HKUST),6,35,539282,21471775892,846548355,22318324247
2020-08-27,All-Floors,RPG,88,107,36701,49936478951,4572948266,54509427217
2020-08-27,All-Floors,Staff,134,1235,1949715,122179548391,27659492406,149839040797
2020-08-27,All-Floors,TPG,4,10,5400,413392150,147284973,560677123
2020-08-27,All-Floors,Total,285,1589,2606512,266277597325,38650267741,304927865066
2020-08-27,All-Floors,UG,46,183,65706,66486613773,5089527205,71576140978
2020-08-27,G,Alumni,0,0,0,0,0,0
2020-08-27,G,Non-HKUST,1,9,8268,5064824746,193773612,5258598358
2020-08-27,G,Others(HKUST),3,6,175676,3334727970,135780583,3470508553
2020-08-27,G,RPG,3,3,0,331365926,28150752,359516678
2020-08-27,G,Staff,47,320,658118,26823494604,4636929596,31460424200
2020-08-27,G,TPG,0,0,0,0,0,0
2020-08-27,G,Total,56,363,842965,42356164499,5300323226,47656487725
2020-08-27,G,UG,2,25,903,6801751253,305688683,7107439936
2020-08-27,LG1,Alumni,0,0,0,0,0,0
2020-08-27,LG1,Non-HKUST,0,0,0,0,0,0
2020-08-27,LG1,Others(HKUST),1,2,172798,45873656,14494404,60368060
2020-08-27,LG1,RPG,1,1,0,8544,4297,12841
2020-08-27,LG1,Staff,20,98,93818,17842754353,4554611128,22397365481
2020-08-27,LG1,TPG,0,0,0,0,0,0
2020-08-27,LG1,Total,24,111,266796,30049891982,5126997743,35176889725
2020-08-27,LG1,UG,2,10,180,12161255429,557887914,12719143343
2020-08-27,LG3,Alumni,2,3,1081,119392829,14219311,133612140
2020-08-27,LG3,Non-HKUST,0,0,0,0,0,0
2020-08-27,LG3,Others(HKUST),4,16,359,12119795808,329567630,12449363438
2020-08-27,LG3,RPG,51,57,15119,18687046742,2695921415,21382968157
2020-08-27,LG3,Staff,83,263,97037,31017225919,12449253881,43466479800
2020-08-27,LG3,TPG,3,8,5040,401152188,77297994,478450182
2020-08-27,LG3,Total,168,395,140587,72020671430,16388419467,88409090897
2020-08-27,LG3,UG,25,48,21951,9676057944,822159236,10498217180
2020-08-27,LG4,Alumni,4,5,359,147474472,17216248,164690720
2020-08-27,LG4,Non-HKUST,2,2,0,458096121,109257365,567353486
2020-08-27,LG4,Others(HKUST),2,8,5938,5845512796,309494593,6155007389
2020-08-27,LG4,RPG,39,43,20681,30328205200,1814657141,32142862341
2020-08-27,LG4,Staff,43,131,27025,20045068896,2257939013,22303007909
2020-08-27,LG4,TPG,2,2,360,12239962,69986979,82226941
2020-08-27,LG4,Total,116,273,70017,91338299584,7626659687,98964959271
2020-08-27,LG4,UG,24,82,15654,34501702137,3048108348,37549810485
2020-08-28,1,Alumni,0,0,0,0,0,0
2020-08-28,1,Non-HKUST,0,0,0,0,0,0
2020-08-28,1,Others(HKUST),2,6,144891,128728671,36186479,164915150
2020-08-28,1,RPG,4,4,1441,3977981343,132926981,4110908324
2020-08-28,1,Staff,33,299,909523,21003756934,3230720261,24234477195
2020-08-28,1,TPG,0,0,0,0,0,0
2020-08-28,1,Total,42,352,1099082,67546194232,5169909203,72716103435
2020-08-28,1,UG,3,43,43227,42435727284,1770075482,44205802766
2020-08-28,All-Floors,Alumni,3,3,0,43546043,3195074,46741117
2020-08-28,All-Floors,Non-HKUST,2,2,360,120275136,10093312,130368448
2020-08-28,All-Floors,Others(HKUST),13,31,497876,2301377897,209991441,2511369338
2020-08-28,All-Floors,RPG,93,109,18368,29186471771,3216251973,32402723744
2020-08-28,All-Floors,Staff,128,871,1399955,67611001311,18663883398,86274884709
2020-08-28,All-Floors,TPG,4,6,0,175778912,13372181,189151093
2020-08-28,All-Floors,Total,290,1212,1986259,184517509339,26140477751,210657987090
2020-08-28,All-Floors,UG,47,190,69700,85079058269,4023690372,89102748641
2020-08-28,G,Alumni,0,0,0,0,0,0
2020-08-28,G,Non-HKUST,1,1,360,59901,46019,105920
2020-08-28,G,Others(HKUST),2,7,178567,246271489,43888114,290159603
2020-08-28,G,RPG,4,7,7923,3079233485,159388529,3238622014
2020-08-28,G,Staff,30,205,390301,10093770788,1669846116,11763616904
2020-08-28,G,TPG,0,0,0,0,0,0
2020-08-28,G,Total,40,242,585621,22666112795,2342226900,25008339695
2020-08-28,G,UG,3,22,8470,9246777132,469058122,9715835254
2020-08-28,LG1,Alumni,0,0,0,0,0,0
2020-08-28,LG1,Non-HKUST,0,0,0,0,0,0
2020-08-28,LG1,Others(HKUST),3,5,174418,106842769,21813197,128655966
2020-08-28,LG1,RPG,3,3,180,693836291,44667029,738503320
2020-08-28,LG1,Staff,14,79,52759,11628646875,10470349447,22098996322
2020-08-28,LG1,TPG,0,0,0,0,0,0
2020-08-28,LG1,Total,25,96,228256,19590838701,10784947926,30375786627
2020-08-28,LG1,UG,5,9,899,7161512766,248118253,7409631019
2020-08-28,LG3,Alumni,3,3,0,43546043,3195074,46741117
2020-08-28,LG3,Non-HKUST,1,1,0,120215235,10047293,130262528
2020-08-28,LG3,Others(HKUST),5,7,0,1751361493,92153418,1843514911
2020-08-28,LG3,RPG,61,68,3965,16224174023,2041131143,18265305166
2020-08-28,LG3,Staff,82,144,10085,16308155999,2220347251,18528503250
2020-08-28,LG3,TPG,2,2,0,95518394,7643530,103161924
2020-08-28,LG3,Total,182,282,17472,44688205390,4944115629,49632321019
2020-08-28,LG3,UG,28,57,3422,10145234203,569597920,10714832123
2020-08-28,LG4,Alumni,0,0,0,0,0,0
2020-08-28,LG4,Non-HKUST,0,0,0,0,0,0
2020-08-28,LG4,Others(HKUST),5,6,0,68173475,15950233,84123708
2020-08-28,LG4,RPG,27,27,4859,5211246629,838138291,6049384920
2020-08-28,LG4,Staff,45,144,37287,8576670715,1072620323,9649291038
2020-08-28,LG4,TPG,3,4,0,80260518,5728651,85989169
2020-08-28,LG4,Total,100,240,55828,30026158221,2899278093,32925436314
2020-08-28,LG4,UG,20,59,13682,16089806884,966840595,17056647479
2020-08-29,1,Alumni,0,0,0,0,0,0
2020-08-29,1,Non-HKUST,0,0,0,0,0,0
2020-08-29,1,Others(HKUST),2,3,172978,134197869,34937886,169135755
2020-08-29,1,RPG,2,2,0,1883966,1301160,3185126
2020-08-29,1,Staff,5,37,438107,593807672,71572065,665379737
2020-08-29,1,TPG,0,0,0,0,0,0
2020-08-29,1,Total,9,42,611085,729889507,107811111,837700618
2020-08-29,1,UG,0,0,0,0,0,0
2020-08-29,All-Floors,Alumni,1,1,0,122260197,3597851,125858048
2020-08-29,All-Floors,Non-HKUST,3,5,1621,238126833,19250331,257377164
2020-08-29,All-Floors,Others(HKUST),6,17,519295,1677401935,161956567,1839358502
2020-08-29,All-Floors,RPG,56,64,4497,12361964736,938521366,13300486102
2020-08-29,All-Floors,Staff,30,76,614506,5352171903,488815116,5840987019
2020-08-29,All-Floors,TPG,3,4,0,333471448,114073974,447545422
2020-08-29,All-Floors,Total,140,248,1157555,31652851624,2650167593,34303019217
2020-08-29,All-Floors,UG,41,81,17636,11567454572,923952388,12491406960
2020-08-29,G,Alumni,0,0,0,0,0,0
2020-08-29,G,Non-HKUST,1,3,1621,25101090,9902169,35003259
2020-08-29,G,Others(HKUST),1,2,172798,227885186,50255918,278141104
2020-08-29,G,RPG,1,1,0,114234,81381,195615
2020-08-29,G,Staff,7,11,173158,696646104,166665997,863312101
2020-08-29,G,TPG,0,0,0,0,0,0
2020-08-29,G,Total,18,37,353336,1424205298,297226658,1721431956
2020-08-29,G,UG,8,20,5759,474458684,70321193,544779877
2020-08-29,LG1,Alumni,0,0,0,0,0,0
2020-08-29,LG1,Non-HKUST,0,0,0,0,0,0
2020-08-29,LG1,Others(HKUST),2,3,172798,133811111,26919140,160730251
2020-08-29,LG1,RPG,4,4,720,779990514,33050685,813041199
2020-08-29,LG1,Staff,3,3,720,699222871,38935556,738158427
2020-08-29,LG1,TPG,0,0,0,0,0,0
2020-08-29,LG1,Total,11,12,175857,1639630141,108742543,1748372684
2020-08-29,LG1,UG,2,2,1619,26605645,9837162,36442807
2020-08-29,LG3,Alumni,0,0,0,0,0,0
2020-08-29,LG3,Non-HKUST,0,0,0,0,0,0
2020-08-29,LG3,Others(HKUST),0,0,0,0,0,0
2020-08-29,LG3,RPG,33,36,1979,10025838726,785826449,10811665175
2020-08-29,LG3,Staff,13,18,1082,3028994085,159704737,3188698822
2020-08-29,LG3,TPG,2,3,0,200356406,9471077,209827483
2020-08-29,LG3,Total,65,77,6482,13802571560,1003403775,14805975335
2020-08-29,LG3,UG,17,20,3421,547382343,48401512,595783855
2020-08-29,LG4,Alumni,1,1,0,122260197,3597851,125858048
2020-08-29,LG4,Non-HKUST,2,2,0,213025743,9348162,222373905
2020-08-29,LG4,Others(HKUST),2,9,721,1181507769,49843623,1231351392
2020-08-29,LG4,RPG,21,21,1798,1554137296,118261691,1672398987
2020-08-29,LG4,Staff,7,7,1439,333501171,51936761,385437932
2020-08-29,LG4,TPG,1,1,0,133115042,104602897,237717939
2020-08-29,LG4,Total,52,80,10795,14056555118,1132983506,15189538624
2020-08-29,LG4,UG,18,39,6837,10519007900,795392521,11314400421
2020-08-30,1,Alumni,0,0,0,0,0,0
2020-08-30,1,Non-HKUST,0,0,0,0,0,0
2020-08-30,1,Others(HKUST),1,2,172798,64329126,36209338,100538464
2020-08-30,1,RPG,0,0,0,0,0,0
2020-08-30,1,Staff,5,30,331558,454651914,28961116,483613030
2020-08-30,1,TPG,0,0,0,0,0,0
2020-08-30,1,Total,6,32,504356,518981040,65170454,584151494
2020-08-30,1,UG,0,0,0,0,0,0
2020-08-30,All-Floors,Alumni,1,1,0,124968640,13877827,138846467
2020-08-30,All-Floors,Non-HKUST,4,5,1261,439264867,36177085,475441952
2020-08-30,All-Floors,Others(HKUST),7,16,346137,3752534464,281548883,4034083347
2020-08-30,All-Floors,RPG,39,42,720,13823809386,739720181,14563529567
2020-08-30,All-Floors,Staff,29,71,425156,3367025049,313327377,3680352426
2020-08-30,All-Floors,TPG,5,5,0,425357706,32322907,457680613
2020-08-30,All-Floors,Total,118,186,775433,29437791512,3107482572,32545274084
2020-08-30,All-Floors,UG,33,46,2159,7504831400,1690508312,9195339712
2020-08-30,G,Alumni,0,0,0,0,0,0
2020-08-30,G,Non-HKUST,1,2,721,3593770,2779587,6373357
2020-08-30,G,Others(HKUST),1,1,86399,199166533,30516406,229682939
2020-08-30,G,RPG,0,0,0,0,0,0
2020-08-30,G,Staff,8,11,86579,476041008,101179793,577220801
2020-08-30,G,TPG,0,0,0,0,0,0
2020-08-30,G,Total,11,15,173699,678900706,134543913,813444619
2020-08-30,G,UG,1,1,0,99395,68127,167522
2020-08-30,LG1,Alumni,0,0,0,0,0,0
2020-08-30,LG1,Non-HKUST,0,0,0,0,0,0
2020-08-30,LG1,Others(HKUST),2,2,86399,71077340,16246172,87323512
2020-08-30,LG1,RPG,3,3,720,3439871,3686521,7126392
2020-08-30,LG1,Staff,2,2,0,2004637,1328351,3332988
2020-08-30,LG1,TPG,0,0,0,0,0,0
2020-08-30,LG1,Total,8,8,87839,125830829,25747962,151578791
2020-08-30,LG1,UG,1,1,720,49308981,4486918,53795899
2020-08-30,LG3,Alumni,1,1,0,124968640,13877827,138846467
2020-08-30,LG3,Non-HKUST,3,3,540,435671097,33397498,469068595
2020-08-30,LG3,Others(HKUST),3,6,361,2764928171,167603319,2932531490
2020-08-30,LG3,RPG,21,24,0,10148782350,465955333,10614737683
2020-08-30,LG3,Staff,12,22,4859,952311950,137736945,1090048895
2020-08-30,LG3,TPG,2,2,0,228254880,19358615,247613495
2020-08-30,LG3,Total,58,75,6300,16198195857,957871273,17156067130
2020-08-30,LG3,UG,16,17,540,1543278769,119941736,1663220505
2020-08-30,LG4,Alumni,0,0,0,0,0,0
2020-08-30,LG4,Non-HKUST,0,0,0,0,0,0
2020-08-30,LG4,Others(HKUST),2,5,180,653033294,30973648,684006942
2020-08-30,LG4,RPG,15,15,0,3671587165,270078327,3941665492
2020-08-30,LG4,Staff,6,6,2160,1482015540,44121172,1526136712
2020-08-30,LG4,TPG,3,3,0,197102826,12964292,210067118
2020-08-30,LG4,Total,42,56,3239,11915883080,1924148970,13840032050
2020-08-30,LG4,UG,16,27,899,5912144255,1566011531,7478155786
2020-08-31,1,Alumni,2,12,30783,3178759053,167757842,3346516895
2020-08-31,1,Non-HKUST,0,0,0,0,0,0
2020-08-31,1,Others(HKUST),2,3,172979,80118973,40288271,120407244
2020-08-31,1,RPG,24,133,406975,29828472419,1749961838,31578434257
2020-08-31,1,Staff,45,386,1157163,20688839500,2878152563,23566992063
2020-08-31,1,TPG,5,22,64656,10661588335,521483277,11183071612
2020-08-31,1,Total,90,587,1911064,70565519082,5883919357,76449438439
2020-08-31,1,UG,12,31,78508,6127740802,526275566,6654016368
2020-08-31,All-Floors,Alumni,11,124,214661,22025977595,3228822930,25254800525
2020-08-31,All-Floors,Non-HKUST,11,31,21958,10870384307,456693900,11327078207
2020-08-31,All-Floors,Others(HKUST),21,60,590764,34191771082,1057636605,35249407687
2020-08-31,All-Floors,RPG,171,806,1266569,193646430105,22067428031,215713858136
2020-08-31,All-Floors,Staff,207,1449,2237425,108007301817,16890048097,124897349914
2020-08-31,All-Floors,TPG,22,156,281289,41140788379,4293021538,45433809917
2020-08-31,All-Floors,Total,590,3789,6876817,708407641748,83271536774,791679178522
2020-08-31,All-Floors,UG,147,1163,2264151,298524988463,35277885673,333802874136
2020-08-31,G,Alumni,9,74,113998,14103454893,2303268196,16406723089
2020-08-31,G,Non-HKUST,4,15,7197,6782972731,260720675,7043693406
2020-08-31,G,Others(HKUST),8,20,211512,11441706456,415820549,11857527005
2020-08-31,G,RPG,95,265,286475,37997750300,6815516456,44813266756
2020-08-31,G,Staff,115,491,757035,24696267183,4774796096,29471063279
2020-08-31,G,TPG,16,62,66802,11058325356,1018063834,12076389190
2020-08-31,G,Total,343,1245,1702489,164455402324,20764895049,185220297373
2020-08-31,G,UG,96,318,259470,58374925405,5176709243,63551634648
2020-08-31,LG1,Alumni,5,37,68798,4743686924,757768948,5501455872
2020-08-31,LG1,Non-HKUST,4,11,14761,1671215683,90913763,1762129446
2020-08-31,LG1,Others(HKUST),7,18,205735,20608840387,337136774,20945977161
2020-08-31,LG1,RPG,41,174,267038,48479350091,5560456720,54039806811
2020-08-31,LG1,Staff,32,154,125709,11270215328,1060861007,12331076335
2020-08-31,LG1,TPG,6,24,36388,7783869598,775631746,8559501344
2020-08-31,LG1,Total,174,892,2076155,215619048095,18859356504,234478404599
2020-08-31,LG1,UG,79,474,1357726,121061870084,10276587546,131338457630
2020-08-31,LG3,Alumni,1,1,1082,76725,27944,104669
2020-08-31,LG3,Non-HKUST,3,3,0,1283717970,31064885,1314782855
2020-08-31,LG3,Others(HKUST),5,10,538,955198251,52029981,1007228232
2020-08-31,LG3,RPG,69,153,187624,43846216381,5901400504,49747616885
2020-08-31,LG3,Staff,97,205,70909,19372472962,5233221359,24605694321
2020-08-31,LG3,TPG,6,26,45559,3515394255,307173336,3822567591
2020-08-31,LG3,Total,225,533,484704,118266488281,14137102968,132403591249
2020-08-31,LG3,UG,44,135,178992,49293411737,2612184959,51905596696
2020-08-31,LG4,Alumni,0,0,0,0,0,0
2020-08-31,LG4,Non-HKUST,2,2,0,1132477923,73994577,1206472500
2020-08-31,LG4,Others(HKUST),6,9,0,1105907015,212361030,1318268045
2020-08-31,LG4,RPG,40,81,118457,33494640914,2040092513,35534733427
2020-08-31,LG4,Staff,61,213,126609,31979506844,2943017072,34922523916
2020-08-31,LG4,TPG,7,22,67884,8121610835,1670669345,9792280180
2020-08-31,LG4,Total,161,532,702405,139501183966,23626262896,163127446862
2020-08-31,LG4,UG,45,205,389455,63667040435,16686128359,80353168794
