Date,Floor,User-Group,User-Count,WiFi-Conn,Duration-Sec,Traffic-In-Byte,Traffic-Out-Byte,Traffic-Both-Byte
2022-03-01,1,Alumni,3,3,30,11415873,101185187,112601060
2022-03-01,1,Non-HKUST,2,2,6431,4026995,452817069,456844064
2022-03-01,1,Others(HKUST),2,3,45,252,124,376
2022-03-01,1,RPG,139,244,113948,106713307,3214326498,3321039805
2022-03-01,1,Staff,68,783,369650,130997282,2912552083,3043549365
2022-03-01,1,TPG,38,149,109347,48321044,1166253538,1214574582
2022-03-01,1,Total,376,1798,1174572,1522700247,50437003381,51959703628
2022-03-01,1,UG,124,614,575121,1221225494,42589868882,43811094376
2022-03-01,All-Floors,Alumni,9,274,129666,322331164,4253909386,4576240550
2022-03-01,All-Floors,Non-HKUST,31,276,200129,890246595,7042432255,7932678850
2022-03-01,All-Floors,Others(HKUST),17,104,331836,2532127,111599983,114132110
2022-03-01,All-Floors,RPG,470,2477,1207490,3839875458,58574800415,62414675873
2022-03-01,All-Floors,Staff,361,3266,808210,401736272,11843113327,12244849599
2022-03-01,All-Floors,TPG,117,2606,1967457,4229721801,74140197588,78369919389
2022-03-01,All-Floors,Total,1646,20252,13669520,35791475926,602359715600,638151191526
2022-03-01,All-Floors,UG,641,11249,9024732,26105032509,446393662646,472498695155
2022-03-01,G,Alumni,5,53,15552,80202182,173087020,253289202
2022-03-01,G,Non-HKUST,13,85,56175,145620277,2124000349,2269620626
2022-03-01,G,Others(HKUST),5,5,46137,28676,146600,175276
2022-03-01,G,RPG,151,584,214026,371669747,5774466656,6146136403
2022-03-01,G,Staff,130,536,184586,134496895,1897003607,2031500502
2022-03-01,G,TPG,75,676,166632,271176037,11050463466,11321639503
2022-03-01,G,Total,711,4296,1390831,2945188773,50877400672,53822589445
2022-03-01,G,UG,332,2357,707723,1941994959,29858232974,31800227933
2022-03-01,LG1,Alumni,3,35,1420,746678,919634,1666312
2022-03-01,LG1,Non-HKUST,9,114,117924,719343453,4009620418,4728963871
2022-03-01,LG1,Others(HKUST),7,16,178223,39762,36379,76141
2022-03-01,LG1,RPG,55,674,615147,1402845639,23956882002,25359727641
2022-03-01,LG1,Staff,113,529,98851,30129579,741847594,771977173
2022-03-01,LG1,TPG,53,833,832234,2463975733,25711003711,28174979444
2022-03-01,LG1,Total,478,7567,8433281,25771147874,356591231072,382362378946
2022-03-01,LG1,UG,238,5366,6589482,21154067030,302170921334,323324988364
2022-03-01,LG3,Alumni,5,32,33368,28249381,2099572515,2127821896
2022-03-01,LG3,Non-HKUST,19,46,18614,20948883,449998537,470947420
2022-03-01,LG3,Others(HKUST),8,41,1181,472224,2582799,3055023
2022-03-01,LG3,RPG,244,509,92959,963724546,12148957876,13112682422
2022-03-01,LG3,Staff,195,786,93612,54397752,5136456416,5190854168
2022-03-01,LG3,TPG,77,438,378447,569578722,21295079761,21864658483
2022-03-01,LG3,Total,943,3421,1149154,2356099317,61686107382,64042206699
2022-03-01,LG3,UG,395,1569,530973,718727809,20553459478,21272187287
2022-03-01,LG4,Alumni,5,151,79296,201717050,1879145030,2080862080
2022-03-01,LG4,Non-HKUST,19,29,985,306987,5995882,6302869
2022-03-01,LG4,Others(HKUST),9,39,106250,1991213,108834081,110825294
2022-03-01,LG4,RPG,246,466,171410,994922219,13480167383,14475089602
2022-03-01,LG4,Staff,163,632,61511,51714764,1155253627,1206968391
2022-03-01,LG4,TPG,67,510,480797,876670265,14917397112,15794067377
2022-03-01,LG4,Total,904,3170,1521682,3196339715,82767973093,85964312808
2022-03-01,LG4,UG,395,1343,621433,1069017217,51221179978,52290197195
2022-03-02,1,Alumni,1,1,20,1760,4402,6162
2022-03-02,1,Non-HKUST,9,9,9022,22284461,1591343258,1613627719
2022-03-02,1,Others(HKUST),1,1,10,0,0,0
2022-03-02,1,RPG,96,148,39545,79023006,3602609016,3681632022
2022-03-02,1,Staff,62,460,367748,129409705,3455734809,3585144514
2022-03-02,1,TPG,27,86,64720,30819086,2165367874,2196186960
2022-03-02,1,Total,297,1358,1133475,1347529564,55667603383,57015132947
2022-03-02,1,UG,101,653,652410,1085991546,44852544024,45938535570
2022-03-02,All-Floors,Alumni,10,106,136720,213018574,3209004343,3422022917
2022-03-02,All-Floors,Non-HKUST,37,524,510797,853513906,16214002324,17067516230
2022-03-02,All-Floors,Others(HKUST),11,94,344697,16704965,1372184393,1388889358
2022-03-02,All-Floors,RPG,403,2560,1014842,2687118351,79497779011,82184897362
2022-03-02,All-Floors,Staff,317,2611,730211,639923884,17370549986,18010473870
2022-03-02,All-Floors,TPG,118,2993,1813282,3486318387,72508538101,75994856488
2022-03-02,All-Floors,Total,1477,21457,13737001,29921332686,677855624808,707776957494
2022-03-02,All-Floors,UG,581,12569,9186452,22024734619,487683566650,509708301269
2022-03-02,G,Alumni,4,24,9171,96243200,297156421,393399621
2022-03-02,G,Non-HKUST,17,165,62999,76732097,2171986185,2248718282
2022-03-02,G,Others(HKUST),2,2,45537,0,0,0
2022-03-02,G,RPG,67,735,244862,373887243,31940537776,32314425019
2022-03-02,G,Staff,52,604,135734,87423714,2082862994,2170286708
2022-03-02,G,TPG,59,666,267504,196596110,6756547458,6953143568
2022-03-02,G,Total,458,4789,1354115,1956007805,94466918810,96422926615
2022-03-02,G,UG,257,2593,588308,1125125441,51217827976,52342953417
2022-03-02,LG1,Alumni,3,16,20494,43361806,143543213,186905019
2022-03-02,LG1,Non-HKUST,21,229,418520,748705305,12291409381,13040114686
2022-03-02,LG1,Others(HKUST),5,15,178646,3507639,15076834,18584473
2022-03-02,LG1,RPG,45,448,452122,1819502888,17438483922,19257986810
2022-03-02,LG1,Staff,101,475,148208,230816214,4413676711,4644492925
2022-03-02,LG1,TPG,46,887,944805,2123895335,45567969807,47691865142
2022-03-02,LG1,Total,489,8561,8712751,22532972682,361435151349,383968124031
2022-03-02,LG1,UG,268,6491,6549956,17563183495,281564991481,299128174976
2022-03-02,LG3,Alumni,6,18,37259,16400027,496793761,513193788
2022-03-02,LG3,Non-HKUST,19,56,12003,4020267,77906173,81926440
2022-03-02,LG3,Others(HKUST),6,30,1601,20728,65369,86097
2022-03-02,LG3,RPG,256,660,78286,133254693,18798652399,18931907092
2022-03-02,LG3,Staff,191,628,36238,41280333,4087938803,4129219136
2022-03-02,LG3,TPG,72,396,218326,753101612,10777012879,11530114491
2022-03-02,LG3,Total,937,3302,1057050,2133742223,69917724740,72051466963
2022-03-02,LG3,UG,387,1514,673337,1185664563,35679355356,36865019919
2022-03-02,LG4,Alumni,7,47,69776,57011781,2271506546,2328518327
2022-03-02,LG4,Non-HKUST,24,65,8253,1771776,81357327,83129103
2022-03-02,LG4,Others(HKUST),6,46,118903,13176598,1357042190,1370218788
2022-03-02,LG4,RPG,247,569,200027,281450521,7717495898,7998946419
2022-03-02,LG4,Staff,160,444,42283,150993918,3330336669,3481330587
2022-03-02,LG4,TPG,66,958,317927,381906244,7241640083,7623546327
2022-03-02,LG4,Total,900,3447,1479610,1951080412,96368226526,98319306938
2022-03-02,LG4,UG,390,1318,722441,1064769574,74368847813,75433617387
2022-03-03,1,Alumni,2,2,31,2528,5106,7634
2022-03-03,1,Non-HKUST,5,5,100,5267,23863,29130
2022-03-03,1,Others(HKUST),2,2,30,0,0,0
2022-03-03,1,RPG,106,145,7941,38924010,3074993277,3113917287
2022-03-03,1,Staff,57,673,466371,117353102,2919343559,3036696661
2022-03-03,1,TPG,28,251,162359,140928423,6057507555,6198435978
2022-03-03,1,Total,326,1645,1231947,1038441510,41792670395,42831111905
2022-03-03,1,UG,126,567,595115,741228180,29740797035,30482025215
2022-03-03,All-Floors,Alumni,9,302,184025,801533035,11400113518,12201646553
2022-03-03,All-Floors,Non-HKUST,31,176,117360,381681727,6783349476,7165031203
2022-03-03,All-Floors,Others(HKUST),14,93,352663,13633435,905848082,919481517
2022-03-03,All-Floors,RPG,429,2137,895544,2193612953,33125332398,35318945351
2022-03-03,All-Floors,Staff,310,2340,799700,683539384,9079446725,9762986109
2022-03-03,All-Floors,TPG,107,2881,1582319,4143937884,95969128679,100113066563
2022-03-03,All-Floors,Total,1522,20166,13049260,30002188305,629555044440,659557232745
2022-03-03,All-Floors,UG,622,12237,9117649,21784249887,472291825562,494076075449
2022-03-03,G,Alumni,7,115,66707,307376800,4033047864,4340424664
2022-03-03,G,Non-HKUST,8,59,43404,131371160,1821889703,1953260863
2022-03-03,G,Others(HKUST),3,4,46045,588783,39056620,39645403
2022-03-03,G,RPG,59,524,168887,213490274,7324801858,7538292132
2022-03-03,G,Staff,54,355,156374,86767564,1910454404,1997221968
2022-03-03,G,TPG,59,792,193377,318486620,8276347117,8594833737
2022-03-03,G,Total,468,4861,1492969,2526383101,50518126318,53044509419
2022-03-03,G,UG,278,3012,818175,1468301900,27112528752,28580830652
2022-03-03,LG1,Alumni,5,91,47455,442587527,5265340492,5707928019
2022-03-03,LG1,Non-HKUST,9,42,44841,234394827,4342452815,4576847642
2022-03-03,LG1,Others(HKUST),2,5,177634,868,1934,2802
2022-03-03,LG1,RPG,34,440,457679,1021485829,16172082856,17193568685
2022-03-03,LG1,Staff,100,381,95768,385905055,2511051982,2896957037
2022-03-03,LG1,TPG,54,915,699276,1568626814,46489837402,48058464216
2022-03-03,LG1,Total,447,8034,8065294,21127590296,403563239140,424690829436
2022-03-03,LG1,UG,243,6160,6542641,17474589376,328782471659,346257061035
2022-03-03,LG3,Alumni,6,13,24760,17120953,783647196,800768149
2022-03-03,LG3,Non-HKUST,17,33,22420,12309563,529833776,542143339
2022-03-03,LG3,Others(HKUST),8,27,655,117164,4287720,4404884
2022-03-03,LG3,RPG,285,511,89087,650443744,1799485113,2449928857
2022-03-03,LG3,Staff,195,573,62339,79169135,1012525149,1091694284
2022-03-03,LG3,TPG,55,336,261315,665285515,15150530532,15815816047
2022-03-03,LG3,Total,957,2738,1050867,2507683873,51557745129,54065429002
2022-03-03,LG3,UG,391,1245,590291,1083237799,32277435643,33360673442
2022-03-03,LG4,Alumni,5,81,45072,34445227,1318072860,1352518087
2022-03-03,LG4,Non-HKUST,20,37,6595,3600910,89149319,92750229
2022-03-03,LG4,Others(HKUST),8,55,128299,12926620,862501808,875428428
2022-03-03,LG4,RPG,285,517,171950,269269096,4753969294,5023238390
2022-03-03,LG4,Staff,147,358,18848,14344528,726071631,740416159
2022-03-03,LG4,TPG,51,587,265992,1450610512,19994906073,21445516585
2022-03-03,LG4,Total,929,2888,1208183,2802089525,82123263458,84925352983
2022-03-03,LG4,UG,413,1253,571427,1016892632,54378592473,55395485105
2022-03-04,1,Alumni,1,2,5,0,0,0
2022-03-04,1,Non-HKUST,0,0,0,0,0,0
2022-03-04,1,Others(HKUST),2,2,80,214212,450245,664457
2022-03-04,1,RPG,62,100,35002,39260049,902902017,942162066
2022-03-04,1,Staff,45,481,432456,175527947,8376540867,8552068814
2022-03-04,1,TPG,28,215,127828,66711129,4198356027,4265067156
2022-03-04,1,Total,243,1305,1093036,1020453214,42406707473,43427160687
2022-03-04,1,UG,105,505,497665,738739877,28928458317,29667198194
2022-03-04,All-Floors,Alumni,10,337,154604,416564711,3626327125,4042891836
2022-03-04,All-Floors,Non-HKUST,32,297,244274,569817229,14054814095,14624631324
2022-03-04,All-Floors,Others(HKUST),12,92,298861,16424982,1451869617,1468294599
2022-03-04,All-Floors,RPG,362,2552,1200527,2590234657,86028238101,88618472758
2022-03-04,All-Floors,Staff,290,2994,893873,1394009176,16570730572,17964739748
2022-03-04,All-Floors,TPG,107,2893,1825839,3441250629,77169904342,80611154971
2022-03-04,All-Floors,Total,1433,20435,12541654,27279750164,583353507448,610633257612
2022-03-04,All-Floors,UG,620,11270,7923676,18851448780,384451623596,403303072376
2022-03-04,G,Alumni,5,58,10739,43131566,387743033,430874599
2022-03-04,G,Non-HKUST,14,162,73390,117674738,2906114154,3023788892
2022-03-04,G,Others(HKUST),3,3,45531,524962,1346182,1871144
2022-03-04,G,RPG,66,554,188828,465777617,14446536142,14912313759
2022-03-04,G,Staff,55,646,177670,100108491,1632579469,1732687960
2022-03-04,G,TPG,57,754,292033,269275749,9233763254,9503039003
2022-03-04,G,Total,468,5127,1727309,2578145301,59247258630,61825403931
2022-03-04,G,UG,268,2950,939118,1581652178,30639176396,32220828574
2022-03-04,LG1,Alumni,2,45,23064,74417337,462061214,536478551
2022-03-04,LG1,Non-HKUST,14,77,144698,432457418,10065668090,10498125508
2022-03-04,LG1,Others(HKUST),3,5,137446,0,0,0
2022-03-04,LG1,RPG,49,717,619968,1712005742,60539181473,62251187215
2022-03-04,LG1,Staff,94,432,114408,962453859,4388516958,5350970817
2022-03-04,LG1,TPG,50,803,846477,1642987563,31442758362,33085745925
2022-03-04,LG1,Total,432,6847,6982766,17972928114,305346843564,323319771678
2022-03-04,LG1,UG,220,4768,5096705,13148606195,198448657467,211597263662
2022-03-04,LG3,Alumni,4,17,28565,12467917,405766753,418234670
2022-03-04,LG3,Non-HKUST,17,24,8388,11025449,295007014,306032463
2022-03-04,LG3,Others(HKUST),6,26,625,300136,2290491,2590627
2022-03-04,LG3,RPG,234,574,157597,119872665,2825994538,2945867203
2022-03-04,LG3,Staff,176,906,110959,74219129,1315751866,1389970995
2022-03-04,LG3,TPG,61,385,198678,138829619,5229029999,5367859618
2022-03-04,LG3,Total,880,3363,1098856,1463209033,43035453333,44498662366
2022-03-04,LG3,UG,382,1431,594044,1106494118,32961612672,34068106790
2022-03-04,LG4,Alumni,8,215,92231,286547891,2370756125,2657304016
2022-03-04,LG4,Non-HKUST,16,34,17798,8659624,788024837,796684461
2022-03-04,LG4,Others(HKUST),7,56,115179,15385672,1447782699,1463168371
2022-03-04,LG4,RPG,256,607,199132,253318584,7313623931,7566942515
2022-03-04,LG4,Staff,157,529,58380,81699750,857341412,939041162
2022-03-04,LG4,TPG,62,736,360823,1323446569,27065996700,28389443269
2022-03-04,LG4,Total,929,3793,1639687,4245014502,133317244448,137562258950
2022-03-04,LG4,UG,423,1616,796144,2275956412,93473718744,95749675156
2022-03-05,1,Alumni,1,1,15,573278,3955375,4528653
2022-03-05,1,Non-HKUST,3,4,65,0,0,0
2022-03-05,1,Others(HKUST),0,0,0,0,0,0
2022-03-05,1,RPG,51,109,104213,60825118,2981703982,3042529100
2022-03-05,1,Staff,32,124,114505,35358091,963136745,998494836
2022-03-05,1,TPG,20,75,36163,35889520,1704754703,1740644223
2022-03-05,1,Total,165,604,516779,330565812,18793374917,19123940729
2022-03-05,1,UG,58,291,261818,197919805,13139824112,13337743917
2022-03-05,All-Floors,Alumni,15,153,165236,252206015,13001899173,13254105188
2022-03-05,All-Floors,Non-HKUST,28,159,91356,117710278,3888829494,4006539772
2022-03-05,All-Floors,Others(HKUST),7,59,337592,150265,446055,596320
2022-03-05,All-Floors,RPG,332,1526,682597,588356336,16824521528,17412877864
2022-03-05,All-Floors,Staff,183,825,268798,1090611580,3431804178,4522415758
2022-03-05,All-Floors,TPG,101,1730,1068511,2261775378,63057500964,65319276342
2022-03-05,All-Floors,Total,1135,10218,6218753,9498088364,333148036059,342646124423
2022-03-05,All-Floors,UG,469,5766,3604663,5187278512,232943034667,238130313179
2022-03-05,G,Alumni,6,29,655,350455,3594148,3944603
2022-03-05,G,Non-HKUST,7,59,4776,275887,3464139,3740026
2022-03-05,G,Others(HKUST),1,1,45504,0,0,0
2022-03-05,G,RPG,48,338,110945,232125281,4366757900,4598883181
2022-03-05,G,Staff,27,131,76222,964014901,1347674520,2311689421
2022-03-05,G,TPG,42,520,213380,627267140,20017740689,20645007829
2022-03-05,G,Total,302,2810,1065866,2598662363,51708387456,54307049819
2022-03-05,G,UG,171,1732,614384,774628699,25969156060,26743784759
2022-03-05,LG1,Alumni,7,26,49517,93041337,2079479924,2172521261
2022-03-05,LG1,Non-HKUST,7,35,74066,88975388,2843679547,2932654935
2022-03-05,LG1,Others(HKUST),2,5,190534,5315,14577,19892
2022-03-05,LG1,RPG,36,214,205813,173733336,5638611779,5812345115
2022-03-05,LG1,Staff,68,216,37542,24958657,621453224,646411881
2022-03-05,LG1,TPG,35,491,348726,442592789,15201974422,15644567211
2022-03-05,LG1,Total,270,2643,2429836,3305826972,107064255251,110370082223
2022-03-05,LG1,UG,115,1656,1523638,2482520150,80679041778,83161561928
2022-03-05,LG3,Alumni,9,34,65658,88546591,6658930701,6747477292
2022-03-05,LG3,Non-HKUST,19,28,9887,27439560,985745055,1013184615
2022-03-05,LG3,Others(HKUST),4,23,625,67297,82044,149341
2022-03-05,LG3,RPG,214,382,105064,37653675,1029800014,1067453689
2022-03-05,LG3,Staff,96,195,15878,3480398,105466040,108946438
2022-03-05,LG3,TPG,64,307,249685,336491032,18160374129,18496865161
2022-03-05,LG3,Total,719,1854,994563,1284586033,67841983853,69126569886
2022-03-05,LG3,UG,313,885,547766,790907480,40901585870,41692493350
2022-03-05,LG4,Alumni,9,63,49391,69694354,4255939025,4325633379
2022-03-05,LG4,Non-HKUST,18,33,2562,1019443,55940753,56960196
2022-03-05,LG4,Others(HKUST),7,30,100929,77653,349434,427087
2022-03-05,LG4,RPG,235,483,156562,84018926,2807647853,2891666779
2022-03-05,LG4,Staff,84,159,24651,62799533,394073649,456873182
2022-03-05,LG4,TPG,66,337,220557,819534897,7972657021,8792191918
2022-03-05,LG4,Total,755,2307,1211709,1978447184,87740034582,89718481766
2022-03-05,LG4,UG,336,1202,657057,941302378,72253426847,73194729225
2022-03-06,1,Alumni,0,0,0,0,0,0
2022-03-06,1,Non-HKUST,1,1,15,0,0,0
2022-03-06,1,Others(HKUST),1,1,5,0,0,0
2022-03-06,1,RPG,49,55,1761,145736,3755633,3901369
2022-03-06,1,Staff,18,36,17902,3078575,28865093,31943668
2022-03-06,1,TPG,16,17,235,6768,25532,32300
2022-03-06,1,Total,133,164,21039,4072107,82510820,86582927
2022-03-06,1,UG,48,54,1121,841028,49864562,50705590
2022-03-06,All-Floors,Alumni,2,19,7157,6840032,253577108,260417140
2022-03-06,All-Floors,Non-HKUST,15,38,3826,1125167,20781161,21906328
2022-03-06,All-Floors,Others(HKUST),6,69,422092,3425367,142158251,145583618
2022-03-06,All-Floors,RPG,260,644,27333,58963973,685058196,744022169
2022-03-06,All-Floors,Staff,127,453,60227,21144260,564424796,585569056
2022-03-06,All-Floors,TPG,67,232,42963,51748636,3961095343,4012843979
2022-03-06,All-Floors,Total,873,2672,729523,241753305,10238596144,10480349449
2022-03-06,All-Floors,UG,396,1217,165925,98505870,4611501289,4710007159
2022-03-06,G,Alumni,0,0,0,0,0,0
2022-03-06,G,Non-HKUST,1,1,625,996,2176,3172
2022-03-06,G,Others(HKUST),1,1,45498,0,0,0
2022-03-06,G,RPG,15,16,265,456076,24759556,25215632
2022-03-06,G,Staff,15,37,1910,458668,2949906,3408574
2022-03-06,G,TPG,6,6,235,104,124,228
2022-03-06,G,Total,83,110,50859,2611888,516869673,519481561
2022-03-06,G,UG,45,49,2326,1696044,489157911,490853955
2022-03-06,LG1,Alumni,0,0,0,0,0,0
2022-03-06,LG1,Non-HKUST,1,1,2231,1004828,18913863,19918691
2022-03-06,LG1,Others(HKUST),1,6,264340,0,0,0
2022-03-06,LG1,RPG,10,16,2727,48061149,188519493,236580642
2022-03-06,LG1,Staff,41,138,25246,9681952,351453822,361135774
2022-03-06,LG1,TPG,10,26,1920,61453,668782,730235
2022-03-06,LG1,Total,103,306,325140,64275701,713656526,777932227
2022-03-06,LG1,UG,40,119,28676,5466319,154100566,159566885
2022-03-06,LG3,Alumni,0,0,0,0,0,0
2022-03-06,LG3,Non-HKUST,11,15,300,254,424,678
2022-03-06,LG3,Others(HKUST),2,14,1396,83259,9277185,9360444
2022-03-06,LG3,RPG,176,272,9078,3350495,209163377,212513872
2022-03-06,LG3,Staff,68,123,8690,4142494,138387897,142530391
2022-03-06,LG3,TPG,46,85,7381,6314433,1141605317,1147919750
2022-03-06,LG3,Total,546,937,105017,68475818,3636367186,3704843004
2022-03-06,LG3,UG,243,428,78172,54584883,2137932986,2192517869
2022-03-06,LG4,Alumni,2,19,7157,6840032,253577108,260417140
2022-03-06,LG4,Non-HKUST,12,20,655,119089,1864698,1983787
2022-03-06,LG4,Others(HKUST),6,47,110853,3342108,132881066,136223174
2022-03-06,LG4,RPG,183,285,13502,6950517,258860137,265810654
2022-03-06,LG4,Staff,66,119,6479,3782571,42768078,46550649
2022-03-06,LG4,TPG,48,98,33192,45365878,2818795588,2864161466
2022-03-06,LG4,Total,606,1155,227468,102317791,5289191939,5391509730
2022-03-06,LG4,UG,289,567,55630,35917596,1780445264,1816362860
2022-03-07,1,Alumni,2,2,10,0,0,0
2022-03-07,1,Non-HKUST,5,6,30741,40606384,3392618816,3433225200
2022-03-07,1,Others(HKUST),3,4,30,3496288,9214233,12710521
2022-03-07,1,RPG,93,131,66734,48706750,1445835959,1494542709
2022-03-07,1,Staff,69,686,354009,124806193,1760375436,1885181629
2022-03-07,1,TPG,23,75,73254,125721046,4248523004,4374244050
2022-03-07,1,Total,289,1655,1295942,1657365452,47006882812,48664248264
2022-03-07,1,UG,94,751,771164,1314028791,36150315364,37464344155
2022-03-07,All-Floors,Alumni,11,170,135097,347821560,6527473584,6875295144
2022-03-07,All-Floors,Non-HKUST,37,553,416357,2699570134,34894306562,37593876696
2022-03-07,All-Floors,Others(HKUST),15,98,371535,10399218,180280965,190680183
2022-03-07,All-Floors,RPG,356,1846,986756,1599658199,45389912334,46989570533
2022-03-07,All-Floors,Staff,299,2365,580047,547434847,9644946484,10192381331
2022-03-07,All-Floors,TPG,91,2474,1659024,3300255360,62798081655,66098337015
2022-03-07,All-Floors,Total,1344,20439,13781678,33340554551,563298328699,596638883250
2022-03-07,All-Floors,UG,535,12933,9632862,24835415233,403863327115,428698742348
2022-03-07,G,Alumni,5,87,56619,222376139,1355312973,1577689112
2022-03-07,G,Non-HKUST,11,117,11344,11343047,1316344380,1327687427
2022-03-07,G,Others(HKUST),4,5,46568,9355,186331,195686
2022-03-07,G,RPG,57,347,157606,266534509,15857577239,16124111748
2022-03-07,G,Staff,50,548,91076,125505739,1832068088,1957573827
2022-03-07,G,TPG,56,682,318415,839969670,12407630653,13247600323
2022-03-07,G,Total,438,4800,1526638,3945432776,59906743944,63852176720
2022-03-07,G,UG,255,3014,845010,2479694317,27137624280,29617318597
2022-03-07,LG1,Alumni,4,27,20536,56989875,967915316,1024905191
2022-03-07,LG1,Non-HKUST,24,343,337780,2556407817,28898604699,31455012516
2022-03-07,LG1,Others(HKUST),3,10,264414,1304756,2914123,4218879
2022-03-07,LG1,RPG,38,468,465937,986054088,17324894854,18310948942
2022-03-07,LG1,Staff,87,276,59634,159139126,3252743711,3411882837
2022-03-07,LG1,TPG,41,1142,895318,1972794447,25215924262,27188718709
2022-03-07,LG1,Total,428,8530,8616539,24359471037,346934599652,371294070689
2022-03-07,LG1,UG,231,6264,6572920,18626780928,271271602687,289898383615
2022-03-07,LG3,Alumni,5,22,19021,21472482,889047969,910520451
2022-03-07,LG3,Non-HKUST,16,34,34040,68975780,1037217651,1106193431
2022-03-07,LG3,Others(HKUST),7,33,5204,2933030,97422759,100355789
2022-03-07,LG3,RPG,211,460,98736,76719560,2044465408,2121184968
2022-03-07,LG3,Staff,173,425,16988,8118814,299257447,307376261
2022-03-07,LG3,TPG,55,207,205919,153916916,12009611211,12163528127
2022-03-07,LG3,Total,822,2651,1169131,1487783887,48952512212,50440296099
2022-03-07,LG3,UG,355,1470,789223,1155647305,32575489767,33731137072
2022-03-07,LG4,Alumni,5,32,38911,46983064,3315197326,3362180390
2022-03-07,LG4,Non-HKUST,19,53,2452,22237106,249521016,271758122
2022-03-07,LG4,Others(HKUST),7,46,55319,2655789,70543519,73199308
2022-03-07,LG4,RPG,217,440,197743,221643292,8717138874,8938782166
2022-03-07,LG4,Staff,148,430,58340,129864975,2500501802,2630366777
2022-03-07,LG4,TPG,52,368,166118,207853281,8916392525,9124245806
2022-03-07,LG4,Total,846,2803,1173428,1890501399,60497590079,62388091478
2022-03-07,LG4,UG,398,1434,654545,1259263892,36728295017,37987558909
2022-03-08,1,Alumni,3,3,110,25106,53020,78126
2022-03-08,1,Non-HKUST,6,37,2211,568719,11348352,11917071
2022-03-08,1,Others(HKUST),6,7,105,8782,11035,19817
2022-03-08,1,RPG,102,233,133654,88669358,2568211548,2656880906
2022-03-08,1,Staff,60,487,305865,101496630,1620429902,1721926532
2022-03-08,1,TPG,23,44,33086,49982581,1268096774,1318079355
2022-03-08,1,Total,320,1577,1052970,733167253,37477465380,38210632633
2022-03-08,1,UG,120,766,577939,492416077,32009314749,32501730826
2022-03-08,All-Floors,Alumni,9,239,120738,445379120,6624817541,7070196661
2022-03-08,All-Floors,Non-HKUST,39,570,324373,637834374,12697444555,13335278929
2022-03-08,All-Floors,Others(HKUST),12,134,386859,16117424,3274326317,3290443741
2022-03-08,All-Floors,RPG,347,2246,1194481,2649554213,47278866526,49928420739
2022-03-08,All-Floors,Staff,251,2383,647979,940767540,14098815985,15039583525
2022-03-08,All-Floors,TPG,108,2493,1645135,8366114322,64366632990,72732747312
2022-03-08,All-Floors,Total,1348,20970,13509442,41773627030,562127106548,603900733578
2022-03-08,All-Floors,UG,582,12905,9189877,28717860037,413786202634,442504062671
2022-03-08,G,Alumni,6,94,44442,337884164,1960562773,2298446937
2022-03-08,G,Non-HKUST,13,253,75144,107414972,3137896429,3245311401
2022-03-08,G,Others(HKUST),2,2,45500,3546,3337,6883
2022-03-08,G,RPG,67,563,254675,1013441235,12814925222,13828366457
2022-03-08,G,Staff,54,585,160084,316842801,3226523449,3543366250
2022-03-08,G,TPG,59,872,406931,990776451,13275740910,14266517361
2022-03-08,G,Total,462,5568,2215118,7018955104,72104909601,79123864705
2022-03-08,G,UG,261,3199,1228342,4252591935,37689257481,41941849416
2022-03-08,LG1,Alumni,1,78,22250,47797346,1707191745,1754989091
2022-03-08,LG1,Non-HKUST,14,181,232653,456925351,8167005037,8623930388
2022-03-08,LG1,Others(HKUST),1,6,216070,0,0,0
2022-03-08,LG1,RPG,47,550,509727,1073935139,21087837812,22161772951
2022-03-08,LG1,Staff,65,380,80800,395386589,3603809071,3999195660
2022-03-08,LG1,TPG,44,812,700177,6699990914,23680937674,30380928588
2022-03-08,LG1,Total,410,8189,7886164,28805468960,356170867618,384976336578
2022-03-08,LG1,UG,238,6182,6124487,20131433621,297924086279,318055519900
2022-03-08,LG3,Alumni,5,18,19899,19915688,1259990507,1279906195
2022-03-08,LG3,Non-HKUST,25,59,10486,71568602,643006558,714575160
2022-03-08,LG3,Others(HKUST),7,46,1636,2450512,306934905,309385417
2022-03-08,LG3,RPG,211,457,163728,166094828,2942443733,3108538561
2022-03-08,LG3,Staff,155,555,64313,67696465,4863538083,4931234548
2022-03-08,LG3,TPG,70,339,292352,270395692,9645393495,9915789187
2022-03-08,LG3,Total,855,2782,1113601,3384336956,39391257175,42775594131
2022-03-08,LG3,UG,382,1308,561187,2786215169,19729949894,22516165063
2022-03-08,LG4,Alumni,4,46,34037,39756816,1697019496,1736776312
2022-03-08,LG4,Non-HKUST,24,40,3879,1356730,738188179,739544909
2022-03-08,LG4,Others(HKUST),8,73,123548,13654584,2967377040,2981031624
2022-03-08,LG4,RPG,209,443,132697,307413653,7865448211,8172861864
2022-03-08,LG4,Staff,139,376,36917,59345055,784515480,843860535
2022-03-08,LG4,TPG,59,426,212589,354968684,16496464137,16851432821
2022-03-08,LG4,Total,837,2854,1241589,1831698757,56982606774,58814305531
2022-03-08,LG4,UG,394,1450,697922,1055203235,26433594231,27488797466
2022-03-09,1,Alumni,2,2,51,165580,2558164,2723744
2022-03-09,1,Non-HKUST,5,8,17526,35200168,1209214220,1244414388
2022-03-09,1,Others(HKUST),3,5,175,13908,169791,183699
2022-03-09,1,RPG,108,140,36237,37501349,2329876878,2367378227
2022-03-09,1,Staff,69,564,367151,186551109,3259877418,3446428527
2022-03-09,1,TPG,25,229,190233,259160221,10048043006,10307203227
2022-03-09,1,Total,337,1636,1299755,1400467100,50353658669,51754125769
2022-03-09,1,UG,125,688,688382,881874765,33503919192,34385793957
2022-03-09,All-Floors,Alumni,5,84,95909,296259797,9959491769,10255751566
2022-03-09,All-Floors,Non-HKUST,41,448,393806,1682035805,28965469352,30647505157
2022-03-09,All-Floors,Others(HKUST),10,90,339720,44224606,593739175,637963781
2022-03-09,All-Floors,RPG,372,1879,889018,2078956709,45270087228,47349043937
2022-03-09,All-Floors,Staff,281,2627,743892,734790528,20710185176,21444975704
2022-03-09,All-Floors,TPG,101,3506,1969155,4658814534,91885628189,96544442723
2022-03-09,All-Floors,Total,1355,22184,12970179,28054370801,630384871474,658439242275
2022-03-09,All-Floors,UG,545,13550,8538679,18559288822,433000270585,451559559407
2022-03-09,G,Alumni,4,27,20818,158318558,187268128,345586686
2022-03-09,G,Non-HKUST,12,113,45463,334259119,1814885229,2149144348
2022-03-09,G,Others(HKUST),1,1,10,0,0,0
2022-03-09,G,RPG,54,391,236800,386427946,10848942213,11235370159
2022-03-09,G,Staff,55,515,145639,137612978,8175632401,8313245379
2022-03-09,G,TPG,57,711,276968,1320966375,10763512237,12084478612
2022-03-09,G,Total,427,5146,1301882,3756734114,55396172079,59152906193
2022-03-09,G,UG,244,3388,576184,1419149138,23605931871,25025081009
2022-03-09,LG1,Alumni,2,4,140,2641,4510,7151
2022-03-09,LG1,Non-HKUST,20,216,275130,498972846,16680094812,17179067658
2022-03-09,LG1,Others(HKUST),1,7,200549,1734112,3772225,5506337
2022-03-09,LG1,RPG,39,480,444557,1454049617,23495047106,24949096723
2022-03-09,LG1,Staff,69,299,106491,285300987,6025086728,6310387715
2022-03-09,LG1,TPG,53,1149,890477,1471461702,45086645055,46558106757
2022-03-09,LG1,Total,413,8230,7515870,17412509926,385672467896,403084977822
2022-03-09,LG1,UG,229,6075,5598526,13700988021,294381817460,308082805481
2022-03-09,LG3,Alumni,2,11,16306,14132456,599457390,613589846
2022-03-09,LG3,Non-HKUST,25,49,24269,188733157,2838963217,3027696374
2022-03-09,LG3,Others(HKUST),4,20,740,26468935,320041792,346510727
2022-03-09,LG3,RPG,209,390,57044,89176537,2711376723,2800553260
2022-03-09,LG3,Staff,188,727,76983,61921895,1719943354,1781865249
2022-03-09,LG3,TPG,56,489,200855,201560200,4964119758,5165679958
2022-03-09,LG3,Total,847,3272,1206639,1658397749,51631865588,53290263337
2022-03-09,LG3,UG,363,1586,830442,1076404569,38477963354,39554367923
2022-03-09,LG4,Alumni,4,40,58594,123640562,9170203577,9293844139
2022-03-09,LG4,Non-HKUST,22,62,31418,624870515,6422311874,7047182389
2022-03-09,LG4,Others(HKUST),7,57,138246,16007651,269755367,285763018
2022-03-09,LG4,RPG,233,478,114380,111801260,5884844308,5996645568
2022-03-09,LG4,Staff,152,522,47628,63403559,1529645275,1593048834
2022-03-09,LG4,TPG,64,928,410622,1405666036,21023308133,22428974169
2022-03-09,LG4,Total,851,3900,1646033,3826261912,87330707242,91156969154
2022-03-09,LG4,UG,369,1813,845145,1480872329,43030638708,44511511037
2022-03-10,1,Alumni,3,3,761,4293,10852,15145
2022-03-10,1,Non-HKUST,8,12,14238,77582562,1032977269,1110559831
2022-03-10,1,Others(HKUST),7,13,82489,4919,14826,19745
2022-03-10,1,RPG,132,183,62922,74188946,3068274383,3142463329
2022-03-10,1,Staff,60,392,170000,89537555,850703269,940240824
2022-03-10,1,TPG,40,106,79681,92577884,5389298066,5481875950
2022-03-10,1,Total,415,1528,1094260,1246302869,45055077743,46301380612
2022-03-10,1,UG,165,819,684169,912406710,34713799078,35626205788
2022-03-10,All-Floors,Alumni,10,90,55790,35251779,3998585770,4033837549
2022-03-10,All-Floors,Non-HKUST,40,425,310344,825185442,16016639245,16841824687
2022-03-10,All-Floors,Others(HKUST),16,170,578543,57233036,864476348,921709384
2022-03-10,All-Floors,RPG,379,2854,1249264,2432407734,76810598726,79243006460
2022-03-10,All-Floors,Staff,258,1810,489956,848058895,10307941408,11156000303
2022-03-10,All-Floors,TPG,109,2719,1496623,3104019020,58255128105,61359147125
2022-03-10,All-Floors,Total,1394,21769,13836655,34078904748,681505276711,715584181459
2022-03-10,All-Floors,UG,582,13701,9656135,26776748842,515251907109,542028655951
2022-03-10,G,Alumni,2,28,400,1107067,812947066,814054133
2022-03-10,G,Non-HKUST,16,116,36127,56274929,1311944664,1368219593
2022-03-10,G,Others(HKUST),4,4,63574,7146135,44674387,51820522
2022-03-10,G,RPG,55,545,220214,462538339,6931095012,7393633351
2022-03-10,G,Staff,34,591,193303,198467515,5697702001,5896169516
2022-03-10,G,TPG,44,630,196650,303253049,8192132878,8495385927
2022-03-10,G,Total,402,5570,1498757,3722976987,46655201887,50378178874
2022-03-10,G,UG,247,3656,788489,2694189953,23664705879,26358895832
2022-03-10,LG1,Alumni,1,3,11903,15187255,1447794024,1462981279
2022-03-10,LG1,Non-HKUST,13,207,231752,639724245,11662013144,12301737389
2022-03-10,LG1,Others(HKUST),1,9,303213,23970915,81379292,105350207
2022-03-10,LG1,RPG,37,600,488139,808092117,38815560176,39623652293
2022-03-10,LG1,Staff,19,109,58832,19332513,1262524119,1281856632
2022-03-10,LG1,TPG,43,815,648344,1251870860,22277577391,23529448251
2022-03-10,LG1,Total,361,7908,8340605,21628345263,447741672801,469370018064
2022-03-10,LG1,UG,247,6165,6598422,18870167358,372194824655,391064992013
2022-03-10,LG3,Alumni,8,13,3612,109831,1070141,1179972
2022-03-10,LG3,Non-HKUST,25,46,26538,41284923,1596272160,1637557083
2022-03-10,LG3,Others(HKUST),6,35,789,31736,256060,287796
2022-03-10,LG3,RPG,224,534,213846,522748024,12537812807,13060560831
2022-03-10,LG3,Staff,167,410,44603,411238322,979899523,1391137845
2022-03-10,LG3,TPG,68,428,313715,377982286,8805366126,9183348412
2022-03-10,LG3,Total,876,2819,1227516,2662542785,59659488497,62322031282
2022-03-10,LG3,UG,378,1353,624413,1309147663,35738811680,37047959343
2022-03-10,LG4,Alumni,7,43,39114,18843333,1736763687,1755607020
2022-03-10,LG4,Non-HKUST,23,44,1689,10318783,413432008,423750791
2022-03-10,LG4,Others(HKUST),9,109,128478,26079331,738151783,764231114
2022-03-10,LG4,RPG,229,992,264143,564840308,15457856348,16022696656
2022-03-10,LG4,Staff,154,308,23218,129482990,1517112496,1646595486
2022-03-10,LG4,TPG,66,740,258233,1078334941,13590753644,14669088585
2022-03-10,LG4,Total,902,3944,1675517,4818736844,82393835783,87212572627
2022-03-10,LG4,UG,414,1708,960642,2990837158,48939765817,51930602975
2022-03-11,1,Alumni,0,0,0,0,0,0
2022-03-11,1,Non-HKUST,8,8,8577,10117723,392747896,402865619
2022-03-11,1,Others(HKUST),6,9,185,7391,109358,116749
2022-03-11,1,RPG,134,218,144857,135255153,4062733457,4197988610
2022-03-11,1,Staff,91,402,350798,87658935,2085184591,2172843526
2022-03-11,1,TPG,40,105,93057,86985040,3184554403,3271539443
2022-03-11,1,Total,450,1477,1114132,1108793645,45443956295,46552749940
2022-03-11,1,UG,171,735,516658,788769403,35718626590,36507395993
2022-03-11,All-Floors,Alumni,7,91,85016,65552429,1918291608,1983844037
2022-03-11,All-Floors,Non-HKUST,31,251,277722,466826909,11350260890,11817087799
2022-03-11,All-Floors,Others(HKUST),16,119,425845,73335614,2455674896,2529010510
2022-03-11,All-Floors,RPG,380,2840,1422345,5168100027,124569069690,129737169717
2022-03-11,All-Floors,Staff,279,2475,751823,515669418,35930233354,36445902772
2022-03-11,All-Floors,TPG,105,3292,1909535,3537786579,74153378597,77691165176
2022-03-11,All-Floors,Total,1410,20250,12710771,25768087107,684466781253,710234868360
2022-03-11,All-Floors,UG,592,11182,7838485,15940816131,434089872218,450030688349
2022-03-11,G,Alumni,4,28,3032,86627,252891,339518
2022-03-11,G,Non-HKUST,13,114,51234,42276132,1713574791,1755850923
2022-03-11,G,Others(HKUST),2,3,63574,0,0,0
2022-03-11,G,RPG,60,663,145805,690643493,4613972356,5304615849
2022-03-11,G,Staff,44,580,218334,212003541,7622494999,7834498540
2022-03-11,G,TPG,55,763,236167,258696834,5746942019,6005638853
2022-03-11,G,Total,405,5367,1392119,2090593870,48271572207,50362166077
2022-03-11,G,UG,227,3216,673973,886887243,28574335151,29461222394
2022-03-11,LG1,Alumni,2,13,21915,32599678,381916261,414515939
2022-03-11,LG1,Non-HKUST,10,53,169604,365635079,7624203730,7989838809
2022-03-11,LG1,Others(HKUST),1,5,215983,10100723,34569685,44670408
2022-03-11,LG1,RPG,46,863,872816,3961166228,101492709249,105453875477
2022-03-11,LG1,Staff,23,290,95941,146379259,24471133970,24617513229
2022-03-11,LG1,TPG,47,902,726989,1609980670,19224638834,20834619504
2022-03-11,LG1,Total,339,6696,7274887,17246995721,421309911569,438556907290
2022-03-11,LG1,UG,210,4570,5171639,11121134084,268080739840,279201873924
2022-03-11,LG3,Alumni,3,6,4401,5305783,229620090,234925873
2022-03-11,LG3,Non-HKUST,19,46,45467,48593039,1615789019,1664382058
2022-03-11,LG3,Others(HKUST),9,41,2261,28228670,945218819,973447489
2022-03-11,LG3,RPG,221,429,112092,146284379,6944156393,7090440772
2022-03-11,LG3,Staff,184,594,37058,19002458,354603075,373605533
2022-03-11,LG3,TPG,76,697,471990,655151206,17926281155,18581432361
2022-03-11,LG3,Total,889,3054,1279495,2154183290,61292187440,63446370730
2022-03-11,LG3,UG,377,1241,606226,1251617755,33276518889,34528136644
2022-03-11,LG4,Alumni,5,44,55668,27560341,1306502366,1334062707
2022-03-11,LG4,Non-HKUST,17,30,2840,204936,3945454,4150390
2022-03-11,LG4,Others(HKUST),9,61,143842,34998830,1475777034,1510775864
2022-03-11,LG4,RPG,237,667,146775,234750774,7455498235,7690249009
2022-03-11,LG4,Staff,167,609,49692,50625225,1396816719,1447441944
2022-03-11,LG4,TPG,68,825,381332,926972829,28070962186,28997935015
2022-03-11,LG4,Total,873,3656,1650138,3167520581,108149153742,111316674323
2022-03-11,LG4,UG,370,1420,869989,1892407646,68439651748,70332059394
2022-03-12,1,Alumni,1,15,29419,33490646,1789033068,1822523714
2022-03-12,1,Non-HKUST,3,3,30,0,0,0
2022-03-12,1,Others(HKUST),3,3,35,0,0,0
2022-03-12,1,RPG,85,120,48400,23306991,1986751803,2010058794
2022-03-12,1,Staff,37,82,54352,73459474,855969168,929428642
2022-03-12,1,TPG,22,264,264225,320697475,11888849558,12209547033
2022-03-12,1,Total,255,1067,802819,749416224,29093734781,29843151005
2022-03-12,1,UG,104,580,406358,298461638,12573131184,12871592822
2022-03-12,All-Floors,Alumni,7,91,71429,65072162,3225242013,3290314175
2022-03-12,All-Floors,Non-HKUST,15,151,104008,240948869,5759241190,6000190059
2022-03-12,All-Floors,Others(HKUST),13,148,460392,153282038,4408482869,4561764907
2022-03-12,All-Floors,RPG,307,1461,613099,1046433725,79198022490,80244456215
2022-03-12,All-Floors,Staff,155,1188,346340,386335639,18064876926,18451212565
2022-03-12,All-Floors,TPG,100,2551,1316146,1590590871,104092886395,105683477266
2022-03-12,All-Floors,Total,1059,13673,7296787,9980846725,395579963110,405560809835
2022-03-12,All-Floors,UG,462,8083,4385373,6498183421,180831211227,187329394648
2022-03-12,G,Alumni,2,24,680,21667,129057,150724
2022-03-12,G,Non-HKUST,6,55,21065,171231557,2926884641,3098116198
2022-03-12,G,Others(HKUST),3,3,101016,110328067,1753587421,1863915488
2022-03-12,G,RPG,46,293,52918,65273735,2663310454,2728584189
2022-03-12,G,Staff,35,489,189123,147551823,10031963355,10179515178
2022-03-12,G,TPG,53,775,212974,357611033,10387480057,10745091090
2022-03-12,G,Total,299,4144,1104454,1404308774,59181207988,60585516762
2022-03-12,G,UG,154,2505,526678,552290892,31417853003,31970143895
2022-03-12,LG1,Alumni,1,10,95,0,0,0
2022-03-12,LG1,Non-HKUST,5,38,66718,54560505,1836777767,1891338272
2022-03-12,LG1,Others(HKUST),1,5,215955,13443837,33837976,47281813
2022-03-12,LG1,RPG,22,212,236657,531833255,13193409868,13725243123
2022-03-12,LG1,Staff,14,76,46238,42911362,4147641488,4190552850
2022-03-12,LG1,TPG,37,549,216193,282511459,10089751476,10372262935
2022-03-12,LG1,Total,201,3581,3171432,4985343995,116111075429,121096419424
2022-03-12,LG1,UG,121,2691,2389576,4060083577,86809656854,90869740431
2022-03-12,LG3,Alumni,2,22,3587,501278,2382820,2884098
2022-03-12,LG3,Non-HKUST,9,15,476,247054,1367473,1614527
2022-03-12,LG3,Others(HKUST),8,41,1435,629488,12714557,13344045
2022-03-12,LG3,RPG,191,446,184538,227140405,52405116191,52632256596
2022-03-12,LG3,Staff,95,297,27880,109172490,101881893,211054383
2022-03-12,LG3,TPG,67,396,356481,264896458,17982100801,18246997259
2022-03-12,LG3,Total,662,2158,947811,919702357,87350496446,88270198803
2022-03-12,LG3,UG,290,941,373414,317115184,16844932711,17162047895
2022-03-12,LG4,Alumni,5,20,37648,31058571,1433697068,1464755639
2022-03-12,LG4,Non-HKUST,10,40,15719,14909753,994211309,1009121062
2022-03-12,LG4,Others(HKUST),7,96,141951,28880646,2608342915,2637223561
2022-03-12,LG4,RPG,202,390,90586,198879339,8949434174,9148313513
2022-03-12,LG4,Staff,84,244,28747,13240490,2927421022,2940661512
2022-03-12,LG4,TPG,64,567,266273,364874446,53744704503,54109578949
2022-03-12,LG4,Total,686,2723,1270271,1922075375,103843448466,105765523841
2022-03-12,LG4,UG,314,1366,689347,1270232130,33185637475,34455869605
2022-03-13,1,Alumni,1,1,55,0,0,0
2022-03-13,1,Non-HKUST,5,7,215,1686,9857,11543
2022-03-13,1,Others(HKUST),1,1,5,0,0,0
2022-03-13,1,RPG,86,112,2296,923538,4797903,5721441
2022-03-13,1,Staff,30,51,33354,1325077,17390280,18715357
2022-03-13,1,TPG,14,14,195,19644,8365,28009
2022-03-13,1,Total,200,267,39102,5102850,74086166,79189016
2022-03-13,1,UG,63,81,2982,2832905,51879761,54712666
2022-03-13,All-Floors,Alumni,5,24,12352,12548501,808045139,820593640
2022-03-13,All-Floors,Non-HKUST,26,99,89067,102771633,5568398655,5671170288
2022-03-13,All-Floors,Others(HKUST),8,35,471630,38395358,245762870,284158228
2022-03-13,All-Floors,RPG,274,967,302045,353210392,17982662718,18335873110
2022-03-13,All-Floors,Staff,141,486,119605,69884731,5378655695,5448540426
2022-03-13,All-Floors,TPG,60,736,619159,7545431833,54441868312,61987300145
2022-03-13,All-Floors,Total,940,6233,3997378,11823983295,189144973460,200968956755
2022-03-13,All-Floors,UG,426,3886,2383520,3701740847,104719580071,108421320918
2022-03-13,G,Alumni,0,0,0,0,0,0
2022-03-13,G,Non-HKUST,0,0,0,0,0,0
2022-03-13,G,Others(HKUST),3,3,127918,560,124,684
2022-03-13,G,RPG,8,10,930,8662,2149603,2158265
2022-03-13,G,Staff,12,38,1200,31249,46314,77563
2022-03-13,G,TPG,6,6,90,0,0,0
2022-03-13,G,Total,51,80,130814,41511,2196845,2238356
2022-03-13,G,UG,22,23,676,1040,804,1844
2022-03-13,LG1,Alumni,0,0,0,0,0,0
2022-03-13,LG1,Non-HKUST,8,50,86550,102636377,5553419785,5656056162
2022-03-13,LG1,Others(HKUST),1,5,215926,9022829,25430460,34453289
2022-03-13,LG1,RPG,14,320,270705,330019785,17019605010,17349624795
2022-03-13,LG1,Staff,12,85,59501,60333995,5229995098,5290329093
2022-03-13,LG1,TPG,29,564,595861,7497431361,49422226556,56919657917
2022-03-13,LG1,Total,171,3420,3387347,11275732130,155720472017,166996204147
2022-03-13,LG1,UG,107,2396,2158804,3276287783,78469795108,81746082891
2022-03-13,LG3,Alumni,2,2,70,0,0,0
2022-03-13,LG3,Non-HKUST,15,27,1505,52657,593504,646161
2022-03-13,LG3,Others(HKUST),2,5,75,356,248,604
2022-03-13,LG3,RPG,161,236,8358,5438221,243052705,248490926
2022-03-13,LG3,Staff,92,183,17919,2940942,59719174,62660116
2022-03-13,LG3,TPG,36,62,2767,3619064,965646291,969265355
2022-03-13,LG3,Total,602,1235,143481,118028918,5150064092,5268093010
2022-03-13,LG3,UG,294,720,112787,105977678,3881052170,3987029848
2022-03-13,LG4,Alumni,3,21,12227,12548501,808045139,820593640
2022-03-13,LG4,Non-HKUST,13,15,797,80913,14375509,14456422
2022-03-13,LG4,Others(HKUST),4,21,127706,29371613,220332038,249703651
2022-03-13,LG4,RPG,182,289,19756,16820186,713057497,729877683
2022-03-13,LG4,Staff,69,129,7631,5253468,71504829,76758297
2022-03-13,LG4,TPG,37,90,20246,44361764,4053987100,4098348864
2022-03-13,LG4,Total,623,1231,296634,425077886,28198154340,28623232226
2022-03-13,LG4,UG,315,666,108271,316641441,22316852228,22633493669
2022-03-14,1,Alumni,0,0,0,0,0,0
2022-03-14,1,Non-HKUST,8,10,28521,38134516,858772524,896907040
2022-03-14,1,Others(HKUST),5,7,515,2147,2266,4413
2022-03-14,1,RPG,95,135,43452,72157500,1352758954,1424916454
2022-03-14,1,Staff,68,433,330475,151461627,2257840952,2409302579
2022-03-14,1,TPG,18,43,42042,56473487,2005086170,2061559657
2022-03-14,1,Total,320,1359,1130599,1141538538,35977153112,37118691650
2022-03-14,1,UG,126,731,685594,823309261,29502692246,30326001507
2022-03-14,All-Floors,Alumni,10,182,198497,365808323,6807861572,7173669895
2022-03-14,All-Floors,Non-HKUST,41,296,271120,847046821,15429013279,16276060100
2022-03-14,All-Floors,Others(HKUST),17,97,452543,6779690,627504859,634284549
2022-03-14,All-Floors,RPG,358,2675,1218736,2969053497,64134188950,67103242447
2022-03-14,All-Floors,Staff,258,2453,826878,546194719,22294305444,22840500163
2022-03-14,All-Floors,TPG,94,3204,2046092,6957082413,129051582484,136008664897
2022-03-14,All-Floors,Total,1381,26258,17055473,41502443633,814850064383,856352508016
2022-03-14,All-Floors,UG,603,17351,12041607,29810478170,576505607795,606316085965
2022-03-14,G,Alumni,7,80,42391,151157270,696419299,847576569
2022-03-14,G,Non-HKUST,8,102,32306,107634449,768330663,875965112
2022-03-14,G,Others(HKUST),5,6,63624,0,0,0
2022-03-14,G,RPG,54,615,143368,276638823,4675850427,4952489250
2022-03-14,G,Staff,46,616,291005,193369228,7411146835,7604516063
2022-03-14,G,TPG,63,764,201099,280158536,74257980503,74538139039
2022-03-14,G,Total,462,5665,1524190,2826611626,117875469216,120702080842
2022-03-14,G,UG,279,3482,750397,1817653320,30065741489,31883394809
2022-03-14,LG1,Alumni,3,26,29024,77317072,916741478,994058550
2022-03-14,LG1,Non-HKUST,11,123,179098,629086948,10161443355,10790530303
2022-03-14,LG1,Others(HKUST),2,7,274330,409913,9308952,9718865
2022-03-14,LG1,RPG,40,873,665706,1926143937,43414265157,45340409094
2022-03-14,LG1,Staff,28,403,136813,148951509,11176679056,11325630565
2022-03-14,LG1,TPG,53,1406,1161946,5474864198,28545810406,34020674604
2022-03-14,LG1,Total,421,11863,11134195,32456724501,501658471366,534115195867
2022-03-14,LG1,UG,284,9025,8687278,24199950924,407434222962,431634173886
2022-03-14,LG3,Alumni,4,13,26800,28489142,713823625,742312767
2022-03-14,LG3,Non-HKUST,19,28,16338,42580036,2295850054,2338430090
2022-03-14,LG3,Others(HKUST),8,27,1641,126708,4364606,4491314
2022-03-14,LG3,RPG,220,438,94468,106393344,2210190841,2316584185
2022-03-14,LG3,Staff,168,553,44279,30576747,589138308,619715055
2022-03-14,LG3,TPG,65,394,288827,397890643,8525208205,8923098848
2022-03-14,LG3,Total,911,3279,1289488,1715415503,46753390749,48468806252
2022-03-14,LG3,UG,427,1826,817135,1109358883,32414815110,33524173993
2022-03-14,LG4,Alumni,7,63,100282,108844839,4480877170,4589722009
2022-03-14,LG4,Non-HKUST,26,33,14857,29610872,1344616683,1374227555
2022-03-14,LG4,Others(HKUST),12,50,112433,6240922,613829035,620069957
2022-03-14,LG4,RPG,228,614,271742,587719893,12481123571,13068843464
2022-03-14,LG4,Staff,161,448,24306,21835608,859500293,881335901
2022-03-14,LG4,TPG,64,597,352178,747695549,15717497200,16465192749
2022-03-14,LG4,Total,929,4092,1977001,3362153465,112585579940,115947733405
2022-03-14,LG4,UG,431,2287,1101203,1860205782,77088135988,78948341770
2022-03-15,1,Alumni,1,1,115,10674,19852,30526
2022-03-15,1,Non-HKUST,9,33,59785,241324944,1887148227,2128473171
2022-03-15,1,Others(HKUST),7,8,185,74897,321407,396304
2022-03-15,1,RPG,108,193,116251,401489587,9262385159,9663874746
2022-03-15,1,Staff,73,539,376752,140301865,2238601937,2378903802
2022-03-15,1,TPG,25,74,106273,162911223,12931286163,13094197386
2022-03-15,1,Total,366,1647,1463091,1982177511,75562472397,77544649908
2022-03-15,1,UG,143,799,803730,1036064321,49242709652,50278773973
2022-03-15,All-Floors,Alumni,10,151,173103,546568487,7904849025,8451417512
2022-03-15,All-Floors,Non-HKUST,38,509,457874,844406489,11773255300,12617661789
2022-03-15,All-Floors,Others(HKUST),20,126,430606,19217524,2348953438,2368170962
2022-03-15,All-Floors,RPG,363,2636,1574689,3346291046,89375130331,92721421377
2022-03-15,All-Floors,Staff,297,2812,855734,816554982,22689577890,23506132872
2022-03-15,All-Floors,TPG,113,3531,2312088,7863156422,134164003112,142027159534
2022-03-15,All-Floors,Total,1440,27969,18901157,48826210080,1000282703188,1049108913268
2022-03-15,All-Floors,UG,599,18204,13097063,35390015130,732026934092,767416949222
2022-03-15,G,Alumni,4,79,42370,268728560,1364135162,1632863722
2022-03-15,G,Non-HKUST,17,97,10175,4268491,14702800,18971291
2022-03-15,G,Others(HKUST),4,7,63703,8720,113972,122692
2022-03-15,G,RPG,65,596,213060,352889817,22328234788,22681124605
2022-03-15,G,Staff,65,642,198660,268228955,12924432876,13192661831
2022-03-15,G,TPG,71,946,416065,756091075,15166873659,15922964734
2022-03-15,G,Total,530,6639,1801145,3324657913,118324454381,121649112294
2022-03-15,G,UG,304,4272,857112,1674442295,66525961124,68200403419
2022-03-15,LG1,Alumni,2,12,38332,194910459,676284133,871194592
2022-03-15,LG1,Non-HKUST,22,299,343652,553534777,9398907415,9952442192
2022-03-15,LG1,Others(HKUST),1,6,246268,0,0,0
2022-03-15,LG1,RPG,43,889,892133,1786812370,35890951264,37677763634
2022-03-15,LG1,Staff,34,252,122900,102803801,5318075235,5420879036
2022-03-15,LG1,TPG,53,1334,1063774,5882666696,35485299409,41367966105
2022-03-15,LG1,Total,439,12124,12010210,37037412813,601548193717,638585606530
2022-03-15,LG1,UG,284,9332,9303151,28516684710,514778676261,543295360971
2022-03-15,LG3,Alumni,3,12,26878,29382956,1343304086,1372687042
2022-03-15,LG3,Non-HKUST,18,41,37519,39774736,329602767,369377503
2022-03-15,LG3,Others(HKUST),11,41,1280,60291,141498,201789
2022-03-15,LG3,RPG,211,465,170616,154349670,8859730598,9014080268
2022-03-15,LG3,Staff,204,807,124697,121955444,1358755496,1480710940
2022-03-15,LG3,TPG,70,525,392567,479062986,38173142331,38652205317
2022-03-15,LG3,Total,927,3654,1776883,2284925613,97227364255,99512289868
2022-03-15,LG3,UG,410,1763,1023326,1460339530,47162687479,48623027009
2022-03-15,LG4,Alumni,6,47,65408,53535838,4521105792,4574641630
2022-03-15,LG4,Non-HKUST,16,39,6743,5503541,142894091,148397632
2022-03-15,LG4,Others(HKUST),14,64,119170,19073616,2348376561,2367450177
2022-03-15,LG4,RPG,230,493,182629,650749602,13033828522,13684578124
2022-03-15,LG4,Staff,170,572,32725,183264917,849712346,1032977263
2022-03-15,LG4,TPG,73,652,333409,582424442,32407401550,32989825992
2022-03-15,LG4,Total,914,3905,1849828,4197036230,107620218438,111817254668
2022-03-15,LG4,UG,405,2038,1109744,2702484274,54316899576,57019383850
2022-03-16,1,Alumni,3,21,14270,20885199,290590918,311476117
2022-03-16,1,Non-HKUST,3,24,340,109334,22223088,22332422
2022-03-16,1,Others(HKUST),3,3,35,0,0,0
2022-03-16,1,RPG,71,93,31199,36019380,135407491,171426871
2022-03-16,1,Staff,65,297,339895,110809615,4827722103,4938531718
2022-03-16,1,TPG,17,168,119869,118977553,13242992782,13361970335
2022-03-16,1,Total,281,1303,1321753,1551234149,110279919712,111831153861
2022-03-16,1,UG,119,697,816145,1264433068,91760983330,93025416398
2022-03-16,All-Floors,Alumni,13,344,191502,1157835028,7049304671,8207139699
2022-03-16,All-Floors,Non-HKUST,55,727,438610,676109431,14515221941,15191331372
2022-03-16,All-Floors,Others(HKUST),21,178,410327,26409469,2310514304,2336923773
2022-03-16,All-Floors,RPG,526,3370,1676070,3739412072,76437581721,80176993793
2022-03-16,All-Floors,Staff,429,2865,834116,587315588,25384863581,25972179169
2022-03-16,All-Floors,TPG,147,3782,2182051,3602895175,115513572468,119116467643
2022-03-16,All-Floors,Total,1847,28853,17189165,33895623742,970308954379,1004204578121
2022-03-16,All-Floors,UG,656,17587,11456489,24105646979,729097895693,753203542672
2022-03-16,G,Alumni,6,133,21618,256410859,1556595923,1813006782
2022-03-16,G,Non-HKUST,22,292,36339,32901833,924519341,957421174
2022-03-16,G,Others(HKUST),4,10,63847,1204,2222,3426
2022-03-16,G,RPG,67,747,243859,345213152,8864588644,9209801796
2022-03-16,G,Staff,45,578,219237,200790776,7562492143,7763282919
2022-03-16,G,TPG,64,761,267698,230379094,6733907846,6964286940
2022-03-16,G,Total,471,6161,1614644,2379010789,56831748214,59210759003
2022-03-16,G,UG,263,3640,762046,1313313871,31189642095,32502955966
2022-03-16,LG1,Alumni,2,5,26588,56467705,1117500598,1173968303
2022-03-16,LG1,Non-HKUST,20,263,341367,563602807,11570384107,12133986914
2022-03-16,LG1,Others(HKUST),2,11,217461,403023,1590509,1993532
2022-03-16,LG1,RPG,49,998,1028352,2694413978,50872534619,53566948597
2022-03-16,LG1,Staff,23,454,143759,125142394,7571587914,7696730308
2022-03-16,LG1,TPG,56,1636,1193642,2403739102,52200649311,54604388413
2022-03-16,LG1,Total,411,12374,10962144,23545755089,539195611899,562741366988
2022-03-16,LG1,UG,259,9007,8010975,17701986080,415861364841,433563350921
2022-03-16,LG3,Alumni,10,42,42199,316330764,1772792239,2089123003
2022-03-16,LG3,Non-HKUST,41,114,25415,37574086,1053873994,1091448080
2022-03-16,LG3,Others(HKUST),18,59,4589,1445582,44285423,45731005
2022-03-16,LG3,RPG,481,1247,253926,449557230,12108830220,12558387450
2022-03-16,LG3,Staff,385,1191,70985,43727299,1304665306,1348392605
2022-03-16,LG3,TPG,126,763,416980,596025075,27730044531,28326069606
2022-03-16,LG3,Total,1643,6185,1879200,3541173483,141405848718,144947022201
2022-03-16,LG3,UG,582,2769,1065106,2096513447,97391357005,99487870452
2022-03-16,LG4,Alumni,7,143,86827,507740501,2311824993,2819565494
2022-03-16,LG4,Non-HKUST,11,34,35149,41921371,944221411,986142782
2022-03-16,LG4,Others(HKUST),5,95,124395,24559660,2264636150,2289195810
2022-03-16,LG4,RPG,110,285,118734,214208332,4456220747,4670429079
2022-03-16,LG4,Staff,96,345,60240,106845504,4118396115,4225241619
2022-03-16,LG4,TPG,41,454,183862,253774351,15605977998,15859752349
2022-03-16,LG4,Total,498,2830,1411424,2878450232,122595825836,125474276068
2022-03-16,LG4,UG,228,1474,802217,1729400513,92894548422,94623948935
2022-03-17,1,Alumni,2,2,15,0,0,0
2022-03-17,1,Non-HKUST,6,6,17277,24613309,732294622,756907931
2022-03-17,1,Others(HKUST),2,5,155,1122,5395,6517
2022-03-17,1,RPG,57,80,49261,47835697,2155679791,2203515488
2022-03-17,1,Staff,57,661,342330,119120438,3036155810,3155276248
2022-03-17,1,TPG,22,112,149553,74219863,5291973301,5366193164
2022-03-17,1,Total,264,1646,1258038,1909444558,57035155302,58944599860
2022-03-17,1,UG,118,780,699447,1643654129,45819046383,47462700512
2022-03-17,All-Floors,Alumni,11,123,83337,175073343,4258607816,4433681159
2022-03-17,All-Floors,Non-HKUST,51,377,385726,1037904041,19272971199,20310875240
2022-03-17,All-Floors,Others(HKUST),15,149,426074,20564606,1635721430,1656286036
2022-03-17,All-Floors,RPG,519,3093,1365712,2185963280,50722213617,52908176897
2022-03-17,All-Floors,Staff,382,2967,746324,1435028448,18940311739,20375340187
2022-03-17,All-Floors,TPG,125,2870,2084175,3439492011,106157559903,109597051914
2022-03-17,All-Floors,Total,1809,28042,17644854,37374499523,888321834160,925696333683
2022-03-17,All-Floors,UG,706,18463,12553506,29080473794,687334448456,716414922250
2022-03-17,G,Alumni,3,34,11421,9548253,361527562,371075815
2022-03-17,G,Non-HKUST,12,86,44968,86820217,1523985651,1610805868
2022-03-17,G,Others(HKUST),2,2,63494,0,0,0
2022-03-17,G,RPG,53,399,64459,66884885,2919982088,2986866973
2022-03-17,G,Staff,39,567,169624,1101638278,7239635052,8341273330
2022-03-17,G,TPG,57,683,227120,220168103,10711829863,10931997966
2022-03-17,G,Total,479,5838,1281224,2985801071,53883234766,56869035837
2022-03-17,G,UG,313,4067,700138,1500741335,31126274550,32627015885
2022-03-17,LG1,Alumni,1,1,25,8336,14836,23172
2022-03-17,LG1,Non-HKUST,18,129,249371,794232480,15568105624,16362338104
2022-03-17,LG1,Others(HKUST),2,8,210699,0,0,0
2022-03-17,LG1,RPG,46,780,742257,1259764952,29819452455,31079217407
2022-03-17,LG1,Staff,22,324,133024,101207687,6270764933,6371972620
2022-03-17,LG1,TPG,44,964,985870,2221188842,49956168653,52177357495
2022-03-17,LG1,Total,424,11719,11184261,25158730611,536452982182,561611712793
2022-03-17,LG1,UG,291,9513,8863015,20782328314,434838475681,455620803995
2022-03-17,LG3,Alumni,10,24,16393,53842408,1223575021,1277417429
2022-03-17,LG3,Non-HKUST,39,112,40439,93219017,992616289,1085835306
2022-03-17,LG3,Others(HKUST),10,60,4491,1127302,47094689,48221991
2022-03-17,LG3,RPG,481,1431,291723,323482384,7539418789,7862901173
2022-03-17,LG3,Staff,337,998,64763,81249663,1398063417,1479313080
2022-03-17,LG3,TPG,107,642,366453,542070043,27374587179,27916657222
2022-03-17,LG3,Total,1586,6056,2036272,3544214788,115577723474,119121938262
2022-03-17,LG3,UG,602,2789,1252010,2449223971,77002368090,79451592061
2022-03-17,LG4,Alumni,6,62,55483,111674346,2673490397,2785164743
2022-03-17,LG4,Non-HKUST,14,44,33671,39019018,455969013,494988031
2022-03-17,LG4,Others(HKUST),7,74,147235,19436182,1588621346,1608057528
2022-03-17,LG4,RPG,156,403,218012,487995362,8287680494,8775675856
2022-03-17,LG4,Staff,98,417,36583,31812382,995692527,1027504909
2022-03-17,LG4,TPG,39,469,355179,381845160,12823000907,13204846067
2022-03-17,LG4,Total,596,2783,1885059,3776308495,125372738436,129149046931
2022-03-17,LG4,UG,276,1314,1038896,2704526045,98548283752,101252809797
2022-03-18,1,Alumni,1,1,10,0,0,0
2022-03-18,1,Non-HKUST,9,71,115726,147114708,6751936444,6899051152
2022-03-18,1,Others(HKUST),2,2,10,0,0,0
2022-03-18,1,RPG,66,91,9838,7136102,513479602,520615704
2022-03-18,1,Staff,48,291,413786,106663170,4659005935,4765669105
2022-03-18,1,TPG,17,168,100360,84670272,4431339490,4516009762
2022-03-18,1,Total,246,1197,1198337,1200524892,47198272606,48398797498
2022-03-18,1,UG,103,573,558607,854940640,30842511135,31697451775
2022-03-18,All-Floors,Alumni,12,187,128030,268325324,6469168553,6737493877
2022-03-18,All-Floors,Non-HKUST,40,412,431858,1564304567,18477859083,20042163650
2022-03-18,All-Floors,Others(HKUST),14,102,302642,15974750,460205674,476180424
2022-03-18,All-Floors,RPG,473,2992,1061346,1321175524,38425742995,39746918519
2022-03-18,All-Floors,Staff,370,2919,1067462,743484184,27257072225,28000556409
2022-03-18,All-Floors,TPG,122,3525,2304790,8283011256,111440646965,119723658221
2022-03-18,All-Floors,Total,1674,25851,16478801,33028524451,781688776741,814717301192
2022-03-18,All-Floors,UG,643,15714,11182673,20832248846,579158081246,599990330092
2022-03-18,G,Alumni,5,104,39869,185812739,2649880165,2835692904
2022-03-18,G,Non-HKUST,19,119,72960,168239442,1658118589,1826358031
2022-03-18,G,Others(HKUST),3,4,63028,0,0,0
2022-03-18,G,RPG,52,423,167373,253677137,7543121693,7796798830
2022-03-18,G,Staff,53,673,241284,232209917,10732461342,10964671259
2022-03-18,G,TPG,63,892,158135,299855317,6856766020,7156621337
2022-03-18,G,Total,465,5456,1459218,2213954752,66116460551,68330415303
2022-03-18,G,UG,270,3241,716569,1074160200,36676112742,37750272942
2022-03-18,LG1,Alumni,4,31,23231,30145381,707390971,737536352
2022-03-18,LG1,Non-HKUST,17,134,221400,1206238564,8843246458,10049485022
2022-03-18,LG1,Others(HKUST),1,4,156727,3453465,9990706,13444171
2022-03-18,LG1,RPG,29,563,512365,721136879,19080982028,19802118907
2022-03-18,LG1,Staff,31,501,287221,338080042,10153002059,10491082101
2022-03-18,LG1,TPG,62,1427,1307247,6686659745,76970062323,83656722068
2022-03-18,LG1,Total,414,10946,10849402,25585392006,531227383918,556812775924
2022-03-18,LG1,UG,270,8286,8341211,16599677930,415462709373,432062387303
2022-03-18,LG3,Alumni,7,22,6511,12223179,489769731,501992910
2022-03-18,LG3,Non-HKUST,25,66,14708,27100950,753740203,780841153
2022-03-18,LG3,Others(HKUST),11,54,2786,358386,3636764,3995150
2022-03-18,LG3,RPG,416,1161,216268,183117997,6141318711,6324436708
2022-03-18,LG3,Staff,326,1036,86020,40373469,1009225674,1049599143
2022-03-18,LG3,TPG,105,511,275074,413156671,4932421635,5345578306
2022-03-18,LG3,Total,1417,5180,1432846,1845130697,68612067228,70457197925
2022-03-18,LG3,UG,527,2330,831479,1168800045,55281954510,56450754555
2022-03-18,LG4,Alumni,6,29,58409,40144025,2622127686,2662271711
2022-03-18,LG4,Non-HKUST,11,22,7064,15610903,470817389,486428292
2022-03-18,LG4,Others(HKUST),4,38,80091,12162899,446578204,458741103
2022-03-18,LG4,RPG,126,754,155502,156107409,5146840961,5302948370
2022-03-18,LG4,Staff,100,418,39151,26157586,703377215,729534801
2022-03-18,LG4,TPG,42,527,463974,798669251,18250057497,19048726748
2022-03-18,LG4,Total,564,3072,1538998,2183522104,68534592438,70718114542
2022-03-18,LG4,UG,275,1284,734807,1134670031,40894793486,42029463517
2022-03-19,1,Alumni,1,1,0,0,0,0
2022-03-19,1,Non-HKUST,2,42,28572,24621564,2121792052,2146413616
2022-03-19,1,Others(HKUST),2,2,50,0,0,0
2022-03-19,1,RPG,72,105,61825,74437407,1802704842,1877142249
2022-03-19,1,Staff,26,94,178860,20223975,221175761,241399736
2022-03-19,1,TPG,25,47,21925,56107896,2840317362,2896425258
2022-03-19,1,Total,234,1088,983536,719275241,56989094152,57708369393
2022-03-19,1,UG,106,797,692304,543884399,50003104135,50546988534
2022-03-19,All-Floors,Alumni,12,141,145750,406041969,10268364553,10674406522
2022-03-19,All-Floors,Non-HKUST,24,297,170025,218102291,5769068632,5987170923
2022-03-19,All-Floors,Others(HKUST),15,125,643818,90774668,4004947243,4095721911
2022-03-19,All-Floors,RPG,355,2102,935469,1814564962,36411163285,38225728247
2022-03-19,All-Floors,Staff,179,929,555937,332806482,13352656042,13685462524
2022-03-19,All-Floors,TPG,110,2977,2176508,5165939597,95368916624,100534856221
2022-03-19,All-Floors,Total,1263,18458,12638871,21782371563,592967650368,614750021931
2022-03-19,All-Floors,UG,568,11887,8011364,13754141594,427792533989,441546675583
2022-03-19,G,Alumni,6,51,8146,3957910,102489010,106446920
2022-03-19,G,Non-HKUST,7,59,7914,17420922,317679304,335100226
2022-03-19,G,Others(HKUST),2,3,133149,6396548,32415893,38812441
2022-03-19,G,RPG,43,375,102300,84791403,1516597575,1601388978
2022-03-19,G,Staff,26,312,227926,135528820,3511834363,3647363183
2022-03-19,G,TPG,58,839,343763,370861341,20744392564,21115253905
2022-03-19,G,Total,353,4115,1190528,1376530671,39299867531,40676398202
2022-03-19,G,UG,211,2476,367330,757573727,13074458822,13832032549
2022-03-19,LG1,Alumni,3,26,43311,50280196,3830990598,3881270794
2022-03-19,LG1,Non-HKUST,9,131,113529,157249880,2909032777,3066282657
2022-03-19,LG1,Others(HKUST),2,11,332890,30489897,106970361,137460258
2022-03-19,LG1,RPG,31,518,445210,1232175003,16899794138,18131969141
2022-03-19,LG1,Staff,18,177,105640,112491288,8152383147,8264874435
2022-03-19,LG1,TPG,51,1231,1205198,3972003585,42070814473,46042818058
2022-03-19,LG1,Total,308,7952,7793560,16240827360,331742184225,347983011585
2022-03-19,LG1,UG,194,5858,5547782,10686137511,257772198731,268458336242
2022-03-19,LG3,Alumni,9,21,17558,288117332,224143496,512260828
2022-03-19,LG3,Non-HKUST,23,45,13313,14685814,232012910,246698724
2022-03-19,LG3,Others(HKUST),12,62,13819,19403681,2401345086,2420748767
2022-03-19,LG3,RPG,297,644,62161,66479841,1858190733,1924670574
2022-03-19,LG3,Staff,145,293,39614,61479162,1345271351,1406750513
2022-03-19,LG3,TPG,82,590,381981,582146322,17860216335,18442362657
2022-03-19,LG3,Total,1028,3344,1158365,1836712092,56529005448,58365717540
2022-03-19,LG3,UG,460,1689,629919,804399940,32607825537,33412225477
2022-03-19,LG4,Alumni,6,42,76735,63686531,6110741449,6174427980
2022-03-19,LG4,Non-HKUST,13,20,6697,4124111,188551589,192675700
2022-03-19,LG4,Others(HKUST),6,47,163910,34484542,1464215903,1498700445
2022-03-19,LG4,RPG,104,460,263973,356681308,14333875997,14690557305
2022-03-19,LG4,Staff,40,53,3897,3083237,121991420,125074657
2022-03-19,LG4,TPG,45,270,223641,184820453,11853175890,12037996343
2022-03-19,LG4,Total,475,1959,1512882,1609026199,108407499012,110016525211
2022-03-19,LG4,UG,261,1067,774029,962146017,74334946764,75297092781
2022-03-20,1,Alumni,0,0,0,0,0,0
2022-03-20,1,Non-HKUST,0,0,0,0,0,0
2022-03-20,1,Others(HKUST),2,2,130,13482,24331,37813
2022-03-20,1,RPG,41,51,1211,252952,1803863,2056815
2022-03-20,1,Staff,24,29,4030,864610,10714465,11579075
2022-03-20,1,TPG,12,16,225,13243,29801,43044
2022-03-20,1,Total,132,160,6748,1224004,13717293,14941297
2022-03-20,1,UG,53,62,1152,79717,1144833,1224550
2022-03-20,All-Floors,Alumni,6,33,10327,6937097,529476295,536413392
2022-03-20,All-Floors,Non-HKUST,28,237,263850,478444692,29931485160,30409929852
2022-03-20,All-Floors,Others(HKUST),9,52,289791,100655643,689569311,790224954
2022-03-20,All-Floors,RPG,335,1688,717224,1589055228,22705419594,24294474822
2022-03-20,All-Floors,Staff,135,459,168632,98773911,5449837762,5548611673
2022-03-20,All-Floors,TPG,97,1916,1497596,1531105694,40296292095,41827397789
2022-03-20,All-Floors,Total,1120,15499,10640985,15934154053,444778492635,460712646688
2022-03-20,All-Floors,UG,510,11114,7693565,12129181788,345176412418,357305594206
2022-03-20,G,Alumni,1,1,5,0,0,0
2022-03-20,G,Non-HKUST,0,0,0,0,0,0
2022-03-20,G,Others(HKUST),2,2,2340,0,0,0
2022-03-20,G,RPG,8,9,200,118257,562256,680513
2022-03-20,G,Staff,3,19,1472,19800,193104,212904
2022-03-20,G,TPG,1,1,5,0,0,0
2022-03-20,G,Total,36,55,4272,270194,1540332,1810526
2022-03-20,G,UG,21,23,250,132137,784972,917109
2022-03-20,LG1,Alumni,0,0,0,0,0,0
2022-03-20,LG1,Non-HKUST,13,190,260828,478070617,29928419082,30406489699
2022-03-20,LG1,Others(HKUST),1,6,210614,9477716,36413391,45891107
2022-03-20,LG1,RPG,22,740,632179,1501140755,19705697729,21206838484
2022-03-20,LG1,Staff,7,86,141534,93877293,5401463403,5495340696
2022-03-20,LG1,TPG,44,1626,1460813,1480487959,37778276943,39258764902
2022-03-20,LG1,Total,280,11743,10121102,15229965188,424904555940,440134521128
2022-03-20,LG1,UG,193,9095,7415134,11666910848,332054285392,343721196240
2022-03-20,LG3,Alumni,4,6,3932,5601157,517081354,522682511
2022-03-20,LG3,Non-HKUST,21,37,2616,333141,2908096,3241237
2022-03-20,LG3,Others(HKUST),6,30,6421,84987470,619453596,704441066
2022-03-20,LG3,RPG,302,724,66415,76619033,2363750591,2440369624
2022-03-20,LG3,Staff,117,270,19744,3473914,29309652,32783566
2022-03-20,LG3,TPG,81,231,11623,31194043,2255257554,2286451597
2022-03-20,LG3,Total,987,2878,317636,593082795,16107978656,16701061451
2022-03-20,LG3,UG,456,1580,206885,390874037,10320217813,10711091850
2022-03-20,LG4,Alumni,2,26,6390,1335940,12394941,13730881
2022-03-20,LG4,Non-HKUST,8,10,406,40934,157982,198916
2022-03-20,LG4,Others(HKUST),5,12,70286,6176975,33677993,39854968
2022-03-20,LG4,RPG,101,164,17219,10924231,633605155,644529386
2022-03-20,LG4,Staff,31,55,1852,538294,8157138,8695432
2022-03-20,LG4,TPG,29,42,24930,19410449,262727797,282138246
2022-03-20,LG4,Total,375,663,191227,109611872,3750700414,3860312286
2022-03-20,LG4,UG,199,354,70144,71185049,2799979408,2871164457
2022-03-21,1,Alumni,0,0,0,0,0,0
2022-03-21,1,Non-HKUST,11,55,115285,240030540,3461402402,3701432942
2022-03-21,1,Others(HKUST),5,6,75,464,124,588
2022-03-21,1,RPG,99,280,199487,236819293,6754511678,6991330971
2022-03-21,1,Staff,63,666,308905,113032953,2407687462,2520720415
2022-03-21,1,TPG,18,48,24140,10951903,492190793,503142696
2022-03-21,1,Total,306,1823,1446922,1756761438,46417801822,48174563260
2022-03-21,1,UG,110,768,799030,1155926285,33302009363,34457935648
2022-03-21,All-Floors,Alumni,7,125,118670,387458979,5511868658,5899327637
2022-03-21,All-Floors,Non-HKUST,40,1236,693534,1424971198,31085194982,32510166180
2022-03-21,All-Floors,Others(HKUST),20,121,327088,30912669,947554071,978466740
2022-03-21,All-Floors,RPG,505,3517,1316336,3900304999,136125051432,140025356431
2022-03-21,All-Floors,Staff,383,2694,904786,4337569947,31670013281,36007583228
2022-03-21,All-Floors,TPG,126,3756,2440668,3425377674,99348726300,102774103974
2022-03-21,All-Floors,Total,1706,33251,19677643,48150374034,988284232147,1036434606181
2022-03-21,All-Floors,UG,625,21802,13876561,34643778568,683595823423,718239601991
2022-03-21,G,Alumni,5,47,7981,682493,22395918,23078411
2022-03-21,G,Non-HKUST,17,197,6131,37804629,1128868665,1166673294
2022-03-21,G,Others(HKUST),3,3,2533,3754245,15273093,19027338
2022-03-21,G,RPG,62,838,245794,419915979,7686508853,8106424832
2022-03-21,G,Staff,49,506,272486,238742599,18904207257,19142949856
2022-03-21,G,TPG,60,978,456142,437727921,16099201246,16536929167
2022-03-21,G,Total,489,6638,1727461,3316101102,99322620964,102638722066
2022-03-21,G,UG,293,4069,736394,2177473236,55466165932,57643639168
2022-03-21,LG1,Alumni,2,2,280,6032,12255,18287
2022-03-21,LG1,Non-HKUST,22,759,479271,918633325,20761394892,21680028217
2022-03-21,LG1,Others(HKUST),1,7,237074,11763288,34359120,46122408
2022-03-21,LG1,RPG,37,973,589372,2908307451,83656656967,86564964418
2022-03-21,LG1,Staff,28,262,213286,211846278,6238388915,6450235193
2022-03-21,LG1,TPG,55,1580,1227536,2148818316,56414539188,58563357504
2022-03-21,LG1,Total,446,16459,13196330,32568001034,654388004246,686956005280
2022-03-21,LG1,UG,301,12876,10449511,26368626344,487282652909,513651279253
2022-03-21,LG3,Alumni,6,17,47097,355938062,2363707612,2719645674
2022-03-21,LG3,Non-HKUST,29,139,29736,146163192,1916596378,2062759570
2022-03-21,LG3,Others(HKUST),16,70,4441,746441,7922895,8669336
2022-03-21,LG3,RPG,433,1081,137559,192056581,29356380019,29548436600
2022-03-21,LG3,Staff,331,956,93929,3754943046,3929333929,7684276975
2022-03-21,LG3,TPG,107,707,301054,389134302,7765047152,8154181454
2022-03-21,LG3,Total,1452,5683,1867926,7944719459,116288681372,124233400831
2022-03-21,LG3,UG,530,2713,1254110,3105737835,70949693387,74055431222
2022-03-21,LG4,Alumni,4,59,63312,30832392,3125752873,3156585265
2022-03-21,LG4,Non-HKUST,17,86,63111,82339512,3816932645,3899272157
2022-03-21,LG4,Others(HKUST),8,35,82965,14648231,889998839,904647070
2022-03-21,LG4,RPG,168,345,144124,143205695,8670993915,8814199610
2022-03-21,LG4,Staff,115,304,16180,19005071,190395718,209400789
2022-03-21,LG4,TPG,57,443,431796,438745232,18577747921,19016493153
2022-03-21,LG4,Total,720,2648,1439004,2564791001,71867123743,74431914744
2022-03-21,LG4,UG,351,1376,637516,1836014868,36595301832,38431316700
2022-03-22,1,Alumni,2,2,15,0,0,0
2022-03-22,1,Non-HKUST,9,45,63956,99719757,3656509551,3756229308
2022-03-22,1,Others(HKUST),2,2,15,0,0,0
2022-03-22,1,RPG,100,153,83027,67033909,1206435535,1273469444
2022-03-22,1,Staff,67,593,523479,201002006,7260453700,7461455706
2022-03-22,1,TPG,20,182,207351,221596154,10384734186,10606330340
2022-03-22,1,Total,345,1708,1643266,1448892154,54760449573,56209341727
2022-03-22,1,UG,145,731,765423,859540328,32252316601,33111856929
2022-03-22,All-Floors,Alumni,10,121,118715,328370934,7667706851,7996077785
2022-03-22,All-Floors,Non-HKUST,45,535,514937,732285398,26106296648,26838582046
2022-03-22,All-Floors,Others(HKUST),17,150,423808,62777908,4153809480,4216587388
2022-03-22,All-Floors,RPG,524,3002,1077652,2233253820,59942516184,62175770004
2022-03-22,All-Floors,Staff,391,3696,1197343,1924926042,46772739165,48697665207
2022-03-22,All-Floors,TPG,135,4045,2963878,21587312083,116245103412,137832415495
2022-03-22,All-Floors,Total,1800,34427,21149565,59570114943,950434173886,1010004288829
2022-03-22,All-Floors,UG,678,22878,14853232,32701188758,689546002146,722247190904
2022-03-22,G,Alumni,4,40,805,598651,1240487,1839138
2022-03-22,G,Non-HKUST,13,103,16636,5558765,138547734,144106499
2022-03-22,G,Others(HKUST),2,2,2370,3696168,32644864,36341032
2022-03-22,G,RPG,63,584,148610,236725689,6697096489,6933822178
2022-03-22,G,Staff,58,715,157129,97653672,4473167436,4570821108
2022-03-22,G,TPG,68,1080,250058,688813513,8007032283,8695845796
2022-03-22,G,Total,547,6646,1366110,2400048863,64341723629,66741772492
2022-03-22,G,UG,339,4122,790502,1367002405,44991994336,46358996741
2022-03-22,LG1,Alumni,3,8,1268,230781,2770600,3001381
2022-03-22,LG1,Non-HKUST,21,255,402260,534192299,18514881774,19049074073
2022-03-22,LG1,Others(HKUST),1,10,303934,23557671,83401401,106959072
2022-03-22,LG1,RPG,31,847,608896,1603894498,46731169377,48335063875
2022-03-22,LG1,Staff,40,931,383711,1422418124,33090953415,34513371539
2022-03-22,LG1,TPG,69,1686,1553168,19064381163,63239795668,82304176831
2022-03-22,LG1,Total,493,16582,14418843,48739772568,651235499676,699975272244
2022-03-22,LG1,UG,328,12845,11165606,26091098032,489572527441,515663625473
2022-03-22,LG3,Alumni,9,27,42793,278101258,2806642425,3084743683
2022-03-22,LG3,Non-HKUST,30,94,13535,43819558,2534160555,2577980113
2022-03-22,LG3,Others(HKUST),15,80,11893,4766959,341095558,345862517
2022-03-22,LG3,RPG,453,1190,148343,230972999,3897571895,4128544894
2022-03-22,LG3,Staff,346,1117,109481,183362799,1178963805,1362326604
2022-03-22,LG3,TPG,113,618,553163,1040324728,13915777354,14956102082
2022-03-22,LG3,Total,1565,5992,1712034,4054345682,82349827613,86404173295
2022-03-22,LG3,UG,599,2866,832826,2272997381,57675616021,59948613402
2022-03-22,LG4,Alumni,6,44,73834,49440244,4857053339,4906493583
2022-03-22,LG4,Non-HKUST,19,38,18550,48995019,1262197034,1311192053
2022-03-22,LG4,Others(HKUST),7,56,105596,30757110,3696667657,3727424767
2022-03-22,LG4,RPG,132,228,88776,94626725,1410242888,1504869613
2022-03-22,LG4,Staff,88,340,23543,20489441,769200809,789690250
2022-03-22,LG4,TPG,67,479,400138,572196525,20697763921,21269960446
2022-03-22,LG4,Total,691,3499,2009312,2927055676,97746673395,100673729071
2022-03-22,LG4,UG,372,2314,1298875,2110550612,65053547747,67164098359
2022-03-23,1,Alumni,0,0,0,0,0,0
2022-03-23,1,Non-HKUST,7,16,49498,39843461,1276598893,1316442354
2022-03-23,1,Others(HKUST),2,6,130,6687,16309,22996
2022-03-23,1,RPG,94,154,85319,79744468,3875416809,3955161277
2022-03-23,1,Staff,62,722,482598,135866099,2043313200,2179179299
2022-03-23,1,TPG,20,127,135780,129234497,6543663212,6672897709
2022-03-23,1,Total,301,1453,1269027,897723410,37056669063,37954392473
2022-03-23,1,UG,116,428,515702,513028198,23317660640,23830688838
2022-03-23,All-Floors,Alumni,9,265,126108,383237668,5370422118,5753659786
2022-03-23,All-Floors,Non-HKUST,40,398,476327,1459306815,20031720771,21491027586
2022-03-23,All-Floors,Others(HKUST),20,159,295277,36135688,1320296318,1356432006
2022-03-23,All-Floors,RPG,471,2707,1222457,14265181635,74340129208,88605310843
2022-03-23,All-Floors,Staff,359,3389,966041,1311051373,17805883250,19116934623
2022-03-23,All-Floors,TPG,105,2588,1900438,3832232475,77983289718,81815522193
2022-03-23,All-Floors,Total,1717,29708,18336211,48249141445,843089341901,891338483346
2022-03-23,All-Floors,UG,713,20202,13349563,26961995791,646237600518,673199596309
2022-03-23,G,Alumni,5,170,36649,112171104,2072365519,2184536623
2022-03-23,G,Non-HKUST,16,99,15854,8125582,208762719,216888301
2022-03-23,G,Others(HKUST),2,2,2318,3764717,18550020,22314737
2022-03-23,G,RPG,41,311,85489,11864799193,4243217206,16108016399
2022-03-23,G,Staff,45,616,74241,44349018,995772559,1040121577
2022-03-23,G,TPG,47,569,214975,200457471,15299242642,15499700113
2022-03-23,G,Total,453,5756,1109876,13215064601,65865069703,79080134304
2022-03-23,G,UG,297,3989,680350,981397516,43027159038,44008556554
2022-03-23,LG1,Alumni,0,0,0,0,0,0
2022-03-23,LG1,Non-HKUST,16,168,359272,1162886572,13235156502,14398043074
2022-03-23,LG1,Others(HKUST),1,5,240206,14457068,59625590,74082658
2022-03-23,LG1,RPG,32,852,722311,1701187062,48854736582,50555923644
2022-03-23,LG1,Staff,32,556,282190,1065717196,13303384745,14369101941
2022-03-23,LG1,TPG,47,1032,1026834,2893236077,36945083505,39838319582
2022-03-23,LG1,Total,417,13647,12702223,28311021861,539700671478,568011693339
2022-03-23,LG1,UG,289,11034,10071410,21473537886,427302684554,448776222440
2022-03-23,LG3,Alumni,8,17,23844,220643756,1292434760,1513078516
2022-03-23,LG3,Non-HKUST,27,91,40663,212819611,4601968843,4814788454
2022-03-23,LG3,Others(HKUST),18,87,4553,1014592,34393605,35408197
2022-03-23,LG3,RPG,411,1097,192638,321787067,4570109150,4891896217
2022-03-23,LG3,Staff,314,1140,111694,57135608,1426676289,1483811897
2022-03-23,LG3,TPG,86,434,212856,177252718,10507865856,10685118574
2022-03-23,LG3,Total,1494,5673,1460043,2330700044,100065067304,102395767348
2022-03-23,LG3,UG,630,2807,873795,1340046692,77631618801,78971665493
2022-03-23,LG4,Alumni,5,78,65615,50422808,2005621839,2056044647
2022-03-23,LG4,Non-HKUST,13,24,11040,35631589,709233814,744865403
2022-03-23,LG4,Others(HKUST),5,59,48070,16892624,1207710794,1224603418
2022-03-23,LG4,RPG,115,293,136700,297663845,12796649461,13094313306
2022-03-23,LG4,Staff,82,355,15318,7983452,36736457,44719909
2022-03-23,LG4,TPG,44,426,309993,432051712,8687434503,9119486215
2022-03-23,LG4,Total,615,3179,1795042,3494631529,100401864353,103896495882
2022-03-23,LG4,UG,351,1944,1208306,2653985499,74958477485,77612462984
2022-03-24,1,Alumni,1,1,5,37127,136731,173858
2022-03-24,1,Non-HKUST,10,61,89527,108979204,2075208651,2184187855
2022-03-24,1,Others(HKUST),6,7,1265,92672,391490,484162
2022-03-24,1,RPG,100,132,41941,47059230,2715415593,2762474823
2022-03-24,1,Staff,55,596,419953,155722624,8208370123,8364092747
2022-03-24,1,TPG,25,151,126410,198578971,9181659288,9380238259
2022-03-24,1,Total,381,1805,1393529,1161135679,49800426275,50961561954
2022-03-24,1,UG,184,857,714428,650665851,27619244399,28269910250
2022-03-24,All-Floors,Alumni,14,287,214353,467362112,12556799663,13024161775
2022-03-24,All-Floors,Non-HKUST,42,599,434158,1004734545,17073686144,18078420689
2022-03-24,All-Floors,Others(HKUST),23,144,324360,236668131,2934731654,3171399785
2022-03-24,All-Floors,RPG,518,3331,1381279,23176577236,67423835127,90600412363
2022-03-24,All-Floors,Staff,359,2721,923767,1066878478,22490912878,23557791356
2022-03-24,All-Floors,TPG,132,3690,2545338,4873789189,110010973632,114884762821
2022-03-24,All-Floors,Total,1808,30948,19797719,66513469194,921730382033,988243851227
2022-03-24,All-Floors,UG,720,20176,13974464,35687459503,689239442935,724926902438
2022-03-24,G,Alumni,8,92,64367,278779317,3667746643,3946525960
2022-03-24,G,Non-HKUST,11,218,24241,29005336,343266668,372272004
2022-03-24,G,Others(HKUST),2,3,2352,0,0,0
2022-03-24,G,RPG,56,584,219508,20263924829,20791888785,41055813614
2022-03-24,G,Staff,44,492,98697,47293596,1330558253,1377851849
2022-03-24,G,TPG,64,779,200719,286496888,7867318645,8153815533
2022-03-24,G,Total,498,6221,1334111,22147292650,60031622036,82178914686
2022-03-24,G,UG,313,4053,724227,1241792684,26030843042,27272635726
2022-03-24,LG1,Alumni,3,92,61469,129818379,2340857976,2470676355
2022-03-24,LG1,Non-HKUST,18,152,292337,853288854,14014475424,14867764278
2022-03-24,LG1,Others(HKUST),3,13,257393,182879583,575377052,758256635
2022-03-24,LG1,RPG,40,974,704122,1967939856,18158514881,20126454737
2022-03-24,LG1,Staff,33,632,326305,360822662,10434042174,10794864836
2022-03-24,LG1,TPG,59,1701,1559007,2912317420,66679412946,69591730366
2022-03-24,LG1,Total,469,14544,13939716,36343317560,632374110199,668717427759
2022-03-24,LG1,UG,313,10980,10739083,29936250806,520171429746,550107680552
2022-03-24,LG3,Alumni,12,19,10817,20749389,4271008027,4291757416
2022-03-24,LG3,Non-HKUST,26,142,27408,13442800,640659666,654102466
2022-03-24,LG3,Others(HKUST),17,80,6216,25283270,201731112,227014382
2022-03-24,LG3,RPG,444,1099,139643,151624438,5011907216,5163531654
2022-03-24,LG3,Staff,319,820,71383,500938674,2433743787,2934682461
2022-03-24,LG3,TPG,107,547,272541,446692996,8303945417,8750638413
2022-03-24,LG3,Total,1524,5471,1634655,3330488005,80985112219,84315600224
2022-03-24,LG3,UG,599,2764,1106647,2171756438,60122116994,62293873432
2022-03-24,LG4,Alumni,6,83,77695,37977900,2277050286,2315028186
2022-03-24,LG4,Non-HKUST,13,26,645,18351,75735,94086
2022-03-24,LG4,Others(HKUST),7,41,57134,28412606,2157232000,2185644606
2022-03-24,LG4,RPG,120,542,276065,746028883,20746108652,21492137535
2022-03-24,LG4,Staff,79,181,7429,2100922,84198541,86299463
2022-03-24,LG4,TPG,59,512,386661,1029702914,17978637336,19008340250
2022-03-24,LG4,Total,616,2907,1495708,3531235300,98539111304,102070346604
2022-03-24,LG4,UG,332,1522,690079,1686993724,55295808754,56982802478
2022-03-25,1,Alumni,4,4,65,13422,14372,27794
2022-03-25,1,Non-HKUST,9,31,45838,61278954,2303296812,2364575766
2022-03-25,1,Others(HKUST),2,2,10,0,0,0
2022-03-25,1,RPG,62,124,90423,57080761,1959291938,2016372699
2022-03-25,1,Staff,61,860,603806,199648034,4869549522,5069197556
2022-03-25,1,TPG,15,106,106335,212659053,4507245460,4719904513
2022-03-25,1,Total,261,1862,1525702,1359033895,53326230759,54685264654
2022-03-25,1,UG,108,735,679225,828353671,39686832655,40515186326
2022-03-25,All-Floors,Alumni,16,405,229160,965740718,407437477765,408403218483
2022-03-25,All-Floors,Non-HKUST,46,391,353583,999298672,12848271687,13847570359
2022-03-25,All-Floors,Others(HKUST),19,134,307333,61341500,3618925363,3680266863
2022-03-25,All-Floors,RPG,502,2710,1187764,15472925397,46019379087,61492304484
2022-03-25,All-Floors,Staff,407,3562,1124961,1152281680,33610968506,34763250186
2022-03-25,All-Floors,TPG,111,3640,2175073,3871364775,80930494360,84801859135
2022-03-25,All-Floors,Total,1781,30012,18587640,53024057237,1252080670478,1305104727715
2022-03-25,All-Floors,UG,680,19170,13209766,30501104495,667615153710,698116258205
2022-03-25,G,Alumni,9,188,72543,255288966,3972182443,4227471409
2022-03-25,G,Non-HKUST,8,55,866,13862474,1093414646,1107277120
2022-03-25,G,Others(HKUST),2,3,3227,0,0,0
2022-03-25,G,RPG,41,525,137815,12774162579,12586020691,25360183270
2022-03-25,G,Staff,63,625,69327,30413607,1995115491,2025529098
2022-03-25,G,TPG,59,736,303839,257478803,8767725069,9025203872
2022-03-25,G,Total,476,5955,1566646,15739298624,80675835004,96415133628
2022-03-25,G,UG,294,3823,979029,2408092195,52261376664,54669468859
2022-03-25,LG1,Alumni,8,109,89084,646399139,400850735109,401497134248
2022-03-25,LG1,Non-HKUST,14,179,270648,874390309,6379689809,7254080118
2022-03-25,LG1,Others(HKUST),4,12,223234,14683004,50608389,65291393
2022-03-25,LG1,RPG,32,628,666764,2222168740,24331589742,26553758482
2022-03-25,LG1,Staff,38,533,354130,616149146,17730627128,18346776274
2022-03-25,LG1,TPG,54,1487,1368347,2762343076,49685148126,52447491202
2022-03-25,LG1,Total,447,12766,12512370,30809330386,982863985673,1013673316059
2022-03-25,LG1,UG,297,9818,9540163,23673196972,483835587370,507508784342
2022-03-25,LG3,Alumni,11,31,4698,11931865,65817283,77749148
2022-03-25,LG3,Non-HKUST,39,93,24524,12261377,214216185,226477562
2022-03-25,LG3,Others(HKUST),16,73,5807,5252705,116557115,121809820
2022-03-25,LG3,RPG,457,1179,154109,237978636,3422054702,3660033338
2022-03-25,LG3,Staff,367,1160,72336,244242360,7548331484,7792573844
2022-03-25,LG3,TPG,83,400,175309,144899116,4336527154,4481426270
2022-03-25,LG3,Total,1562,5919,1415589,1908328594,52593850222,54502178816
2022-03-25,LG3,UG,589,2983,978806,1251762535,36890346299,38142108834
2022-03-25,LG4,Alumni,7,73,62770,52107326,2548728558,2600835884
2022-03-25,LG4,Non-HKUST,10,33,11707,37505558,2857654235,2895159793
2022-03-25,LG4,Others(HKUST),4,44,75055,41405791,3451759859,3493165650
2022-03-25,LG4,RPG,102,254,138653,181534681,3720422014,3901956695
2022-03-25,LG4,Staff,100,384,25362,61828533,1467344881,1529173414
2022-03-25,LG4,TPG,40,911,221243,493984727,13633848551,14127833278
2022-03-25,LG4,Total,587,3510,1567333,3208065738,82620768820,85828834558
2022-03-25,LG4,UG,324,1811,1032543,2339699122,54941010722,57280709844
2022-03-26,1,Alumni,3,48,13297,48026792,18662529347,18710556139
2022-03-26,1,Non-HKUST,1,3,24112,269524,708670,978194
2022-03-26,1,Others(HKUST),2,2,85,1052,372,1424
2022-03-26,1,RPG,35,103,54640,65458367,4103486844,4168945211
2022-03-26,1,Staff,21,97,109638,125587040,3766605219,3892192259
2022-03-26,1,TPG,8,22,415,12811,106980,119791
2022-03-26,1,Total,130,842,891311,1092931323,52767035749,53859967072
2022-03-26,1,UG,60,567,689124,853575737,26233598317,27087174054
2022-03-26,All-Floors,Alumni,18,490,175954,427194975,30630155161,31057350136
2022-03-26,All-Floors,Non-HKUST,28,433,292977,254812993,12021576395,12276389388
2022-03-26,All-Floors,Others(HKUST),14,125,295691,34098776,775670686,809769462
2022-03-26,All-Floors,RPG,445,2300,935828,1661839125,41689568602,43351407727
2022-03-26,All-Floors,Staff,238,1115,257620,480744876,11574750526,12055495402
2022-03-26,All-Floors,TPG,128,4594,2527274,5032296910,156127130823,161159427733
2022-03-26,All-Floors,Total,1509,23196,13212438,21937472749,675732618310,697670091059
2022-03-26,All-Floors,UG,638,14139,8727094,14046485094,422913766117,436960251211
2022-03-26,G,Alumni,8,129,35606,53970900,4059910069,4113880969
2022-03-26,G,Non-HKUST,12,88,20215,20537068,425129353,445666421
2022-03-26,G,Others(HKUST),2,2,2285,0,0,0
2022-03-26,G,RPG,34,266,60266,36944811,1121016666,1157961477
2022-03-26,G,Staff,24,222,14919,8876706,163403528,172280234
2022-03-26,G,TPG,58,1196,374699,401951148,12153987416,12555938564
2022-03-26,G,Total,364,4600,1014368,1107672468,37493351978,38601024446
2022-03-26,G,UG,226,2697,506378,585391835,19569904946,20155296781
2022-03-26,LG1,Alumni,7,68,26840,226124232,2903257847,3129382079
2022-03-26,LG1,Non-HKUST,9,117,133890,178238786,9052046434,9230285220
2022-03-26,LG1,Others(HKUST),1,5,219000,17396818,64126483,81523301
2022-03-26,LG1,RPG,30,663,587658,1178020860,27643518241,28821539101
2022-03-26,LG1,Staff,11,113,31762,19308099,274842373,294150472
2022-03-26,LG1,TPG,50,1378,1409953,3866693617,100717700980,104584394597
2022-03-26,LG1,Total,306,9469,8505231,15331087342,430844271039,446175358381
2022-03-26,LG1,UG,198,7125,6096128,9845304930,290188778681,300034083611
2022-03-26,LG3,Alumni,17,67,8656,15282289,1010615225,1025897514
2022-03-26,LG3,Non-HKUST,26,178,74366,48010111,2482910489,2530920600
2022-03-26,LG3,Others(HKUST),12,78,9166,1418669,45523074,46941743
2022-03-26,LG3,RPG,417,1133,150049,229958847,6834478809,7064437656
2022-03-26,LG3,Staff,223,594,88364,321788911,7235579267,7557368178
2022-03-26,LG3,TPG,121,781,518149,507304589,23811643585,24318948174
2022-03-26,LG3,Total,1402,5313,1659690,2836303049,85601673740,88437976789
2022-03-26,LG3,UG,586,2482,810940,1712539633,44180923291,45893462924
2022-03-26,LG4,Alumni,7,178,91555,83790762,3993842673,4077633435
2022-03-26,LG4,Non-HKUST,7,47,40394,7757504,60781449,68538953
2022-03-26,LG4,Others(HKUST),4,38,65155,15282237,666020757,681302994
2022-03-26,LG4,RPG,68,135,83215,151456240,1987068042,2138524282
2022-03-26,LG4,Staff,24,89,12937,5184120,134320139,139504259
2022-03-26,LG4,TPG,43,1217,224058,256334745,19443691862,19700026607
2022-03-26,LG4,Total,367,2972,1141838,1569478567,69026285804,70595764371
2022-03-26,LG4,UG,214,1268,624524,1049672959,42740560882,43790233841
2022-03-27,1,Alumni,0,0,0,0,0,0
2022-03-27,1,Non-HKUST,0,0,0,0,0,0
2022-03-27,1,Others(HKUST),0,0,0,0,0,0
2022-03-27,1,RPG,27,28,1080,598560,11954656,12553216
2022-03-27,1,Staff,9,22,1330,99598,254149,353747
2022-03-27,1,TPG,11,11,565,91923,259440,351363
2022-03-27,1,Total,86,105,5109,3390976,119721477,123112453
2022-03-27,1,UG,39,44,2134,2600895,107253232,109854127
2022-03-27,All-Floors,Alumni,12,127,17195,38962521,1176562168,1215524689
2022-03-27,All-Floors,Non-HKUST,27,189,158121,293136768,6823711672,7116848440
2022-03-27,All-Floors,Others(HKUST),10,50,261692,3489419,245168289,248657708
2022-03-27,All-Floors,RPG,406,1789,831816,1078268804,31965074720,33043343524
2022-03-27,All-Floors,Staff,166,506,99130,67709209,6381877731,6449586940
2022-03-27,All-Floors,TPG,123,2764,1884956,2196579924,67266894778,69463474702
2022-03-27,All-Floors,Total,1297,16226,10846983,15125296688,419752163576,434877460264
2022-03-27,All-Floors,UG,553,10801,7594073,11447150043,305892874218,317340024261
2022-03-27,G,Alumni,1,1,10,0,0,0
2022-03-27,G,Non-HKUST,1,1,731,2446,6590,9036
2022-03-27,G,Others(HKUST),1,1,15,0,0,0
2022-03-27,G,RPG,8,8,335,7036,20693,27729
2022-03-27,G,Staff,8,14,410,45510,26956,72466
2022-03-27,G,TPG,5,5,190,0,0,0
2022-03-27,G,Total,49,56,3619,318710,5127096,5445806
2022-03-27,G,UG,25,26,1928,263718,5072857,5336575
2022-03-27,LG1,Alumni,2,5,856,5116,8036,13152
2022-03-27,LG1,Non-HKUST,8,112,148334,171442610,5879840497,6051283107
2022-03-27,LG1,Others(HKUST),1,5,216940,0,0,0
2022-03-27,LG1,RPG,24,782,711113,837556723,26306761313,27144318036
2022-03-27,LG1,Staff,6,47,62864,34850497,1452260333,1487110830
2022-03-27,LG1,TPG,51,2306,1838231,2020474432,65326568514,67347042946
2022-03-27,LG1,Total,281,11991,10296840,14114779782,387215830285,401330610067
2022-03-27,LG1,UG,189,8734,7318502,11050450404,288250391592,299300841996
2022-03-27,LG3,Alumni,12,52,2283,311649,2552303,2863952
2022-03-27,LG3,Non-HKUST,25,69,8931,121685039,943836312,1065521351
2022-03-27,LG3,Others(HKUST),7,31,2111,272654,1959332,2231986
2022-03-27,LG3,RPG,388,903,117663,237139089,5418110778,5655249867
2022-03-27,LG3,Staff,157,398,33379,32596934,4929127530,4961724464
2022-03-27,LG3,TPG,118,412,35915,60974936,1061998853,1122973789
2022-03-27,LG3,Total,1216,3693,461862,825246596,29443473575,30268720171
2022-03-27,LG3,UG,509,1828,261580,372266295,17085888467,17458154762
2022-03-27,LG4,Alumni,4,69,14046,38645756,1174001829,1212647585
2022-03-27,LG4,Non-HKUST,6,7,125,6673,28273,34946
2022-03-27,LG4,Others(HKUST),3,13,42626,3216765,243208957,246425722
2022-03-27,LG4,RPG,44,68,1625,2967396,228227280,231194676
2022-03-27,LG4,Staff,16,25,1147,116670,208763,325433
2022-03-27,LG4,TPG,22,30,10055,115038633,878067971,993106604
2022-03-27,LG4,Total,195,381,79553,181560624,2968011143,3149571767
2022-03-27,LG4,UG,100,169,9929,21568731,444268070,465836801
2022-03-28,1,Alumni,2,2,19,0,0,0
2022-03-28,1,Non-HKUST,9,55,34402,28646899,742825093,771471992
2022-03-28,1,Others(HKUST),2,2,935,488,1084,1572
2022-03-28,1,RPG,55,153,92421,525581670,7423157281,7948738951
2022-03-28,1,Staff,57,640,419993,200258698,6613755995,6814014693
2022-03-28,1,TPG,11,26,54522,55091985,2846171300,2901263285
2022-03-28,1,Total,207,1702,1240184,2475242542,39610431257,42085673799
2022-03-28,1,UG,71,824,637892,1665662802,21984520504,23650183306
2022-03-28,All-Floors,Alumni,12,446,229565,1377019467,17256210127,18633229594
2022-03-28,All-Floors,Non-HKUST,49,784,476872,1414786741,17146820117,18561606858
2022-03-28,All-Floors,Others(HKUST),19,112,268543,22612270,832355699,854967969
2022-03-28,All-Floors,RPG,575,3325,1316725,41713509114,108917345304,150630854418
2022-03-28,All-Floors,Staff,424,2860,901709,764541349,19841128569,20605669918
2022-03-28,All-Floors,TPG,117,3075,2217015,4752293933,111373288775,116125582708
2022-03-28,All-Floors,Total,1854,28973,18061912,78206508678,928708585893,1006915094571
2022-03-28,All-Floors,UG,658,18371,12651483,28161745804,653341437302,681503183106
2022-03-28,G,Alumni,8,52,8239,232393088,1824411280,2056804368
2022-03-28,G,Non-HKUST,24,198,31013,447176688,2267173685,2714350373
2022-03-28,G,Others(HKUST),4,4,20608,2524,2731,5255
2022-03-28,G,RPG,180,503,149841,171036896,2827079456,2998116352
2022-03-28,G,Staff,117,520,128195,35758640,484472724,520231364
2022-03-28,G,TPG,70,590,312193,735709060,9125588089,9861297149
2022-03-28,G,Total,768,5263,1644177,3521047773,70227895721,73748943494
2022-03-28,G,UG,365,3396,994088,1898970877,53699167756,55598138633
2022-03-28,LG1,Alumni,5,42,48221,776740918,359113379,1135854297
2022-03-28,LG1,Non-HKUST,21,341,298771,747471631,8147019746,8894491377
2022-03-28,LG1,Others(HKUST),1,11,178840,8109906,28937841,37047747
2022-03-28,LG1,RPG,39,1258,748959,40566984261,68407360940,108974345201
2022-03-28,LG1,Staff,28,258,193098,408154242,10741882594,11150036836
2022-03-28,LG1,TPG,52,1468,1340847,3119116062,66087761903,69206877965
2022-03-28,LG1,Total,432,13440,12016508,65912751652,572399956098,638312707750
2022-03-28,LG1,UG,286,10062,9207772,20286174632,418627879695,438914054327
2022-03-28,LG3,Alumni,12,63,52866,158604118,1327632542,1486236660
2022-03-28,LG3,Non-HKUST,37,140,52390,67766292,1215153737,1282920029
2022-03-28,LG3,Others(HKUST),16,60,4617,3318415,238747292,242065707
2022-03-28,LG3,RPG,475,1228,218102,305785883,28404897157,28710683040
2022-03-28,LG3,Staff,339,1039,81271,103895336,1404008031,1507903367
2022-03-28,LG3,TPG,99,588,234778,329398365,8562845055,8892243420
2022-03-28,LG3,Total,1513,5935,1702266,3090257673,155661252323,158751509996
2022-03-28,LG3,UG,535,2817,1058242,2121489264,114507968509,116629457773
2022-03-28,LG4,Alumni,9,287,120220,209281343,13745052926,13954334269
2022-03-28,LG4,Non-HKUST,13,50,60296,123725231,4774647856,4898373087
2022-03-28,LG4,Others(HKUST),3,35,63543,11180937,564666751,575847688
2022-03-28,LG4,RPG,85,183,107402,144120404,1854850470,1998970874
2022-03-28,LG4,Staff,68,403,79152,16474433,597009225,613483658
2022-03-28,LG4,TPG,48,403,274675,512978461,24750922428,25263900889
2022-03-28,LG4,Total,469,2633,1458777,3207209038,90809050494,94016259532
2022-03-28,LG4,UG,243,1272,753489,2189448229,44521900838,46711349067
2022-03-29,1,Alumni,3,4,384,15377,57320,72697
2022-03-29,1,Non-HKUST,4,10,24541,133188645,2748661528,2881850173
2022-03-29,1,Others(HKUST),5,5,255,12305,77725,90030
2022-03-29,1,RPG,66,154,93681,82911672,2456387058,2539298730
2022-03-29,1,Staff,60,597,613952,210314392,9607725681,9818040073
2022-03-29,1,TPG,26,383,278477,282091172,9795087292,10077178464
2022-03-29,1,Total,252,2132,1757235,1568326964,48155681725,49724008689
2022-03-29,1,UG,88,979,745945,859793401,23547685121,24407478522
2022-03-29,All-Floors,Alumni,16,381,254750,3103048657,17066666154,20169714811
2022-03-29,All-Floors,Non-HKUST,48,507,445558,1014964687,22327836748,23342801435
2022-03-29,All-Floors,Others(HKUST),26,140,241828,21069091,589315775,610384866
2022-03-29,All-Floors,RPG,573,3501,1565136,6808969706,78000194749,84809164455
2022-03-29,All-Floors,Staff,447,3159,1204220,1101522281,28794044179,29895566460
2022-03-29,All-Floors,TPG,148,4160,2902891,4672301060,111910466300,116582767360
2022-03-29,All-Floors,Total,2013,33437,21833362,50599537785,857254038505,907853576290
2022-03-29,All-Floors,UG,755,21589,15218979,33877662303,598565514600,632443176903
2022-03-29,G,Alumni,9,118,40799,114003906,1276135981,1390139887
2022-03-29,G,Non-HKUST,20,109,30302,22141498,577725903,599867401
2022-03-29,G,Others(HKUST),8,13,21631,112408,409221,521629
2022-03-29,G,RPG,176,598,226104,1303030440,7751494426,9054524866
2022-03-29,G,Staff,137,601,277547,365165525,9338179260,9703344785
2022-03-29,G,TPG,77,899,314702,270618461,11917931751,12188550212
2022-03-29,G,Total,868,5670,1786499,4106017366,77489009378,81595026744
2022-03-29,G,UG,441,3332,875414,2030945128,46627132836,48658077964
2022-03-29,LG1,Alumni,4,96,78306,2725144751,12919853995,15644998746
2022-03-29,LG1,Non-HKUST,19,288,355332,771932492,15146308919,15918241411
2022-03-29,LG1,Others(HKUST),1,6,159047,127694,505728,633422
2022-03-29,LG1,RPG,44,1207,819522,4895457843,55187425758,60082883601
2022-03-29,LG1,Staff,31,552,195402,155517919,5548890092,5704408011
2022-03-29,LG1,TPG,69,1708,1514188,2970624034,52904632352,55875256386
2022-03-29,LG1,Total,503,16799,14848219,37574019377,554480989976,592055009353
2022-03-29,LG1,UG,335,12942,11726422,26055214644,412773373132,438828587776
2022-03-29,LG3,Alumni,15,47,40902,214611264,569458955,784070219
2022-03-29,LG3,Non-HKUST,32,85,34098,87601650,3854132218,3941733868
2022-03-29,LG3,Others(HKUST),19,69,7389,13679209,198551205,212230414
2022-03-29,LG3,RPG,459,1151,216230,196085300,4120993704,4317079004
2022-03-29,LG3,Staff,364,1096,87333,135660025,1677988291,1813648316
2022-03-29,LG3,TPG,119,695,500833,620387642,24974939544,25595327186
2022-03-29,LG3,Total,1574,5890,1890603,4396061153,102207066706,106603127859
2022-03-29,LG3,UG,566,2747,1003818,3128036063,66811002789,69939038852
2022-03-29,LG4,Alumni,8,116,94359,49273359,2301159903,2350433262
2022-03-29,LG4,Non-HKUST,9,15,1285,100402,1008180,1108582
2022-03-29,LG4,Others(HKUST),6,47,53506,7137475,389771896,396909371
2022-03-29,LG4,RPG,149,391,209599,331484451,8483893803,8815378254
2022-03-29,LG4,Staff,74,313,29986,234864420,2621260855,2856125275
2022-03-29,LG4,TPG,65,475,294691,528579751,12317875361,12846455112
2022-03-29,LG4,Total,654,2946,1550806,2955112925,74921290720,77876403645
2022-03-29,LG4,UG,343,1589,867380,1803673067,48806320722,50609993789
2022-03-30,1,Alumni,1,5,941,14032,50578,64610
2022-03-30,1,Non-HKUST,6,14,21496,15634779,723685564,739320343
2022-03-30,1,Others(HKUST),2,2,34,9564,69414,78978
2022-03-30,1,RPG,78,142,50479,20260584,531542567,551803151
2022-03-30,1,Staff,73,1057,657382,258931564,12672778910,12931710474
2022-03-30,1,TPG,19,90,66346,94368808,1680200784,1774569592
2022-03-30,1,Total,283,1814,1425026,1336879709,54234388996,55571268705
2022-03-30,1,UG,104,504,628348,947660378,38626061179,39573721557
2022-03-30,All-Floors,Alumni,6,285,152983,1413991150,6850681340,8264672490
2022-03-30,All-Floors,Non-HKUST,37,290,252579,443287391,7274939831,7718227222
2022-03-30,All-Floors,Others(HKUST),13,141,277749,6040838,414788015,420828853
2022-03-30,All-Floors,RPG,470,2605,1337028,11516836348,71532850656,83049687004
2022-03-30,All-Floors,Staff,345,3201,1263855,726541540,28069705846,28796247386
2022-03-30,All-Floors,TPG,118,3188,2614798,6884721549,174655165010,181539886559
2022-03-30,All-Floors,Total,1679,29404,20154735,56803529131,860312500124,917116029255
2022-03-30,All-Floors,UG,690,19694,14255743,35812110315,571514369426,607326479741
2022-03-30,G,Alumni,4,29,1335,496062,19077908,19573970
2022-03-30,G,Non-HKUST,16,76,30127,166166552,1694700087,1860866639
2022-03-30,G,Others(HKUST),8,14,30264,21199,137587,158786
2022-03-30,G,RPG,204,593,203798,4017968690,11278167492,15296136182
2022-03-30,G,Staff,144,611,196458,72472992,2894672769,2967145761
2022-03-30,G,TPG,76,903,307684,619234628,57857160406,58476395034
2022-03-30,G,Total,879,5254,1613775,8692463782,114553918252,123246382034
2022-03-30,G,UG,427,3028,844109,3816103659,40810002003,44626105662
2022-03-30,LG1,Alumni,2,24,34601,1300977736,2672020195,3972997931
2022-03-30,LG1,Non-HKUST,12,145,188716,216932507,4078238880,4295171387
2022-03-30,LG1,Others(HKUST),2,15,179636,36521,111089,147610
2022-03-30,LG1,RPG,36,674,741731,7011061240,43790721989,50801783229
2022-03-30,LG1,Staff,37,328,248225,263167763,9378354562,9641522325
2022-03-30,LG1,TPG,55,1219,1455816,5325171011,51946493215,57271664226
2022-03-30,LG1,Total,479,13500,13582163,41660655543,516905400636,558566056179
2022-03-30,LG1,UG,335,11095,10733438,27543308765,405039460706,432582769471
2022-03-30,LG3,Alumni,5,20,29050,22970288,1651488108,1674458396
2022-03-30,LG3,Non-HKUST,20,29,8552,42543006,638191359,680734365
2022-03-30,LG3,Others(HKUST),6,44,3103,151377,5768157,5919534
2022-03-30,LG3,RPG,273,588,131123,112534282,4119926683,4232460965
2022-03-30,LG3,Staff,217,773,97678,35277632,734410410,769688042
2022-03-30,LG3,TPG,75,572,529303,580269396,17616821994,18197091390
2022-03-30,LG3,Total,1054,4770,1753284,2004909346,60414249527,62419158873
2022-03-30,LG3,UG,458,2744,954475,1211163365,35647642816,36858806181
2022-03-30,LG4,Alumni,4,207,87056,89533032,2508044551,2597577583
2022-03-30,LG4,Non-HKUST,18,26,3688,2010547,140123941,142134488
2022-03-30,LG4,Others(HKUST),7,66,64712,5822177,408701768,414523945
2022-03-30,LG4,RPG,250,608,209897,355011552,11812491925,12167503477
2022-03-30,LG4,Staff,161,432,64112,96691589,2389489195,2486180784
2022-03-30,LG4,TPG,76,404,255649,265677706,45554488611,45820166317
2022-03-30,LG4,Total,967,4066,1780487,3108620751,114204542713,117313163464
2022-03-30,LG4,UG,451,2323,1095373,2293874148,51391202722,53685076870
2022-03-31,1,Alumni,5,5,450,116078,4109998,4226076
2022-03-31,1,Non-HKUST,9,17,13465,13540762,685505512,699046274
2022-03-31,1,Others(HKUST),1,1,5,0,0,0
2022-03-31,1,RPG,62,163,129266,205784766,8302182168,8507966934
2022-03-31,1,Staff,62,672,663766,400180791,11878047074,12278227865
2022-03-31,1,TPG,15,72,121382,81578611,4283639810,4365218421
2022-03-31,1,Total,253,1651,1606668,1582535916,56102363820,57684899736
2022-03-31,1,UG,99,721,678334,881334908,30948879258,31830214166
2022-03-31,All-Floors,Alumni,13,699,335063,923169732,22894884718,23818054450
2022-03-31,All-Floors,Non-HKUST,44,561,382451,821061938,13788045692,14609107630
2022-03-31,All-Floors,Others(HKUST),14,133,283923,27860214,1940630022,1968490236
2022-03-31,All-Floors,RPG,451,2546,1419554,6880512513,107214522106,114095034619
2022-03-31,All-Floors,Staff,310,2442,1303272,1115809416,48061694022,49177503438
2022-03-31,All-Floors,TPG,114,2279,2273925,5046476173,102241805576,107288281749
2022-03-31,All-Floors,Total,1631,27036,19372889,56638548758,898022105920,954660654678
2022-03-31,All-Floors,UG,685,18376,13374701,41823658772,601880523784,643704182556
2022-03-31,G,Alumni,12,205,38602,243382452,1734886939,1978269391
2022-03-31,G,Non-HKUST,22,107,77930,81773404,3316795389,3398568793
2022-03-31,G,Others(HKUST),6,8,20698,3196,5651,8847
2022-03-31,G,RPG,227,572,269983,1275130468,60061293662,61336424130
2022-03-31,G,Staff,132,478,274413,191577718,18475269817,18666847535
2022-03-31,G,TPG,72,548,204203,461188264,8793748156,9254936420
2022-03-31,G,Total,890,5047,1730755,4226176818,129217488746,133443665564
2022-03-31,G,UG,419,3129,844926,1973121316,36835489132,38808610448
2022-03-31,LG1,Alumni,7,331,171317,554171500,16620479508,17174651008
2022-03-31,LG1,Non-HKUST,15,92,238554,664340844,7630350341,8294691185
2022-03-31,LG1,Others(HKUST),2,9,178767,668675,1618711,2287386
2022-03-31,LG1,RPG,44,754,752169,3824275907,27234115582,31058391489
2022-03-31,LG1,Staff,32,451,254927,459443901,15991621073,16451064974
2022-03-31,LG1,TPG,49,1019,1455207,3869048751,61149724342,65018773093
2022-03-31,LG1,Total,434,13281,13185342,42062937930,569007536482,611070474412
2022-03-31,LG1,UG,285,10625,10134401,32690988352,440379626925,473070615277
2022-03-31,LG3,Alumni,7,32,18342,33962751,972772843,1006735594
2022-03-31,LG3,Non-HKUST,20,235,47941,53848978,1770202205,1824051183
2022-03-31,LG3,Others(HKUST),7,36,960,9642537,323801389,333443926
2022-03-31,LG3,RPG,231,544,74227,750797627,1614456378,2365254005
2022-03-31,LG3,Staff,191,546,91323,41298068,994409982,1035708050
2022-03-31,LG3,TPG,67,287,299257,349303317,12260885330,12610188647
2022-03-31,LG3,Total,953,3657,1402464,3004271205,73899692755,76903963960
2022-03-31,LG3,UG,430,1977,870414,1765417927,55963164628,57728582555
2022-03-31,LG4,Alumni,7,126,106352,91536951,3562635430,3654172381
2022-03-31,LG4,Non-HKUST,21,110,4561,7557950,385192245,392750195
2022-03-31,LG4,Others(HKUST),8,79,83493,17545806,1615204271,1632750077
2022-03-31,LG4,RPG,214,513,193909,824523745,10002474316,10826998061
2022-03-31,LG4,Staff,150,295,18843,23308938,722346076,745655014
2022-03-31,LG4,TPG,69,353,193876,285357230,15753807938,16039165168
2022-03-31,LG4,Total,919,3400,1447660,5762626889,69795024117,75557651006
2022-03-31,LG4,UG,450,1924,846626,4512796269,37753363841,42266160110
