Date,Floor,User-Group,User-Count,WiFi-Conn,Duration-Sec,Traffic-In-Byte,Traffic-Out-Byte,Traffic-Both-Byte
2014-12-01,1,Staff,60,530,712526,10988745726,508529468,11497275194
2014-12-01,1,TPG,57,387,757991,17509872182,1305886958,18815759140
2014-12-01,1,RPG,19,55,64189,229146036,35332813,264478849
2014-12-01,1,UG,258,2187,3715578,108816402132,51038122307,159854524439
2014-12-01,1,Alumni,6,77,54952,11692855674,428749548,12121605222
2014-12-01,1,Others(HKUST),4,29,92163,199631777,18651717,218283494
2014-12-01,1,Non-HKUST,8,58,104760,5574380861,428901242,6003282103
2014-12-01,1,Total,412,3323,5502159,155011034388,53764174053,208775208441
2014-12-01,G,Staff,123,583,450426,1264276021,477744197,1742020218
2014-12-01,G,TPG,348,2144,2115789,12435551121,4467823307,16903374428
2014-12-01,G,RPG,160,612,585594,1051033721,228535629,1279569350
2014-12-01,G,UG,872,4840,4162730,10014004362,3512115795,13526120157
2014-12-01,G,Alumni,14,82,52309,780425,812641,1593066
2014-12-01,G,Others(HKUST),13,98,216635,16495739,4742000,21237739
2014-12-01,G,Non-HKUST,25,91,102202,2643299600,141902970,2785202570
2014-12-01,G,Total,1555,8450,7685685,27425440989,8833676539,36259117528
2014-12-01,LG1,Staff,135,479,363793,730125435,320436978,1050562413
2014-12-01,LG1,TPG,558,6959,7544892,89580515316,6954065787,96534581103
2014-12-01,LG1,RPG,214,1539,1596020,3546097675,394235183,3940332858
2014-12-01,LG1,UG,1701,20886,22255641,77362193935,24617213847,101979407782
2014-12-01,LG1,Alumni,24,182,198440,332052325,31991106,364043431
2014-12-01,LG1,Others(HKUST),19,211,300409,33751949,21865276,55617225
2014-12-01,LG1,Non-HKUST,47,238,247232,79334302,20284936,99619238
2014-12-01,LG1,Total,2698,30494,32506427,171664070937,32360093113,204024164050
2014-12-01,LG3,Staff,145,330,182739,2033033785,155477940,2188511725
2014-12-01,LG3,TPG,387,3794,4099222,127814192074,15632671918,143446863992
2014-12-01,LG3,RPG,269,1119,1247039,23691947361,4490061230,28182008591
2014-12-01,LG3,UG,990,4489,4581056,94926619260,13815716561,108742335821
2014-12-01,LG3,Alumni,10,67,97644,1208209808,525122141,1733331949
2014-12-01,LG3,Others(HKUST),16,67,17066,22038156,4029216,26067372
2014-12-01,LG3,Non-HKUST,33,212,222440,400656671,224021445,624678116
2014-12-01,LG3,Total,1850,10078,10447206,250096697115,34847100451,284943797566
2014-12-01,LG4,Staff,117,426,439847,2767362569,2668205552,5435568121
2014-12-01,LG4,TPG,396,5941,9226541,194165161441,58591467238,252756628679
2014-12-01,LG4,RPG,219,2197,3001658,58625313151,19209191396,77834504547
2014-12-01,LG4,UG,1071,10791,14425004,255214824187,74445248658,329660072845
2014-12-01,LG4,Alumni,17,305,314413,2698087672,511035816,3209123488
2014-12-01,LG4,Others(HKUST),16,271,416071,98171922060,3733068731,101904990791
2014-12-01,LG4,Non-HKUST,39,445,534987,12477799172,1030373328,13508172500
2014-12-01,LG4,Total,1875,20376,28358521,624120470252,160188590719,784309060971
2014-12-01,All-Floors,Staff,355,2348,2149331,17783543536,4130394135,21913937671
2014-12-01,All-Floors,TPG,730,19225,23744435,441505292134,86951915208,528457207342
2014-12-01,All-Floors,RPG,498,5522,6494500,87143537944,24357356251,111500894195
2014-12-01,All-Floors,UG,2412,43193,49140009,546334043876,167428417168,713762461044
2014-12-01,All-Floors,Alumni,34,713,717758,15931985904,1497711252,17429697156
2014-12-01,All-Floors,Others(HKUST),32,676,1042344,98443839681,3782356940,102226196621
2014-12-01,All-Floors,Non-HKUST,86,1044,1211621,21175470606,1845483921,23020954527
2014-12-01,All-Floors,Total,4147,72721,84499998,1228317713681,289993634875,1518311348556
2014-12-02,1,Staff,62,618,770858,8255975631,618564109,8874539740
2014-12-02,1,TPG,65,784,1313054,26044363248,3073109957,29117473205
2014-12-02,1,RPG,22,62,83327,651743570,116541713,768285283
2014-12-02,1,UG,278,2359,4258957,119524808107,13012454693,132537262800
2014-12-02,1,Alumni,4,50,68720,6032002905,247263444,6279266349
2014-12-02,1,Others(HKUST),3,67,90114,6290751757,179185891,6469937648
2014-12-02,1,Non-HKUST,11,61,128091,346153529,96021061,442174590
2014-12-02,1,Total,445,4001,6713121,167145798747,17343140868,184488939615
2014-12-02,G,Staff,115,584,451756,1031112304,177034004,1208146308
2014-12-02,G,TPG,360,2328,1920095,2476384031,322276444,2798660475
2014-12-02,G,RPG,178,827,762349,1587833103,394666109,1982499212
2014-12-02,G,UG,877,4929,4894494,17946762403,6303299298,24250061701
2014-12-02,G,Alumni,15,67,55792,33898835,8891559,42790394
2014-12-02,G,Others(HKUST),21,99,191340,14944444,1215261,16159705
2014-12-02,G,Non-HKUST,24,97,94429,313894164,83390702,397284866
2014-12-02,G,Total,1590,8931,8370255,23404829284,7290773377,30695602661
2014-12-02,LG1,Staff,117,540,516215,569298988,234504436,803803424
2014-12-02,LG1,TPG,612,7530,9186038,18296729277,2827898379,21124627656
2014-12-02,LG1,RPG,211,1335,1316172,951296495,121935818,1073232313
2014-12-02,LG1,UG,1677,18906,21376418,87900798254,16522817100,104423615354
2014-12-02,LG1,Alumni,19,144,153786,196347233,15229622,211576855
2014-12-02,LG1,Others(HKUST),23,256,309626,43827275,25833141,69660416
2014-12-02,LG1,Non-HKUST,44,244,339909,299450573,306531244,605981817
2014-12-02,LG1,Total,2703,28955,33198164,108257748095,20054749740,128312497835
2014-12-02,LG3,Staff,165,497,422815,2455209473,11666612867,14121822340
2014-12-02,LG3,TPG,386,3415,4106654,87753612622,23852181956,111605794578
2014-12-02,LG3,RPG,238,1140,1352141,17706616044,5019134168,22725750212
2014-12-02,LG3,UG,921,4458,4763257,88202613463,15793122879,103995736342
2014-12-02,LG3,Alumni,14,33,65470,1005684909,40042176,1045727085
2014-12-02,LG3,Others(HKUST),24,74,15974,11951448,1901410,13852858
2014-12-02,LG3,Non-HKUST,23,142,183924,1796779573,200541309,1997320882
2014-12-02,LG3,Total,1771,9759,10910235,198932467532,56573536765,255506004297
2014-12-02,LG4,Staff,110,440,345526,2391300025,257224092,2648524117
2014-12-02,LG4,TPG,430,7561,10438661,153936009544,35957761039,189893770583
2014-12-02,LG4,RPG,254,2345,2857743,50808700897,6025165932,56833866829
2014-12-02,LG4,UG,1008,11120,14743647,303620669876,27933329616,331553999492
2014-12-02,LG4,Alumni,13,287,311074,4175097587,227277470,4402375057
2014-12-02,LG4,Others(HKUST),23,282,373145,10564151308,4707433371,15271584679
2014-12-02,LG4,Non-HKUST,44,416,540236,6924041261,540367196,7464408457
2014-12-02,LG4,Total,1882,22451,29610032,532419970498,75648558716,608068529214
2014-12-02,All-Floors,Staff,355,2679,2507170,14702896421,12953939508,27656835929
2014-12-02,All-Floors,TPG,759,21618,26964502,288507098722,66033227775,354540326497
2014-12-02,All-Floors,RPG,499,5709,6371732,71706190109,11677443740,83383633849
2014-12-02,All-Floors,UG,2388,41772,50036773,617195652103,79565023586,696760675689
2014-12-02,All-Floors,Alumni,31,581,654842,11443031469,538704271,11981735740
2014-12-02,All-Floors,Others(HKUST),40,778,980199,16925626232,4915569074,21841195306
2014-12-02,All-Floors,Non-HKUST,87,960,1286589,9680319100,1226851512,10907170612
2014-12-02,All-Floors,Total,4159,74097,88801807,1030160814156,176910759466,1207071573622
2014-12-03,1,Staff,61,631,807162,19381586943,1329320745,20710907688
2014-12-03,1,TPG,73,854,1398979,39329915465,6260573155,45590488620
2014-12-03,1,RPG,27,63,56660,623554820,82684833,706239653
2014-12-03,1,UG,301,2940,4769678,187189842926,20860734666,208050577592
2014-12-03,1,Alumni,6,80,85881,5982336438,456293842,6438630280
2014-12-03,1,Others(HKUST),5,45,41281,43178545,3866633,47045178
2014-12-03,1,Non-HKUST,14,135,262751,5693145528,569710579,6262856107
2014-12-03,1,Total,487,4748,7422392,258243560665,29563184453,287806745118
2014-12-03,G,Staff,106,486,363851,1305757168,141595242,1447352410
2014-12-03,G,TPG,345,2279,2157966,5740988642,4963947266,10704935908
2014-12-03,G,RPG,147,762,658414,3420493713,1215148685,4635642398
2014-12-03,G,UG,883,5288,5627005,24427983655,1993750672,26421734327
2014-12-03,G,Alumni,12,64,60906,77465190,2373771,79838961
2014-12-03,G,Others(HKUST),12,109,245901,331286843,21134412,352421255
2014-12-03,G,Non-HKUST,23,100,82101,3025760381,153011730,3178772111
2014-12-03,G,Total,1528,9088,9196144,38329735592,8490961778,46820697370
2014-12-03,LG1,Staff,117,582,509086,785635533,72307009,857942542
2014-12-03,LG1,TPG,578,7113,8714903,24579106368,13512139728,38091246096
2014-12-03,LG1,RPG,204,1518,1601572,5588475614,2395715313,7984190927
2014-12-03,LG1,UG,1714,19196,23186750,60947503222,11525510148,72473013370
2014-12-03,LG1,Alumni,19,220,308458,400022935,22166139,422189074
2014-12-03,LG1,Others(HKUST),22,187,313504,94010519,91508130,185518649
2014-12-03,LG1,Non-HKUST,58,324,377411,838581721,75560700,914142421
2014-12-03,LG1,Total,2712,29140,35011684,93233335912,27694907167,120928243079
2014-12-03,LG3,Staff,151,480,284265,2067315785,369431328,2436747113
2014-12-03,LG3,TPG,392,3632,4684806,90039670801,10881391226,100921062027
2014-12-03,LG3,RPG,250,1161,1467944,16014030310,1545882898,17559913208
2014-12-03,LG3,UG,966,4781,5098181,111345438553,11409174237,122754612790
2014-12-03,LG3,Alumni,15,87,65565,932982309,42920944,975903253
2014-12-03,LG3,Others(HKUST),18,70,54510,516165408,96864157,613029565
2014-12-03,LG3,Non-HKUST,22,113,150393,2939080190,1548796249,4487876439
2014-12-03,LG3,Total,1814,10324,11805664,223854683356,25894461039,249749144395
2014-12-03,LG4,Staff,114,390,301078,6245024275,488248773,6733273048
2014-12-03,LG4,TPG,445,8258,11562968,190404761032,64048508934,254453269966
2014-12-03,LG4,RPG,209,1906,2341033,27540763076,8607965241,36148728317
2014-12-03,LG4,UG,1071,12031,16591919,354360799611,28729197646,383089997257
2014-12-03,LG4,Alumni,12,275,313955,1400682794,125111418,1525794212
2014-12-03,LG4,Others(HKUST),15,231,278303,16849926182,6555152650,23405078832
2014-12-03,LG4,Non-HKUST,36,346,380125,3530272842,424165748,3954438590
2014-12-03,LG4,Total,1902,23437,31769381,600332229812,108978350410,709310580222
2014-12-03,All-Floors,Staff,342,2569,2265442,29785319704,2400903097,32186222801
2014-12-03,All-Floors,TPG,732,22136,28519622,350094442308,99666560309,449761002617
2014-12-03,All-Floors,RPG,475,5410,6125623,53187317533,13847396970,67034714503
2014-12-03,All-Floors,UG,2415,44236,55273533,738271567967,74518367369,812789935336
2014-12-03,All-Floors,Alumni,34,726,834765,8793489666,648866114,9442355780
2014-12-03,All-Floors,Others(HKUST),37,642,933499,17834567497,6768525982,24603093479
2014-12-03,All-Floors,Non-HKUST,90,1018,1252781,16026840662,2771245006,18798085668
2014-12-03,All-Floors,Total,4125,76737,95205265,1213993545337,200621864847,1414615410184
2014-12-04,1,Staff,65,502,812633,22319398404,1071529213,23390927617
2014-12-04,1,TPG,62,547,1214745,27938878888,2074659072,30013537960
2014-12-04,1,RPG,19,54,78240,1338755250,108307283,1447062533
2014-12-04,1,UG,287,2560,5200478,282006625170,24448236682,306454861852
2014-12-04,1,Alumni,6,39,52847,4928429527,177647860,5106077387
2014-12-04,1,Others(HKUST),2,29,21371,15537184,5285831,20823015
2014-12-04,1,Non-HKUST,10,79,131707,7121719208,456590475,7578309683
2014-12-04,1,Total,451,3810,7512021,345669343631,28342256416,374011600047
2014-12-04,G,Staff,103,409,345172,2049213080,93863414,2143076494
2014-12-04,G,TPG,340,2054,2409310,7190909105,2869835056,10060744161
2014-12-04,G,RPG,120,520,457632,289275177,28140571,317415748
2014-12-04,G,UG,753,4288,4825313,35067997435,4567807299,39635804734
2014-12-04,G,Alumni,14,46,33202,17253884,66471332,83725216
2014-12-04,G,Others(HKUST),13,114,284291,214851542,100265619,315117161
2014-12-04,G,Non-HKUST,19,63,27654,119668256,9315483,128983739
2014-12-04,G,Total,1362,7494,8382574,44949168479,7735698774,52684867253
2014-12-04,LG1,Staff,103,532,469854,2008284459,188593711,2196878170
2014-12-04,LG1,TPG,576,6389,8102998,20437930198,8876779135,29314709333
2014-12-04,LG1,RPG,198,1626,2066526,13736027353,1380580748,15116608101
2014-12-04,LG1,UG,1569,17161,22809983,75784044671,21753522204,97537566875
2014-12-04,LG1,Alumni,18,147,198605,308174772,19569206,327743978
2014-12-04,LG1,Others(HKUST),14,189,393725,648079284,179635174,827714458
2014-12-04,LG1,Non-HKUST,43,185,263392,1837673,1030539,2868212
2014-12-04,LG1,Total,2521,26229,34305083,112924378410,32399710717,145324089127
2014-12-04,LG3,Staff,138,419,304926,3021883450,593805729,3615689179
2014-12-04,LG3,TPG,403,3292,4679520,74789653602,10652619203,85442272805
2014-12-04,LG3,RPG,230,985,1108146,14648848449,2430843360,17079691809
2014-12-04,LG3,UG,934,3764,4143526,90696301143,13084463438,103780764581
2014-12-04,LG3,Alumni,8,18,22651,109412643,23768893,133181536
2014-12-04,LG3,Others(HKUST),11,61,60097,641128743,152276739,793405482
2014-12-04,LG3,Non-HKUST,27,119,117926,1151424350,650432289,1801856639
2014-12-04,LG3,Total,1751,8658,10436792,185058652380,27588209651,212646862031
2014-12-04,LG4,Staff,94,309,300713,4133664582,582384593,4716049175
2014-12-04,LG4,TPG,387,6667,10192166,194898625124,24149158584,219047783708
2014-12-04,LG4,RPG,190,1689,2282151,30444776744,14277316145,44722092889
2014-12-04,LG4,UG,1014,10493,16232059,253160809108,42833794407,295994603515
2014-12-04,LG4,Alumni,15,270,308382,2285882852,193257999,2479140851
2014-12-04,LG4,Others(HKUST),16,160,219537,14775986398,3230609898,18006596296
2014-12-04,LG4,Non-HKUST,35,291,611696,6002646588,494589673,6497236261
2014-12-04,LG4,Total,1751,19879,30146704,505702391396,85761111299,591463502695
2014-12-04,All-Floors,Staff,318,2171,2233298,33532443975,2530176660,36062620635
2014-12-04,All-Floors,TPG,747,18949,26598739,325255996917,48623051050,373879047967
2014-12-04,All-Floors,RPG,456,4874,5992695,60457682973,18225188107,78682871080
2014-12-04,All-Floors,UG,2307,38266,53211359,736715777527,106687824030,843403601557
2014-12-04,All-Floors,Alumni,32,520,615687,7649153678,480715290,8129868968
2014-12-04,All-Floors,Others(HKUST),31,553,979021,16295583151,3668073261,19963656412
2014-12-04,All-Floors,Non-HKUST,79,737,1152375,14397296075,1611958459,16009254534
2014-12-04,All-Floors,Total,3970,66070,90783174,1194303934296,181826986857,1376130921153
2014-12-05,1,Staff,52,463,844021,7774801175,2289710518,10064511693
2014-12-05,1,TPG,69,717,1410101,70971741034,7906650169,78878391203
2014-12-05,1,RPG,23,121,118598,1553517649,144531947,1698049596
2014-12-05,1,UG,286,2816,4530790,210598951655,28404282516,239003234171
2014-12-05,1,Alumni,3,39,55339,293894783,104290171,398184954
2014-12-05,1,Others(HKUST),2,33,36373,11474851,3325731,14800582
2014-12-05,1,Non-HKUST,9,99,123659,6554753462,303393213,6858146675
2014-12-05,1,Total,444,4288,7118881,297759134609,39156184265,336915318874
2014-12-05,G,Staff,98,392,472300,1375003527,102611877,1477615404
2014-12-05,G,TPG,356,2071,2009641,4943528991,1014613633,5958142624
2014-12-05,G,RPG,137,592,701655,1013374058,203462124,1216836182
2014-12-05,G,UG,767,4016,4432161,21115793238,2499083801,23614877039
2014-12-05,G,Alumni,13,65,74358,1590251029,70579702,1660830731
2014-12-05,G,Others(HKUST),19,124,277651,140191116,13435084,153626200
2014-12-05,G,Non-HKUST,29,65,64538,2273618064,97252613,2370870677
2014-12-05,G,Total,1419,7325,8032304,32451760023,4001038834,36452798857
2014-12-05,LG1,Staff,98,478,312537,338840548,61658626,400499174
2014-12-05,LG1,TPG,580,7232,9608707,48138561878,4955836622,53094398500
2014-12-05,LG1,RPG,185,1263,1362782,621507351,290040989,911548340
2014-12-05,LG1,UG,1588,18522,23032289,119349151245,12898060222,132247211467
2014-12-05,LG1,Alumni,22,167,158412,143758967,14843082,158602049
2014-12-05,LG1,Others(HKUST),18,336,553957,261536996,129231765,390768761
2014-12-05,LG1,Non-HKUST,55,255,368611,2949086,2006474,4955560
2014-12-05,LG1,Total,2546,28253,35397295,168856306071,18351677780,187207983851
2014-12-05,LG3,Staff,133,364,255404,5359872972,315106513,5674979485
2014-12-05,LG3,TPG,419,3574,5031307,78674592798,9468320643,88142913441
2014-12-05,LG3,RPG,224,1031,1097924,13951941503,4185073041,18137014544
2014-12-05,LG3,UG,896,3727,4403207,113117901923,9570745845,122688647768
2014-12-05,LG3,Alumni,13,43,60870,2435731169,113670232,2549401401
2014-12-05,LG3,Others(HKUST),11,38,2899,2830341,670899,3501240
2014-12-05,LG3,Non-HKUST,30,107,128778,2626873457,196339728,2823213185
2014-12-05,LG3,Total,1726,8884,10980389,216169744163,23849926901,240019671064
2014-12-05,LG4,Staff,100,268,225555,1495180381,165958659,1661139040
2014-12-05,LG4,TPG,423,6593,10431887,148462667959,34926364320,183389032279
2014-12-05,LG4,RPG,175,1573,2041439,43500014512,7940718646,51440733158
2014-12-05,LG4,UG,956,9491,15044761,297519978495,33538251605,331058230100
2014-12-05,LG4,Alumni,17,381,531652,10182524633,990411180,11172935813
2014-12-05,LG4,Others(HKUST),11,216,217237,39997472027,10687879599,50685351626
2014-12-05,LG4,Non-HKUST,43,309,505588,5873358036,457536557,6330894593
2014-12-05,LG4,Total,1725,18831,28998119,547031196043,88707120566,635738316609
2014-12-05,All-Floors,Staff,309,1965,2109817,16343698603,2935046193,19278744796
2014-12-05,All-Floors,TPG,747,20187,28491643,351191092660,58271785387,409462878047
2014-12-05,All-Floors,RPG,425,4580,5322398,60640355073,12763826747,73404181820
2014-12-05,All-Floors,UG,2312,38572,51443208,761701776556,86910423989,848612200545
2014-12-05,All-Floors,Alumni,30,695,880631,14646160581,1293794367,15939954948
2014-12-05,All-Floors,Others(HKUST),35,747,1088117,40413505331,10834543078,51248048409
2014-12-05,All-Floors,Non-HKUST,102,835,1191174,17331552105,1056528585,18388080690
2014-12-05,All-Floors,Total,3960,67581,90526988,1262268140909,174065948346,1436334089255
2014-12-06,1,Staff,15,120,131740,1675374337,206464206,1881838543
2014-12-06,1,TPG,75,667,1218549,90465186817,7369832628,97835019445
2014-12-06,1,RPG,18,55,87816,1762763016,132997710,1895760726
2014-12-06,1,UG,146,1894,3495345,130257595719,11057351617,141314947336
2014-12-06,1,Alumni,2,10,26389,704530415,44978269,749508684
2014-12-06,1,Others(HKUST),3,8,9361,7130592,2145942,9276534
2014-12-06,1,Non-HKUST,3,17,15487,1017692396,50860350,1068552746
2014-12-06,1,Total,262,2771,4984687,225890273292,18864630722,244754904014
2014-12-06,G,Staff,48,226,143350,349123863,716810829,1065934692
2014-12-06,G,TPG,333,2022,1973865,8798832338,1314500820,10113333158
2014-12-06,G,RPG,89,456,657264,3489041599,472787291,3961828890
2014-12-06,G,UG,513,3537,4357645,14037006741,4604278765,18641285506
2014-12-06,G,Alumni,17,99,99301,516507990,240949999,757457989
2014-12-06,G,Others(HKUST),8,44,174335,78926343,5538674,84465017
2014-12-06,G,Non-HKUST,23,64,86826,606349676,74101885,680451561
2014-12-06,G,Total,1031,6448,7492586,27875788550,7428968263,35304756813
2014-12-06,LG1,Staff,51,292,227677,2550008030,106279949,2656287979
2014-12-06,LG1,TPG,614,8203,10470868,28122092581,5127621451,33249714032
2014-12-06,LG1,RPG,162,1439,1751646,5307429247,1757725631,7065154878
2014-12-06,LG1,UG,1176,15345,19998661,88581447084,14954274925,103535722009
2014-12-06,LG1,Alumni,24,116,170674,246066120,40792904,286859024
2014-12-06,LG1,Others(HKUST),10,203,452204,552655054,160848849,713503903
2014-12-06,LG1,Non-HKUST,54,230,440518,97708712,9509446,107218158
2014-12-06,LG1,Total,2091,25828,33512248,125457406828,22157053155,147614459983
2014-12-06,LG3,Staff,67,200,106975,547841081,94431156,642272237
2014-12-06,LG3,TPG,430,3481,4417481,56251165660,9369829198,65620994858
2014-12-06,LG3,RPG,152,646,769859,14184560771,2063516616,16248077387
2014-12-06,LG3,UG,713,3119,3792029,64763602975,6442622833,71206225808
2014-12-06,LG3,Alumni,21,210,140382,3873181938,239368215,4112550153
2014-12-06,LG3,Others(HKUST),9,47,25087,3688473,1965511,5653984
2014-12-06,LG3,Non-HKUST,36,172,213217,1498820179,161097479,1659917658
2014-12-06,LG3,Total,1428,7875,9465030,141122861077,18372831008,159495692085
2014-12-06,LG4,Staff,40,155,206876,3986462093,321573805,4308035898
2014-12-06,LG4,TPG,427,6966,11270999,169246970683,36610685767,205857656450
2014-12-06,LG4,RPG,142,1333,1752382,22526740320,3086525510,25613265830
2014-12-06,LG4,UG,699,7860,12523144,249691491866,28793380100,278484871966
2014-12-06,LG4,Alumni,23,334,440315,7295847816,709095185,8004943001
2014-12-06,LG4,Others(HKUST),9,277,496955,75737646430,28579784238,104317430668
2014-12-06,LG4,Non-HKUST,44,372,616261,16566750862,1366811508,17933562370
2014-12-06,LG4,Total,1384,17297,27306932,545051910070,99467856113,644519766183
2014-12-06,All-Floors,Staff,131,993,816618,9108809404,1445559945,10554369349
2014-12-06,All-Floors,TPG,797,21339,29351762,352884248079,59792469864,412676717943
2014-12-06,All-Floors,RPG,316,3929,5018967,47270534953,7513552758,54784087711
2014-12-06,All-Floors,UG,1638,31755,44166824,547331144385,65851908240,613183052625
2014-12-06,All-Floors,Alumni,42,769,877061,12636134279,1275184572,13911318851
2014-12-06,All-Floors,Others(HKUST),19,579,1157942,76380046892,28750283214,105130330106
2014-12-06,All-Floors,Non-HKUST,98,855,1372309,19787321825,1662380668,21449702493
2014-12-06,All-Floors,Total,3041,60219,82761483,1065398239817,166291339261,1231689579078
2014-12-07,1,Staff,11,111,266759,14399847053,17419869063,31819716116
2014-12-07,1,TPG,67,733,1420312,58580612124,19534828121,78115440245
2014-12-07,1,RPG,12,74,69277,514863236,441670332,956533568
2014-12-07,1,UG,236,2960,4692724,96834210219,12066538361,108900748580
2014-12-07,1,Alumni,6,86,146018,4269255989,411463362,4680719351
2014-12-07,1,Others(HKUST),1,7,1314,129715,73856,203571
2014-12-07,1,Non-HKUST,7,34,70548,770273177,67355920,837629097
2014-12-07,1,Total,340,4005,6666952,175369191513,49941799015,225310990528
2014-12-07,G,Staff,34,155,205152,97486768,66221988,163708756
2014-12-07,G,TPG,370,2499,2658999,10323630776,872159873,11195790649
2014-12-07,G,RPG,111,593,539424,1436262515,1018727297,2454989812
2014-12-07,G,UG,630,4116,4223492,11990211754,2375214268,14365426022
2014-12-07,G,Alumni,23,118,214457,1567941974,517417586,2085359560
2014-12-07,G,Others(HKUST),6,51,193043,44026,48707,92733
2014-12-07,G,Non-HKUST,34,142,113496,20261418,6533795,26795213
2014-12-07,G,Total,1208,7674,8148063,25435839231,4856323514,30292162745
2014-12-07,LG1,Staff,42,174,156764,2083880945,437841066,2521722011
2014-12-07,LG1,TPG,628,9580,10254757,23253841595,3602592819,26856434414
2014-12-07,LG1,RPG,198,1740,1910060,7032302408,1666285647,8698588055
2014-12-07,LG1,UG,1352,18931,22326277,106658508054,12762416258,119420924312
2014-12-07,LG1,Alumni,31,156,104565,6194431,813751,7008182
2014-12-07,LG1,Others(HKUST),11,226,442956,131754764,134883197,266637961
2014-12-07,LG1,Non-HKUST,60,310,303123,138107820,8993299,147101119
2014-12-07,LG1,Total,2322,31117,35498502,139304590017,18613826037,157918416054
2014-12-07,LG3,Staff,34,137,132564,1509435209,110645215,1620080424
2014-12-07,LG3,TPG,454,4491,5530211,186813893522,24436375440,211250268962
2014-12-07,LG3,RPG,179,890,926059,12664363396,2343276427,15007639823
2014-12-07,LG3,UG,822,3706,3999442,81716456561,8323290946,90039747507
2014-12-07,LG3,Alumni,18,113,172317,5379128417,309858855,5688987272
2014-12-07,LG3,Others(HKUST),9,38,41327,25188743,2429836,27618579
2014-12-07,LG3,Non-HKUST,25,122,188348,2426708540,180758673,2607467213
2014-12-07,LG3,Total,1541,9497,10990268,290535174388,35706635392,326241809780
2014-12-07,LG4,Staff,20,104,185833,400613976,226122319,626736295
2014-12-07,LG4,TPG,447,8686,12745976,256611919563,47209261601,303821181164
2014-12-07,LG4,RPG,146,1533,2081755,18278394347,6126281252,24404675599
2014-12-07,LG4,UG,912,11064,16799997,197058877641,48466751274,245525628915
2014-12-07,LG4,Alumni,24,316,410546,4639720835,923116077,5562836912
2014-12-07,LG4,Others(HKUST),8,187,351078,20922300660,18093025270,39015325930
2014-12-07,LG4,Non-HKUST,54,497,822591,12487133977,1687370026,14174504003
2014-12-07,LG4,Total,1611,22387,33397776,510398960999,122731927819,633130888818
2014-12-07,All-Floors,Staff,91,681,947072,18491263951,18260699651,36751963602
2014-12-07,All-Floors,TPG,754,25989,32610255,535583897580,95655217854,631239115434
2014-12-07,All-Floors,RPG,363,4830,5526575,39926185902,11596240955,51522426857
2014-12-07,All-Floors,UG,1847,40777,52041932,494258264229,83994211107,578252475336
2014-12-07,All-Floors,Alumni,48,789,1047903,15862241646,2162669631,18024911277
2014-12-07,All-Floors,Others(HKUST),16,509,1029718,21079417908,18230460866,39309878774
2014-12-07,All-Floors,Non-HKUST,101,1105,1498106,15842484932,1951011713,17793496645
2014-12-07,All-Floors,Total,3220,74680,94701561,1141043756148,231850511777,1372894267925
2014-12-08,1,Staff,61,598,909433,46035912297,4769875351,50805787648
2014-12-08,1,TPG,100,954,1357359,29245729678,7629607644,36875337322
2014-12-08,1,RPG,26,97,68072,988293871,77531753,1065825624
2014-12-08,1,UG,423,4030,6240634,201280861954,25492045978,226772907932
2014-12-08,1,Alumni,7,49,65597,757678278,119196859,876875137
2014-12-08,1,Others(HKUST),3,63,47840,3554729,2940707,6495436
2014-12-08,1,Non-HKUST,10,87,117623,11065275879,327084343,11392360222
2014-12-08,1,Total,630,5878,8806558,289377306686,38418282635,327795589321
2014-12-08,G,Staff,122,605,579907,1244981655,529306576,1774288231
2014-12-08,G,TPG,440,2796,2246238,1752131513,228413672,1980545185
2014-12-08,G,RPG,167,786,875330,5821598798,247968811,6069567609
2014-12-08,G,UG,1250,7129,6469632,18350859787,1946382841,20297242628
2014-12-08,G,Alumni,15,115,101743,1252457851,202749036,1455206887
2014-12-08,G,Others(HKUST),11,43,188579,30672528,8530927,39203455
2014-12-08,G,Non-HKUST,33,108,77682,173321056,19085696,192406752
2014-12-08,G,Total,2038,11582,10539111,28626023188,3182437559,31808460747
2014-12-08,LG1,Staff,119,490,262103,156074014,130705017,286779031
2014-12-08,LG1,TPG,686,8426,8333654,25555663823,2391825908,27947489731
2014-12-08,LG1,RPG,233,1690,1682625,8974313966,625211365,9599525331
2014-12-08,LG1,UG,2125,26978,27744537,82951781517,15120451655,98072233172
2014-12-08,LG1,Alumni,18,210,162901,2014840577,118391614,2133232191
2014-12-08,LG1,Others(HKUST),13,239,489176,367694325,198167383,565861708
2014-12-08,LG1,Non-HKUST,60,437,455546,340698608,26383417,367082025
2014-12-08,LG1,Total,3254,38470,39130542,120361066830,18611136359,138972203189
2014-12-08,LG3,Staff,177,440,319694,2147305248,389442417,2536747665
2014-12-08,LG3,TPG,506,4781,5149064,53909687372,8596304192,62505991564
2014-12-08,LG3,RPG,268,1011,988544,11431579682,1747449008,13179028690
2014-12-08,LG3,UG,1481,5906,5532424,89047463839,9305796435,98353260274
2014-12-08,LG3,Alumni,15,75,51183,1392489964,98015404,1490505368
2014-12-08,LG3,Others(HKUST),14,39,7321,68789980,23133108,91923088
2014-12-08,LG3,Non-HKUST,38,128,196360,2172420703,797914353,2970335056
2014-12-08,LG3,Total,2499,12380,12244590,160169736788,20958054917,181127791705
2014-12-08,LG4,Staff,104,370,274548,11246362692,662904118,11909266810
2014-12-08,LG4,TPG,509,9305,11156822,118108112846,30370464230,148478577076
2014-12-08,LG4,RPG,242,2407,2991176,62185405923,12554141110,74739547033
2014-12-08,LG4,UG,1565,15734,20623473,307740273963,37441086772,345181360735
2014-12-08,LG4,Alumni,14,213,263778,2319273578,103578748,2422852326
2014-12-08,LG4,Others(HKUST),14,278,274900,29820939567,12518994253,42339933820
2014-12-08,LG4,Non-HKUST,47,456,654322,5453039895,434749608,5887789503
2014-12-08,LG4,Total,2495,28763,36239019,536873408464,94085918839,630959327303
2014-12-08,All-Floors,Staff,359,2503,2345685,60830635906,6482233479,67312869385
2014-12-08,All-Floors,TPG,877,26262,28243137,228571325232,49216615646,277787940878
2014-12-08,All-Floors,RPG,515,5991,6605747,89401192240,15252302047,104653494287
2014-12-08,All-Floors,UG,3267,59777,66610700,699371241060,89305763681,788677004741
2014-12-08,All-Floors,Alumni,31,662,645202,7736740248,641931661,8378671909
2014-12-08,All-Floors,Others(HKUST),27,662,1007816,30291651129,12751766378,43043417507
2014-12-08,All-Floors,Non-HKUST,109,1216,1501533,19204756141,1605217417,20809973558
2014-12-08,All-Floors,Total,5185,97073,106959820,1135407541956,175255830309,1310663372265
2014-12-09,1,Staff,64,688,1092855,33909992307,4448151787,38358144094
2014-12-09,1,TPG,103,1087,1907906,52619200029,6396187648,59015387677
2014-12-09,1,RPG,41,248,281831,2472336744,392024136,2864360880
2014-12-09,1,UG,452,3892,6130567,212189220135,19920113310,232109333445
2014-12-09,1,Alumni,3,13,23171,3547566,1512109,5059675
2014-12-09,1,Others(HKUST),2,57,80759,7125393,4300741,11426134
2014-12-09,1,Non-HKUST,12,136,141823,1388196066,157199339,1545395405
2014-12-09,1,Total,677,6121,9658912,302589618240,31319489070,333909107310
2014-12-09,G,Staff,112,584,527771,1126983658,89060263,1216043921
2014-12-09,G,TPG,461,2773,2613096,8364240357,1979368689,10343609046
2014-12-09,G,RPG,169,849,700858,340531982,35626626,376158608
2014-12-09,G,UG,1197,6708,6132160,23541619412,2737588415,26279207827
2014-12-09,G,Alumni,12,38,45235,292268964,31639529,323908493
2014-12-09,G,Others(HKUST),15,80,190667,48342179,9683443,58025622
2014-12-09,G,Non-HKUST,28,88,69614,3344746,560130,3904876
2014-12-09,G,Total,1994,11120,10279401,33717331298,4883527095,38600858393
2014-12-09,LG1,Staff,102,417,361553,947221475,641603261,1588824736
2014-12-09,LG1,TPG,689,7908,8291311,34747022229,4859596317,39606618546
2014-12-09,LG1,RPG,242,1869,1830741,4397544448,863382520,5260926968
2014-12-09,LG1,UG,2101,24367,26017515,78455132940,16041443465,94496576405
2014-12-09,LG1,Alumni,13,95,47437,0,0,0
2014-12-09,LG1,Others(HKUST),18,246,463138,222610562,162080802,384691364
2014-12-09,LG1,Non-HKUST,64,290,492879,579009019,41005939,620014958
2014-12-09,LG1,Total,3229,35192,37504574,119348540673,22609112304,141957652977
2014-12-09,LG3,Staff,175,421,304043,2028891131,611924836,2640815967
2014-12-09,LG3,TPG,528,4317,5005187,85708228270,10546298754,96254527024
2014-12-09,LG3,RPG,281,1174,1253200,12234266115,2016445642,14250711757
2014-12-09,LG3,UG,1502,5962,5670928,93161999395,13319958015,106481957410
2014-12-09,LG3,Alumni,7,18,19572,435391178,21479902,456871080
2014-12-09,LG3,Others(HKUST),18,66,52350,532589878,48110922,580700800
2014-12-09,LG3,Non-HKUST,28,91,76860,149702855,72470783,222173638
2014-12-09,LG3,Total,2539,12049,12382140,194251068822,26636688854,220887757676
2014-12-09,LG4,Staff,128,388,263017,3940989794,634990571,4575980365
2014-12-09,LG4,TPG,559,10182,13546353,127602866612,35983121412,163585988024
2014-12-09,LG4,RPG,221,1928,2528549,24865999119,6114489100,30980488219
2014-12-09,LG4,UG,1520,13889,19031399,316555924964,41153105497,357709030461
2014-12-09,LG4,Alumni,10,226,248266,2273566468,151434111,2425000579
2014-12-09,LG4,Others(HKUST),15,392,465764,33805691423,8452066309,42257757732
2014-12-09,LG4,Non-HKUST,50,343,386027,4996118173,424984133,5421102306
2014-12-09,LG4,Total,2503,27348,36469375,514041156553,92914191133,606955347686
2014-12-09,All-Floors,Staff,375,2498,2549239,41954078365,6425730718,48379809083
2014-12-09,All-Floors,TPG,882,26267,31363853,309041557497,59764572820,368806130317
2014-12-09,All-Floors,RPG,517,6068,6595179,44310678408,9421968024,53732646432
2014-12-09,All-Floors,UG,3357,54818,62982569,723903896846,93172208702,817076105548
2014-12-09,All-Floors,Alumni,21,390,383681,3004774176,206065651,3210839827
2014-12-09,All-Floors,Others(HKUST),36,841,1252678,34616359435,8676242217,43292601652
2014-12-09,All-Floors,Non-HKUST,105,948,1167203,7116370859,696220324,7812591183
2014-12-09,All-Floors,Total,5293,91830,106294402,1163947715586,178363008456,1342310724042
2014-12-10,1,Staff,57,759,902822,9065745549,870997652,9936743201
2014-12-10,1,TPG,91,710,1304437,30563688285,6603368458,37167056743
2014-12-10,1,RPG,34,184,240103,7414072688,1032013386,8446086074
2014-12-10,1,UG,415,3953,6753559,182607426404,22115231862,204722658266
2014-12-10,1,Alumni,8,96,113219,4325538778,1720960079,6046498857
2014-12-10,1,Others(HKUST),3,45,68297,2672222238,43764707,2715986945
2014-12-10,1,Non-HKUST,5,41,40237,187050682,20674412,207725094
2014-12-10,1,Total,613,5788,9422674,236835744624,32407010556,269242755180
2014-12-10,G,Staff,110,583,439919,1356889326,193290536,1550179862
2014-12-10,G,TPG,464,2958,2904611,12423017979,2045847413,14468865392
2014-12-10,G,RPG,142,718,660969,1413890951,73715224,1487606175
2014-12-10,G,UG,1070,5543,5414084,22556802754,3608233402,26165036156
2014-12-10,G,Alumni,14,79,38281,1199487984,53027763,1252515747
2014-12-10,G,Others(HKUST),7,39,176050,1314380419,34456342,1348836761
2014-12-10,G,Non-HKUST,29,69,85755,1066439737,534804234,1601243971
2014-12-10,G,Total,1836,9989,9719669,41330909150,6543374914,47874284064
2014-12-10,LG1,Staff,110,504,415549,3426027411,2112377559,5538404970
2014-12-10,LG1,TPG,666,6997,7381752,22385914531,3600373655,25986288186
2014-12-10,LG1,RPG,201,1579,1874512,9307101270,670355678,9977456948
2014-12-10,LG1,UG,1999,23952,27793279,113515351567,19509005678,133024357245
2014-12-10,LG1,Alumni,20,138,143076,34473788,2594250,37068038
2014-12-10,LG1,Others(HKUST),15,251,528653,290744715,249463967,540208682
2014-12-10,LG1,Non-HKUST,53,390,527281,65390979,9057476,74448455
2014-12-10,LG1,Total,3064,33811,38664102,149025004261,26153228263,175178232524
2014-12-10,LG3,Staff,165,450,335629,4062743706,264236038,4326979744
2014-12-10,LG3,TPG,505,3812,4357056,72730517233,10687570120,83418087353
2014-12-10,LG3,RPG,231,1040,1007832,10453023406,1438467367,11891490773
2014-12-10,LG3,UG,1438,5840,6372813,129535730788,14363304200,143899034988
2014-12-10,LG3,Alumni,13,33,18365,281622354,15952176,297574530
2014-12-10,LG3,Others(HKUST),23,60,48775,3282288962,154907307,3437196269
2014-12-10,LG3,Non-HKUST,34,131,105208,3872884420,264316065,4137200485
2014-12-10,LG3,Total,2409,11366,12245678,224218810869,27188753273,251407564142
2014-12-10,LG4,Staff,91,254,204445,1453635398,269261987,1722897385
2014-12-10,LG4,TPG,536,9455,12775683,221618313662,40165639903,261783953565
2014-12-10,LG4,RPG,199,1781,2235856,35712184725,19037787450,54749972175
2014-12-10,LG4,UG,1339,14141,19838664,370277822411,30745249424,401023071835
2014-12-10,LG4,Alumni,18,280,400951,2636704691,350395915,2987100606
2014-12-10,LG4,Others(HKUST),15,342,443659,155044382093,12308491237,167352873330
2014-12-10,LG4,Non-HKUST,38,390,533352,9113100647,868218586,9981319233
2014-12-10,LG4,Total,2236,26643,36432610,795856143627,103745044502,899601188129
2014-12-10,All-Floors,Staff,326,2550,2298364,19365041390,3710163772,23075205162
2014-12-10,All-Floors,TPG,902,23932,28723539,359721451690,63102799549,422824251239
2014-12-10,All-Floors,RPG,456,5302,6019272,64300273040,22252339105,86552612145
2014-12-10,All-Floors,UG,3072,53429,66172399,818493133924,90341024566,908834158490
2014-12-10,All-Floors,Alumni,31,626,713892,8477827595,2142930183,10620757778
2014-12-10,All-Floors,Others(HKUST),36,737,1265434,162604018427,12791083560,175395101987
2014-12-10,All-Floors,Non-HKUST,97,1021,1291833,14304866465,1697070773,16001937238
2014-12-10,All-Floors,Total,4920,87597,106484733,1447266612531,196037411508,1643304024039
2014-12-11,1,Staff,61,530,829334,20201874024,1783485515,21985359539
2014-12-11,1,TPG,81,747,1133524,58541607442,25917733381,84459340823
2014-12-11,1,RPG,33,131,207912,1339976407,241024660,1581001067
2014-12-11,1,UG,340,2969,5309578,186993305811,18296498384,205289804195
2014-12-11,1,Alumni,4,34,60999,1808812748,263825927,2072638675
2014-12-11,1,Others(HKUST),3,30,59486,2729765562,139956769,2869722331
2014-12-11,1,Non-HKUST,7,27,60255,10651375,6884467,17535842
2014-12-11,1,Total,529,4468,7661088,271625993369,46649409103,318275402472
2014-12-11,G,Staff,110,527,578288,5034699895,277137394,5311837289
2014-12-11,G,TPG,411,2534,2481445,12601402652,2240955817,14842358469
2014-12-11,G,RPG,140,610,551672,272275763,47712853,319988616
2014-12-11,G,UG,1006,5280,5878957,23783922224,6265867207,30049789431
2014-12-11,G,Alumni,9,75,22871,90370691,13281995,103652686
2014-12-11,G,Others(HKUST),10,61,268013,1350729148,39833716,1390562864
2014-12-11,G,Non-HKUST,22,63,70098,34954101,10049878,45003979
2014-12-11,G,Total,1708,9150,9851344,43168354474,8894838860,52063193334
2014-12-11,LG1,Staff,103,374,367451,3263428714,2223221590,5486650304
2014-12-11,LG1,TPG,667,7156,7818528,35536983897,10204888725,45741872622
2014-12-11,LG1,RPG,202,1479,1613786,3936661981,260418250,4197080231
2014-12-11,LG1,UG,1843,19590,24365036,98765800248,22377274678,121143074926
2014-12-11,LG1,Alumni,17,104,104504,24896208,3923368,28819576
2014-12-11,LG1,Others(HKUST),16,278,597900,1096954695,203968825,1300923520
2014-12-11,LG1,Non-HKUST,56,288,400427,2886149078,97506757,2983655835
2014-12-11,LG1,Total,2904,29269,35267632,145510874821,35371202193,180882077014
2014-12-11,LG3,Staff,143,318,248044,3230935626,185363683,3416299309
2014-12-11,LG3,TPG,460,3806,4658423,95044325442,9884133323,104928458765
2014-12-11,LG3,RPG,217,746,912954,6345931923,746449763,7092381686
2014-12-11,LG3,UG,1256,4974,5359190,103423388365,13662271310,117085659675
2014-12-11,LG3,Alumni,9,72,22508,101391529,7120030,108511559
2014-12-11,LG3,Others(HKUST),14,73,38314,115947533,12144845,128092378
2014-12-11,LG3,Non-HKUST,32,90,113498,4062276745,203580934,4265857679
2014-12-11,LG3,Total,2131,10079,11352931,212324197163,24701063888,237025261051
2014-12-11,LG4,Staff,126,427,342840,1530181563,250584055,1780765618
2014-12-11,LG4,TPG,491,8353,11865072,196159647746,32032305470,228191953216
2014-12-11,LG4,RPG,188,1703,2460361,47960745534,12381980134,60342725668
2014-12-11,LG4,UG,1217,11570,16680766,359817432272,34978576191,394796008463
2014-12-11,LG4,Alumni,11,166,226394,5645020138,316342539,5961362677
2014-12-11,LG4,Others(HKUST),10,177,267131,24062542268,2889660890,26952203158
2014-12-11,LG4,Non-HKUST,39,426,623017,8277419435,1898773757,10176193192
2014-12-11,LG4,Total,2082,22822,32465581,643452988956,84748223036,728201211992
2014-12-11,All-Floors,Staff,320,2176,2365957,33261119822,4719792237,37980912059
2014-12-11,All-Floors,TPG,887,22596,27956992,397883967179,80280016716,478163983895
2014-12-11,All-Floors,RPG,444,4669,5746685,59855591608,13677585660,73533177268
2014-12-11,All-Floors,UG,3019,44383,57593527,772783848920,95580487770,868364336690
2014-12-11,All-Floors,Alumni,23,451,437276,7670491314,604493859,8274985173
2014-12-11,All-Floors,Others(HKUST),28,619,1230844,29355939206,3285565045,32641504251
2014-12-11,All-Floors,Non-HKUST,88,894,1267295,15271450734,2216795793,17488246527
2014-12-11,All-Floors,Total,4809,75788,96598576,1316082408783,200364737080,1516447145863
2014-12-12,1,Staff,54,594,891600,11951891964,1554830939,13506722903
2014-12-12,1,TPG,85,808,1205030,24691424865,2615813979,27307238844
2014-12-12,1,RPG,28,68,77367,888367831,58323819,946691650
2014-12-12,1,UG,352,3107,5098760,170293071365,16596862738,186889934103
2014-12-12,1,Alumni,5,70,113517,13666245302,1722890951,15389136253
2014-12-12,1,Others(HKUST),4,94,161299,3222062432,253040797,3475103229
2014-12-12,1,Non-HKUST,11,90,145666,5922491955,292599720,6215091675
2014-12-12,1,Total,539,4831,7693239,230635555714,23094362943,253729918657
2014-12-12,G,Staff,110,672,491687,4359863831,652949134,5012812965
2014-12-12,G,TPG,428,3411,2760457,56299447622,6247272945,62546720567
2014-12-12,G,RPG,143,608,519907,13752157110,1430727490,15182884600
2014-12-12,G,UG,1070,6300,5573134,107419741875,8505229778,115924971653
2014-12-12,G,Alumni,13,62,41683,35310497,3644250,38954747
2014-12-12,G,Others(HKUST),9,62,159659,37203826,5862804,43066630
2014-12-12,G,Non-HKUST,28,151,110495,382092864,24281461,406374325
2014-12-12,G,Total,1801,11266,9657022,182285817625,16869967862,199155785487
2014-12-12,LG1,Staff,113,495,349174,6407784536,3932607412,10340391948
2014-12-12,LG1,TPG,660,7458,7236549,94638693111,31229542631,125868235742
2014-12-12,LG1,RPG,213,1315,1196095,46744158757,3343593324,50087752081
2014-12-12,LG1,UG,1786,21626,23282445,513089945392,75228988135,588318933527
2014-12-12,LG1,Alumni,17,114,103432,964853726,86869609,1051723335
2014-12-12,LG1,Others(HKUST),14,232,569831,847000671,97941403,944942074
2014-12-12,LG1,Non-HKUST,57,387,447426,7017548970,510130969,7527679939
2014-12-12,LG1,Total,2860,31627,33184952,669709985163,114429673483,784139658646
2014-12-12,LG3,Staff,201,505,311489,3375904919,288194134,3664099053
2014-12-12,LG3,TPG,474,4033,4243055,159602660481,24202100056,183804760537
2014-12-12,LG3,RPG,236,818,726140,21681116656,2841001171,24522117827
2014-12-12,LG3,UG,1440,5351,5127091,93115087670,8383448587,101498536257
2014-12-12,LG3,Alumni,15,89,99547,890068124,70814144,960882268
2014-12-12,LG3,Others(HKUST),14,52,22168,5796434021,287918124,6084352145
2014-12-12,LG3,Non-HKUST,36,133,116723,5097915063,255535338,5353450401
2014-12-12,LG3,Total,2416,10981,10646213,289559186934,36329011554,325888198488
2014-12-12,LG4,Staff,98,316,194028,2052080120,211128117,2263208237
2014-12-12,LG4,TPG,440,6880,10664631,197919147449,34512167779,232431315228
2014-12-12,LG4,RPG,189,1341,1748287,48402700301,5587726039,53990426340
2014-12-12,LG4,UG,1145,11007,15325469,288230092578,37396285284,325626377862
2014-12-12,LG4,Alumni,10,242,281030,2926475639,314126955,3240602594
2014-12-12,LG4,Others(HKUST),10,220,242963,7922369659,1593831430,9516201089
2014-12-12,LG4,Non-HKUST,40,305,520093,10528309626,703153021,11231462647
2014-12-12,LG4,Total,1932,20311,28976501,557981175372,80318418625,638299593997
2014-12-12,All-Floors,Staff,360,2582,2237978,28147525370,6639709736,34787235106
2014-12-12,All-Floors,TPG,840,22590,26109722,533151373528,98806897390,631958270918
2014-12-12,All-Floors,RPG,473,4150,4267796,131468500655,13261371843,144729872498
2014-12-12,All-Floors,UG,2805,47391,54406899,1172147938880,146110814522,1318258753402
2014-12-12,All-Floors,Alumni,28,577,639209,18482953288,2198345909,20681299197
2014-12-12,All-Floors,Others(HKUST),27,660,1155920,17825070609,2238594558,20063665167
2014-12-12,All-Floors,Non-HKUST,94,1066,1340403,28948358478,1785700509,30734058987
2014-12-12,All-Floors,Total,4627,79016,90157927,1930171720808,271041434467,2201213155275
2014-12-13,1,Staff,14,139,56668,633835910,24996188,658832098
2014-12-13,1,TPG,59,410,542349,20140080305,1834268556,21974348861
2014-12-13,1,RPG,21,130,142722,1009395155,279769125,1289164280
2014-12-13,1,UG,205,1858,3138361,93641068840,8604133097,102245201937
2014-12-13,1,Alumni,5,54,89790,14794521098,967029327,15761550425
2014-12-13,1,Others(HKUST),4,38,112451,1171128954,71946542,1243075496
2014-12-13,1,Non-HKUST,10,107,122290,2164709557,253820332,2418529889
2014-12-13,1,Total,318,2736,4204631,133554739819,12035963167,145590702986
2014-12-13,G,Staff,41,224,174636,10278711530,608842540,10887554070
2014-12-13,G,TPG,328,2083,1768862,9916117463,2155456671,12071574134
2014-12-13,G,RPG,98,529,452335,9378902040,680624058,10059526098
2014-12-13,G,UG,783,4195,4010724,35414949247,2021299722,37436248969
2014-12-13,G,Alumni,24,102,142538,1332651074,248185628,1580836702
2014-12-13,G,Others(HKUST),9,89,248592,114955137,24273116,139228253
2014-12-13,G,Non-HKUST,29,111,94438,302760729,82734302,385495031
2014-12-13,G,Total,1312,7333,6892125,66739047220,5821416037,72560463257
2014-12-13,LG1,Staff,42,213,141068,3543612124,508253930,4051866054
2014-12-13,LG1,TPG,531,6865,7766497,144136155866,41117118403,185253274269
2014-12-13,LG1,RPG,135,1082,1305630,17269562130,14587235872,31856798002
2014-12-13,LG1,UG,1490,15754,18853351,382356029218,92062160461,474418189679
2014-12-13,LG1,Alumni,25,127,88492,2071441687,273115574,2344557261
2014-12-13,LG1,Others(HKUST),11,298,568103,672574579,143962682,816537261
2014-12-13,LG1,Non-HKUST,58,323,403957,2364504849,240869116,2605373965
2014-12-13,LG1,Total,2292,24662,29127098,552413880453,148932716038,701346596491
2014-12-13,LG3,Staff,71,296,343342,6936944347,6270786959,13207731306
2014-12-13,LG3,TPG,326,2271,2631337,69409018283,17878716024,87287734307
2014-12-13,LG3,RPG,151,589,638138,8050209266,1198488353,9248697619
2014-12-13,LG3,UG,1050,3617,3630326,89869948902,26409246256,116279195158
2014-12-13,LG3,Alumni,21,110,141792,3989570689,468027887,4457598576
2014-12-13,LG3,Others(HKUST),11,71,51804,1289403558,673347937,1962751495
2014-12-13,LG3,Non-HKUST,27,122,173211,2379548417,603154176,2982702593
2014-12-13,LG3,Total,1657,7076,7609950,181924643462,53501767592,235426411054
2014-12-13,LG4,Staff,35,122,106925,1306681330,165260427,1471941757
2014-12-13,LG4,TPG,303,4562,7297767,89505124353,14158624941,103663749294
2014-12-13,LG4,RPG,118,976,1322839,31334330934,6304982867,37639313801
2014-12-13,LG4,UG,813,5634,8358624,229907377950,19096583138,249003961088
2014-12-13,LG4,Alumni,24,295,390211,12222213243,724631707,12946844950
2014-12-13,LG4,Others(HKUST),11,294,457468,33975759398,27640534772,61616294170
2014-12-13,LG4,Non-HKUST,36,241,520827,12913287913,1292358340,14205646253
2014-12-13,LG4,Total,1340,12124,18454661,411164775121,69382976192,480547751313
2014-12-13,All-Floors,Staff,125,994,822639,22699785241,7578140044,30277925285
2014-12-13,All-Floors,TPG,698,16191,20006812,333106496270,77144184595,410250680865
2014-12-13,All-Floors,RPG,306,3306,3861664,67042399525,23051100275,90093499800
2014-12-13,All-Floors,UG,2319,31058,37991386,831189374157,148193422674,979382796831
2014-12-13,All-Floors,Alumni,45,688,852823,34410397791,2680990123,37091387914
2014-12-13,All-Floors,Others(HKUST),22,790,1438418,37223821626,28554065049,65777886675
2014-12-13,All-Floors,Non-HKUST,92,904,1314723,20124811465,2472936266,22597747731
2014-12-13,All-Floors,Total,3607,53931,66288465,1345797086075,289674839026,1635471925101
2014-12-14,1,Staff,10,120,41369,1358392021,41569211,1399961232
2014-12-14,1,TPG,37,262,333056,3393358764,239244142,3632602906
2014-12-14,1,RPG,23,121,154104,6614762032,588573172,7203335204
2014-12-14,1,UG,195,2468,4522488,137453982572,19429530848,156883513420
2014-12-14,1,Alumni,2,3,5282,567371934,18297241,585669175
2014-12-14,1,Others(HKUST),3,69,154477,1224073480,259692018,1483765498
2014-12-14,1,Non-HKUST,8,101,93015,1827677087,255338106,2083015193
2014-12-14,1,Total,278,3144,5303791,152439617890,20832244738,173271862628
2014-12-14,G,Staff,36,123,130434,19572214,10506824,30079038
2014-12-14,G,TPG,295,2333,2085876,17904334380,1569786568,19474120948
2014-12-14,G,RPG,107,521,589848,3617226163,465611211,4082837374
2014-12-14,G,UG,625,4268,4386434,52184600100,12649098839,64833698939
2014-12-14,G,Alumni,28,86,86270,2530406060,378533008,2908939068
2014-12-14,G,Others(HKUST),8,91,175742,236576085,55801056,292377141
2014-12-14,G,Non-HKUST,26,83,37494,120390850,30313157,150704007
2014-12-14,G,Total,1125,7505,7492098,76613105852,15159650663,91772756515
2014-12-14,LG1,Staff,35,229,244931,8035062729,1062081390,9097144119
2014-12-14,LG1,TPG,461,6539,7588029,156153726811,24563977792,180717704603
2014-12-14,LG1,RPG,161,1365,1494985,14071444782,4664439742,18735884524
2014-12-14,LG1,UG,1267,17179,20792458,366313301856,63938422869,430251724725
2014-12-14,LG1,Alumni,43,224,193543,1884357936,135198996,2019556932
2014-12-14,LG1,Others(HKUST),12,395,687907,1741311533,519503070,2260814603
2014-12-14,LG1,Non-HKUST,51,304,405026,8875808830,577240008,9453048838
2014-12-14,LG1,Total,2030,26235,31406879,557075014477,95460863867,652535878344
2014-12-14,LG3,Staff,45,157,185597,5110166755,655787965,5765954720
2014-12-14,LG3,TPG,311,2616,3447998,65447385721,17057988296,82505374017
2014-12-14,LG3,RPG,173,623,673068,7474413557,972822439,8447235996
2014-12-14,LG3,UG,806,4268,4670204,146667364282,15294158735,161961523017
2014-12-14,LG3,Alumni,29,208,147342,886283863,111559139,997843002
2014-12-14,LG3,Others(HKUST),6,119,178357,886585347,3047162062,3933747409
2014-12-14,LG3,Non-HKUST,26,94,181485,4073249022,335564758,4408813780
2014-12-14,LG3,Total,1396,8085,9484051,230545448547,37475043394,268020491941
2014-12-14,LG4,Staff,26,152,219040,7433725070,1474446472,8908171542
2014-12-14,LG4,TPG,298,4904,7326665,86839029001,14931721380,101770750381
2014-12-14,LG4,RPG,145,1543,2076141,45201314818,7999824889,53201139707
2014-12-14,LG4,UG,707,8230,12955465,406951137393,43167429800,450118567193
2014-12-14,LG4,Alumni,35,447,544418,12395344118,760262598,13155606716
2014-12-14,LG4,Others(HKUST),11,200,239368,20814236851,4643373519,25457610370
2014-12-14,LG4,Non-HKUST,39,313,754133,11118319174,2240562809,13358881983
2014-12-14,LG4,Total,1261,15789,24115230,590753106425,75217621467,665970727892
2014-12-14,All-Floors,Staff,97,781,821371,21956918789,3244391862,25201310651
2014-12-14,All-Floors,TPG,590,16654,20781624,329737834677,58362718178,388100552855
2014-12-14,All-Floors,RPG,333,4173,4988146,76979161352,14691271453,91670432805
2014-12-14,All-Floors,UG,1686,36413,47327049,1109570386203,154478641091,1264049027294
2014-12-14,All-Floors,Alumni,61,968,976855,18263763911,1403850982,19667614893
2014-12-14,All-Floors,Others(HKUST),16,874,1435851,24902783296,8525531725,33428315021
2014-12-14,All-Floors,Non-HKUST,81,895,1471153,26015444963,3439018838,29454463801
2014-12-14,All-Floors,Total,2864,60758,77802049,1607426293191,244145424129,1851571717320
2014-12-15,1,Staff,64,675,848011,8650967110,748668727,9399635837
2014-12-15,1,TPG,46,258,333622,4287632506,1690689804,5978322310
2014-12-15,1,RPG,25,99,110269,1625147655,443180329,2068327984
2014-12-15,1,UG,384,4462,6374684,233661125935,32865330294,266526456229
2014-12-15,1,Alumni,4,75,93562,11084576640,392351244,11476927884
2014-12-15,1,Others(HKUST),6,64,68338,482611111,77650618,560261729
2014-12-15,1,Non-HKUST,10,30,40189,829426523,91666534,921093057
2014-12-15,1,Total,539,5663,7868675,260621487480,36309537550,296931025030
2014-12-15,G,Staff,119,680,494604,1669723372,91796259,1761519631
2014-12-15,G,TPG,295,2062,1801848,2731811798,305509789,3037321587
2014-12-15,G,RPG,114,495,472971,4098072617,164365316,4262437933
2014-12-15,G,UG,1123,5804,5202648,22952550643,6283837734,29236388377
2014-12-15,G,Alumni,15,78,30821,6341242,1250331,7591573
2014-12-15,G,Others(HKUST),13,82,173404,819077346,28443358,847520704
2014-12-15,G,Non-HKUST,28,96,51471,30191680,2070891,32262571
2014-12-15,G,Total,1707,9297,8227767,32307768698,6877273678,39185042376
2014-12-15,LG1,Staff,106,536,451607,5516051126,440336126,5956387252
2014-12-15,LG1,TPG,425,5384,5663075,64991348578,12951091213,77942439791
2014-12-15,LG1,RPG,176,1506,1756092,44180745847,7442639058,51623384905
2014-12-15,LG1,UG,1850,23641,27436887,353926382838,52241438036,406167820874
2014-12-15,LG1,Alumni,16,258,191628,1359995487,174691221,1534686708
2014-12-15,LG1,Others(HKUST),18,324,600900,722064569,103581431,825646000
2014-12-15,LG1,Non-HKUST,50,316,396800,11437319858,836404097,12273723955
2014-12-15,LG1,Total,2641,31965,36496989,482133908303,74190181182,556324089485
2014-12-15,LG3,Staff,160,494,383846,3228533189,423184341,3651717530
2014-12-15,LG3,TPG,288,2397,3087639,83615557127,10562890972,94178448099
2014-12-15,LG3,RPG,198,1013,954532,13386244189,5991298297,19377542486
2014-12-15,LG3,UG,1190,5776,5522692,113351430729,10053966784,123405397513
2014-12-15,LG3,Alumni,8,144,54700,380636981,26555154,407192135
2014-12-15,LG3,Others(HKUST),10,32,24384,152759425,59906136,212665561
2014-12-15,LG3,Non-HKUST,25,111,114967,1404823484,120549528,1525373012
2014-12-15,LG3,Total,1879,9967,10142760,215519985124,27238351212,242758336336
2014-12-15,LG4,Staff,79,270,184722,3365349857,282934018,3648283875
2014-12-15,LG4,TPG,303,5327,7245823,136866152484,22094138442,158960290926
2014-12-15,LG4,RPG,172,1633,1676687,46470664528,18725542093,65196206621
2014-12-15,LG4,UG,1088,12444,15767063,326968205153,31450228553,358418433706
2014-12-15,LG4,Alumni,10,167,175330,830965145,378808219,1209773364
2014-12-15,LG4,Others(HKUST),11,318,391056,75852718558,5402252493,81254971051
2014-12-15,LG4,Non-HKUST,32,363,560223,4701270235,352929535,5054199770
2014-12-15,LG4,Total,1695,20522,26000904,595055325960,78686833353,673742159313
2014-12-15,All-Floors,Staff,326,2655,2362790,22430624654,1986919471,24417544125
2014-12-15,All-Floors,TPG,590,15428,18132007,292492502493,47604320220,340096822713
2014-12-15,All-Floors,RPG,420,4746,4970551,109760874836,32767025093,142527899929
2014-12-15,All-Floors,UG,2882,52127,60303974,1050859695298,132894801401,1183754496699
2014-12-15,All-Floors,Alumni,29,722,546041,13662515495,973656169,14636171664
2014-12-15,All-Floors,Others(HKUST),24,820,1258082,78029231009,5671834036,83701065045
2014-12-15,All-Floors,Non-HKUST,86,916,1163650,18403031780,1403620585,19806652365
2014-12-15,All-Floors,Total,4357,77414,88737095,1585638475565,223302176975,1808940652540
2014-12-16,1,Staff,59,608,874476,11365440232,595352864,11960793096
2014-12-16,1,TPG,28,231,244420,11825272967,918459040,12743732007
2014-12-16,1,RPG,22,143,132182,1691000863,159271890,1850272753
2014-12-16,1,UG,288,3542,5313336,178237737256,35435775402,213673512658
2014-12-16,1,Alumni,3,32,53285,15618982619,508181592,16127164211
2014-12-16,1,Others(HKUST),2,26,6356,400080,283397,683477
2014-12-16,1,Non-HKUST,4,23,46328,38892050,7407027,46299077
2014-12-16,1,Total,406,4605,6670383,218777726067,37624731212,256402457279
2014-12-16,G,Staff,124,685,550810,1745236279,595725531,2340961810
2014-12-16,G,TPG,269,1424,1163034,2290344239,725999121,3016343360
2014-12-16,G,RPG,122,634,726158,4287516003,432462049,4719978052
2014-12-16,G,UG,932,5465,4982235,17034939686,1552327422,18587267108
2014-12-16,G,Alumni,11,33,42213,1343506021,45105253,1388611274
2014-12-16,G,Others(HKUST),12,66,194786,10863813,1683485,12547298
2014-12-16,G,Non-HKUST,33,186,109333,482791466,30660351,513451817
2014-12-16,G,Total,1503,8493,7768569,27195197507,3383963212,30579160719
2014-12-16,LG1,Staff,113,450,336308,1255317387,203664983,1458982370
2014-12-16,LG1,TPG,384,3952,3893405,40701629662,45285071817,85986701479
2014-12-16,LG1,RPG,184,1411,1577811,15797959703,2817286074,18615245777
2014-12-16,LG1,UG,1691,21330,26213874,323548989563,37086956503,360635946066
2014-12-16,LG1,Alumni,19,93,111881,339825518,54928378,394753896
2014-12-16,LG1,Others(HKUST),15,252,546998,125172831,35112093,160284924
2014-12-16,LG1,Non-HKUST,48,277,255393,537470111,35439586,572909697
2014-12-16,LG1,Total,2454,27765,32935670,382306364775,85518459434,467824824209
2014-12-16,LG3,Staff,150,525,406878,4013753507,558633060,4572386567
2014-12-16,LG3,TPG,270,2365,2765752,71504243451,8871450735,80375694186
2014-12-16,LG3,RPG,215,1003,1070472,11983053284,2452442424,14435495708
2014-12-16,LG3,UG,1040,4871,5011372,87656724748,10234075009,97890799757
2014-12-16,LG3,Alumni,10,88,43514,111515959,18429539,129945498
2014-12-16,LG3,Others(HKUST),17,68,78535,167603194,19705289,187308483
2014-12-16,LG3,Non-HKUST,27,68,49925,635384717,49816502,685201219
2014-12-16,LG3,Total,1729,8988,9426448,176072278860,22204552558,198276831418
2014-12-16,LG4,Staff,103,402,362036,1757201507,295500012,2052701519
2014-12-16,LG4,TPG,263,4469,6020147,116670402342,15953255445,132623657787
2014-12-16,LG4,RPG,153,1340,1647052,21727457938,5346090383,27073548321
2014-12-16,LG4,UG,956,12194,16250326,337522877128,58657147891,396180025019
2014-12-16,LG4,Alumni,18,339,432398,7769841445,650934948,8420776393
2014-12-16,LG4,Others(HKUST),15,299,418664,18137833595,1661640189,19799473784
2014-12-16,LG4,Non-HKUST,28,230,397204,6400805959,457498881,6858304840
2014-12-16,LG4,Total,1536,19273,25527827,509986419914,83022067749,593008487663
2014-12-16,All-Floors,Staff,326,2670,2530508,20136948912,2248876450,22385825362
2014-12-16,All-Floors,TPG,530,12441,14086758,242991892661,71754236158,314746128819
2014-12-16,All-Floors,RPG,416,4531,5153675,55486987791,11207552820,66694540611
2014-12-16,All-Floors,UG,2562,47402,57771143,944001268381,142966282227,1086967550608
2014-12-16,All-Floors,Alumni,29,585,683291,25183671562,1277579710,26461251272
2014-12-16,All-Floors,Others(HKUST),29,711,1245339,18441873513,1718424453,20160297966
2014-12-16,All-Floors,Non-HKUST,81,784,858183,8095344303,580822347,8676166650
2014-12-16,All-Floors,Total,3973,69124,82328897,1314337987123,231753774165,1546091761288
2014-12-17,1,Staff,61,774,898247,18726162630,977458803,19703621433
2014-12-17,1,TPG,38,578,588067,18284350828,2017460125,20301810953
2014-12-17,1,RPG,27,170,150549,7184137362,616458277,7800595639
2014-12-17,1,UG,263,3179,3985130,194247851764,13186890602,207434742366
2014-12-17,1,Alumni,5,34,37483,372723284,163461158,536184442
2014-12-17,1,Others(HKUST),4,86,21299,432589383,52944992,485534375
2014-12-17,1,Non-HKUST,4,26,57708,14135016896,446564198,14581581094
2014-12-17,1,Total,402,4847,5738483,253382832147,17461238155,270844070302
2014-12-17,G,Staff,106,591,449637,10220565310,5007520743,15228086053
2014-12-17,G,TPG,246,1687,1405735,14038901116,2541116180,16580017296
2014-12-17,G,RPG,142,778,727511,14456698010,976393675,15433091685
2014-12-17,G,UG,903,5204,4213503,73921430584,7273690750,81195121334
2014-12-17,G,Alumni,10,55,37427,862750494,48109651,910860145
2014-12-17,G,Others(HKUST),10,52,165498,59110991,12850845,71961836
2014-12-17,G,Non-HKUST,23,78,44095,42847493,8220715,51068208
2014-12-17,G,Total,1440,8445,7043406,113602303998,15867902559,129470206557
2014-12-17,LG1,Staff,106,455,287361,4723054635,540996306,5264050941
2014-12-17,LG1,TPG,282,2621,2350454,73166459806,32258617273,105425077079
2014-12-17,LG1,RPG,176,1545,1547237,26807854997,5418936361,32226791358
2014-12-17,LG1,UG,1735,22794,23720558,660233565220,144631483341,804865048561
2014-12-17,LG1,Alumni,14,81,69735,577907130,70406200,648313330
2014-12-17,LG1,Others(HKUST),16,397,641088,1599609439,746603132,2346212571
2014-12-17,LG1,Non-HKUST,40,233,322334,1606729380,159725818,1766455198
2014-12-17,LG1,Total,2369,28126,28938767,768715180607,183826768431,952541949038
2014-12-17,LG3,Staff,107,381,364143,10278079534,18940142860,29218222394
2014-12-17,LG3,TPG,203,1992,2180528,90573696287,7980881669,98554577956
2014-12-17,LG3,RPG,172,1037,853168,46835871810,5998147548,52834019358
2014-12-17,LG3,UG,905,4538,4276925,227148185711,14729850648,241878036359
2014-12-17,LG3,Alumni,5,58,32327,656540259,58737301,715277560
2014-12-17,LG3,Others(HKUST),14,60,63930,1137992699,127894456,1265887155
2014-12-17,LG3,Non-HKUST,25,105,120348,4054138623,334964287,4389102910
2014-12-17,LG3,Total,1431,8171,7891369,380684504923,48170618769,428855123692
2014-12-17,LG4,Staff,118,432,229160,5417439011,945505324,6362944335
2014-12-17,LG4,TPG,199,3446,3815252,177647218771,24262125166,201909343937
2014-12-17,LG4,RPG,154,1044,1179566,35186909887,3392822874,38579732761
2014-12-17,LG4,UG,868,10630,11182402,557334200939,67268559159,624602760098
2014-12-17,LG4,Alumni,9,191,213253,7091676573,357582765,7449259338
2014-12-17,LG4,Others(HKUST),14,349,319426,17327608092,5413252774,22740860866
2014-12-17,LG4,Non-HKUST,24,253,297463,14914481867,1071603777,15986085644
2014-12-17,LG4,Total,1386,16345,17236522,814919535140,102711451839,917630986979
2014-12-17,All-Floors,Staff,311,2633,2228548,49365301120,26411624036,75776925156
2014-12-17,All-Floors,TPG,439,10324,10340036,373710626808,69060200413,442770827221
2014-12-17,All-Floors,RPG,425,4574,4458031,130471472066,16402758735,146874230801
2014-12-17,All-Floors,UG,2650,46345,47378518,1712885234218,247090474500,1959975708718
2014-12-17,All-Floors,Alumni,23,419,390225,9561597740,698297075,10259894815
2014-12-17,All-Floors,Others(HKUST),25,944,1211241,20556910604,6353546199,26910456803
2014-12-17,All-Floors,Non-HKUST,78,695,841948,34753214259,2021078795,36774293054
2014-12-17,All-Floors,Total,3951,65934,66848547,2331304356815,368037979753,2699342336568
2014-12-18,1,Staff,51,677,838827,10746425038,808745753,11555170791
2014-12-18,1,TPG,25,272,253801,6867273053,392421292,7259694345
2014-12-18,1,RPG,26,95,87775,554641664,35688942,590330606
2014-12-18,1,UG,187,1849,2170959,62215965668,5358869133,67574834801
2014-12-18,1,Alumni,2,4,2078,1021896,248149,1270045
2014-12-18,1,Others(HKUST),3,59,12670,387311144,13349823,400660967
2014-12-18,1,Non-HKUST,5,99,82234,1620390317,112223054,1732613371
2014-12-18,1,Total,299,3055,3448344,82393028780,6721546146,89114574926
2014-12-18,G,Staff,104,681,549997,6872658160,652310543,7524968703
2014-12-18,G,TPG,169,1078,943812,7662315940,2912922812,10575238752
2014-12-18,G,RPG,122,670,742907,3517264663,1470461700,4987726363
2014-12-18,G,UG,734,4284,3709443,26617403806,4759748780,31377152586
2014-12-18,G,Alumni,9,21,11593,154623,64523,219146
2014-12-18,G,Others(HKUST),9,37,183729,173967792,81983818,255951610
2014-12-18,G,Non-HKUST,17,59,9325,186855595,11247678,198103273
2014-12-18,G,Total,1164,6830,6150806,45030620579,9888739854,54919360433
2014-12-18,LG1,Staff,82,467,392810,1412375534,304487279,1716862813
2014-12-18,LG1,TPG,243,2362,2174090,35637960288,5171277564,40809237852
2014-12-18,LG1,RPG,160,1509,1562180,19906625816,6321636241,26228262057
2014-12-18,LG1,UG,1330,16737,18185119,186780514463,16756118992,203536633455
2014-12-18,LG1,Alumni,13,131,138367,211335219,16170461,227505680
2014-12-18,LG1,Others(HKUST),10,183,527430,200211323,966997156,1167208479
2014-12-18,LG1,Non-HKUST,34,336,297664,4954832113,396896039,5351728152
2014-12-18,LG1,Total,1872,21725,23277660,249103854756,29933583732,279037438488
2014-12-18,LG3,Staff,105,321,255641,4264424348,224694389,4489118737
2014-12-18,LG3,TPG,176,1483,1310713,28912929935,4100847605,33013777540
2014-12-18,LG3,RPG,164,832,703474,13323043883,3933611006,17256654889
2014-12-18,LG3,UG,774,3551,3018120,110572479365,10165732575,120738211940
2014-12-18,LG3,Alumni,14,80,47185,583380913,34835647,618216560
2014-12-18,LG3,Others(HKUST),10,65,97219,1693219728,187855013,1881074741
2014-12-18,LG3,Non-HKUST,23,111,82554,998686154,122160145,1120846299
2014-12-18,LG3,Total,1266,6443,5514906,160348164326,18769736380,179117900706
2014-12-18,LG4,Staff,74,210,134523,1426045787,90902976,1516948763
2014-12-18,LG4,TPG,167,2357,2905381,76144195918,23372481954,99516677872
2014-12-18,LG4,RPG,148,1117,1396391,23309079174,2147058442,25456137616
2014-12-18,LG4,UG,612,5708,5976048,137784171503,11353406387,149137577890
2014-12-18,LG4,Alumni,10,277,304504,3570519941,230275247,3800795188
2014-12-18,LG4,Others(HKUST),11,187,238486,19492265092,4175578093,23667843185
2014-12-18,LG4,Non-HKUST,21,145,307111,4358457175,345834928,4704292103
2014-12-18,LG4,Total,1043,10001,11262444,266084734590,41715538027,307800272617
2014-12-18,All-Floors,Staff,272,2356,2171798,24721928867,2081140940,26803069807
2014-12-18,All-Floors,TPG,391,7552,7587797,155224675134,35949951227,191174626361
2014-12-18,All-Floors,RPG,384,4223,4492727,60610655200,13908456331,74519111531
2014-12-18,All-Floors,UG,2135,32129,33059689,523970534805,48393875867,572364410672
2014-12-18,All-Floors,Alumni,20,513,503727,4366412592,281594027,4648006619
2014-12-18,All-Floors,Others(HKUST),25,531,1059534,21946975079,5425763903,27372738982
2014-12-18,All-Floors,Non-HKUST,60,750,778888,12119221354,988361844,13107583198
2014-12-18,All-Floors,Total,3287,48054,49654160,802960403031,107029144139,909989547170
2014-12-19,1,Staff,61,634,805241,6001053689,553259972,6554313661
2014-12-19,1,TPG,31,275,280852,13252474825,996615192,14249090017
2014-12-19,1,RPG,28,178,277862,1137948336,128940675,1266889011
2014-12-19,1,UG,108,788,796149,9746186390,905360390,10651546780
2014-12-19,1,Alumni,5,13,26025,995806948,402302730,1398109678
2014-12-19,1,Others(HKUST),5,62,8636,5658023,961377,6619400
2014-12-19,1,Non-HKUST,1,1,10481,29321162,1380174,30701336
2014-12-19,1,Total,239,1951,2205246,31168449373,2988820510,34157269883
2014-12-19,G,Staff,100,589,498840,12166264505,1194414838,13360679343
2014-12-19,G,TPG,180,1040,1012322,5909887457,600449833,6510337290
2014-12-19,G,RPG,127,558,549472,7143602191,408192298,7551794489
2014-12-19,G,UG,652,3009,1959967,9972684273,1344085570,11316769843
2014-12-19,G,Alumni,11,55,69018,5932543094,1288584363,7221127457
2014-12-19,G,Others(HKUST),16,247,267722,3269719986,1838353908,5108073894
2014-12-19,G,Non-HKUST,26,74,28796,55451774,4152173,59603947
2014-12-19,G,Total,1112,5572,4386137,44450153280,6678232983,51128386263
2014-12-19,LG1,Staff,75,281,287880,5451613073,2363232835,7814845908
2014-12-19,LG1,TPG,197,2011,2529951,73961615571,20804006167,94765621738
2014-12-19,LG1,RPG,132,959,1237032,2857477930,216062568,3073540498
2014-12-19,LG1,UG,1059,11056,11131896,62895942680,35540901416,98436844096
2014-12-19,LG1,Alumni,14,165,131419,469422130,42067704,511489834
2014-12-19,LG1,Others(HKUST),16,330,510315,101231806,95680878,196912684
2014-12-19,LG1,Non-HKUST,38,228,234551,1896321260,161966801,2058288061
2014-12-19,LG1,Total,1531,15030,16063044,147633624450,59223918369,206857542819
2014-12-19,LG3,Staff,132,433,309642,6981640210,801232449,7782872659
2014-12-19,LG3,TPG,139,1077,1116299,62689476616,11337043289,74026519905
2014-12-19,LG3,RPG,154,780,782636,12422624324,1200380204,13623004528
2014-12-19,LG3,UG,569,1978,1506654,20353554393,5648335668,26001890061
2014-12-19,LG3,Alumni,12,66,79173,134816390,11409155,146225545
2014-12-19,LG3,Others(HKUST),9,27,40540,2606973310,58202191,2665175501
2014-12-19,LG3,Non-HKUST,20,44,42796,245608153,11007031,256615184
2014-12-19,LG3,Total,1035,4405,3877740,105434693396,19067609987,124502303383
2014-12-19,LG4,Staff,99,294,160201,1953430858,143456523,2096887381
2014-12-19,LG4,TPG,125,1802,2433579,55553976146,8633754785,64187730931
2014-12-19,LG4,RPG,116,643,894556,26667344778,2947852233,29615197011
2014-12-19,LG4,UG,402,2411,2035339,67778899841,3718004467,71496904308
2014-12-19,LG4,Alumni,14,297,268959,1013572278,99632305,1113204583
2014-12-19,LG4,Others(HKUST),7,161,290695,21125705127,2551546974,23677252101
2014-12-19,LG4,Non-HKUST,18,200,289533,1405243664,124398637,1529642301
2014-12-19,LG4,Total,781,5808,6372862,175498172692,18218645924,193716818616
2014-12-19,All-Floors,Staff,299,2231,2061804,32554002335,5055596617,37609598952
2014-12-19,All-Floors,TPG,326,6205,7373003,211367430615,42371869266,253739299881
2014-12-19,All-Floors,RPG,347,3118,3741558,50228997559,4901427978,55130425537
2014-12-19,All-Floors,UG,1784,19242,17430005,170747267577,47156687511,217903955088
2014-12-19,All-Floors,Alumni,31,596,574594,8546160840,1843996257,10390157097
2014-12-19,All-Floors,Others(HKUST),28,827,1117908,27109288252,4544745328,31654033580
2014-12-19,All-Floors,Non-HKUST,65,547,606157,3631946013,302904816,3934850829
2014-12-19,All-Floors,Total,2880,32766,32905029,504185093191,106177227773,610362320964
2014-12-20,1,Staff,16,148,194026,2040482270,79525651,2120007921
2014-12-20,1,TPG,10,24,12804,0,0,0
2014-12-20,1,RPG,14,38,51395,1513958,827713,2341671
2014-12-20,1,UG,5,8,6720,369460,121316,490776
2014-12-20,1,Alumni,4,16,20980,3482346,1157965,4640311
2014-12-20,1,Others(HKUST),1,50,6433,939651,359317,1298968
2014-12-20,1,Non-HKUST,2,6,4929,48021908,13151450,61173358
2014-12-20,1,Total,52,290,297287,2094809593,95143412,2189953005
2014-12-20,G,Staff,37,209,194189,31468374,960315,32428689
2014-12-20,G,TPG,98,617,648447,1538938785,146532973,1685471758
2014-12-20,G,RPG,68,392,567715,9207735413,242174943,9449910356
2014-12-20,G,UG,131,476,480928,539758512,677032881,1216791393
2014-12-20,G,Alumni,14,60,39927,6964692,2315930,9280622
2014-12-20,G,Others(HKUST),9,25,107844,4073761,3810365,7884126
2014-12-20,G,Non-HKUST,6,28,25915,0,0,0
2014-12-20,G,Total,363,1807,2064965,11328939537,1072827407,12401766944
2014-12-20,LG1,Staff,28,116,159934,680033501,23850461,703883962
2014-12-20,LG1,TPG,128,1010,1355651,44187941685,1699732146,45887673831
2014-12-20,LG1,RPG,82,775,1117758,9219015689,307918429,9526934118
2014-12-20,LG1,UG,248,2135,2506968,26997367651,13430852883,40428220534
2014-12-20,LG1,Alumni,20,212,193463,868753621,340458328,1209211949
2014-12-20,LG1,Others(HKUST),8,143,457879,34563165,33240753,67803918
2014-12-20,LG1,Non-HKUST,16,50,111132,438157897,45621720,483779617
2014-12-20,LG1,Total,530,4441,5902785,82425833209,15881674720,98307507929
2014-12-20,LG3,Staff,28,87,65700,604231051,226094082,830325133
2014-12-20,LG3,TPG,69,300,397460,972659204,120681355,1093340559
2014-12-20,LG3,RPG,80,347,454584,2884552330,652463900,3537016230
2014-12-20,LG3,UG,162,480,335851,1795302183,126971177,1922273360
2014-12-20,LG3,Alumni,10,13,2741,3897320,3293722,7191042
2014-12-20,LG3,Others(HKUST),8,48,154985,1805007,1057612,2862619
2014-12-20,LG3,Non-HKUST,9,37,47532,150388886,55431403,205820289
2014-12-20,LG3,Total,366,1312,1458853,6412835981,1185993251,7598829232
2014-12-20,LG4,Staff,18,43,16971,5114,1599,6713
2014-12-20,LG4,TPG,63,395,586080,7045515128,2170521426,9216036554
2014-12-20,LG4,RPG,57,158,288540,1952144530,1838731249,3790875779
2014-12-20,LG4,UG,108,411,209472,141445191508,7841402136,149286593644
2014-12-20,LG4,Alumni,14,148,243195,3640218863,1045843134,4686061997
2014-12-20,LG4,Others(HKUST),6,122,314115,9003149788,2250540563,11253690351
2014-12-20,LG4,Non-HKUST,5,64,145221,420990610,30704902,451695512
2014-12-20,LG4,Total,271,1341,1803594,163507215541,15177745009,178684960550
2014-12-20,All-Floors,Staff,85,603,630820,3356220310,330432108,3686652418
2014-12-20,All-Floors,TPG,218,2346,3000442,53745054802,4137467900,57882522702
2014-12-20,All-Floors,RPG,201,1710,2479992,23264961920,3042116234,26307078154
2014-12-20,All-Floors,UG,462,3510,3539939,170777989314,22076380393,192854369707
2014-12-20,All-Floors,Alumni,35,449,500306,4523316842,1393069079,5916385921
2014-12-20,All-Floors,Others(HKUST),19,388,1041256,9044531372,2289008610,11333539982
2014-12-20,All-Floors,Non-HKUST,27,185,334729,1057559301,144909475,1202468776
2014-12-20,All-Floors,Total,1047,9191,11527484,265769633861,33413383799,299183017660
2014-12-21,1,Staff,9,159,60562,101400523,10497343,111897866
2014-12-21,1,TPG,8,27,39152,512550600,22983947,535534547
2014-12-21,1,RPG,7,8,4319,103757,79338,183095
2014-12-21,1,UG,6,19,9965,0,0,0
2014-12-21,1,Alumni,1,2,3240,0,0,0
2014-12-21,1,Others(HKUST),2,47,7099,649392,317746,967138
2014-12-21,1,Non-HKUST,1,3,0,0,0,0
2014-12-21,1,Total,34,265,124337,614704272,33878374,648582646
2014-12-21,G,Staff,24,108,103757,1662626895,368407969,2031034864
2014-12-21,G,TPG,46,239,212549,1243284217,254603987,1497888204
2014-12-21,G,RPG,44,162,176110,268138914,90049364,358188278
2014-12-21,G,UG,54,226,135650,2889462887,137025845,3026488732
2014-12-21,G,Alumni,8,34,13831,87720,58962,146682
2014-12-21,G,Others(HKUST),1,3,102234,4073761,3810365,7884126
2014-12-21,G,Non-HKUST,7,22,16793,0,0,0
2014-12-21,G,Total,184,794,760924,6067674394,853956492,6921630886
2014-12-21,LG1,Staff,20,75,104028,3698613,1051306,4749919
2014-12-21,LG1,TPG,58,576,635434,405762261,55312026,461074287
2014-12-21,LG1,RPG,29,153,176661,3290134,2481442,5771576
2014-12-21,LG1,UG,76,362,365676,71255363,5791657,77047020
2014-12-21,LG1,Alumni,11,68,87707,204680,137578,342258
2014-12-21,LG1,Others(HKUST),3,121,466641,20663646,19315138,39978784
2014-12-21,LG1,Non-HKUST,4,9,2630,0,0,0
2014-12-21,LG1,Total,201,1364,1838777,504874697,84089147,588963844
2014-12-21,LG3,Staff,26,60,36535,4623685948,150645936,4774331884
2014-12-21,LG3,TPG,44,141,75862,8110675,3485763,11596438
2014-12-21,LG3,RPG,71,143,93457,3506243,1680430,5186673
2014-12-21,LG3,UG,98,190,65523,157288,72600,229888
2014-12-21,LG3,Alumni,5,30,20607,227011733,128412827,355424560
2014-12-21,LG3,Others(HKUST),3,5,3601,0,0,0
2014-12-21,LG3,Non-HKUST,6,29,36616,0,0,0
2014-12-21,LG3,Total,253,598,332201,4862471887,284297556,5146769443
2014-12-21,LG4,Staff,14,25,14731,12824,5150,17974
2014-12-21,LG4,TPG,20,67,53040,25793539,11312574,37106113
2014-12-21,LG4,RPG,55,135,73085,84472278,7051733,91524011
2014-12-21,LG4,UG,95,218,40017,3237540771,326122319,3563663090
2014-12-21,LG4,Alumni,7,46,31057,14620,9827,24447
2014-12-21,LG4,Others(HKUST),1,80,179423,8880252309,2246488410,11126740719
2014-12-21,LG4,Non-HKUST,5,6,481,0,0,0
2014-12-21,LG4,Total,197,577,391834,12228086341,2590990013,14819076354
2014-12-21,All-Floors,Staff,62,427,319613,6391424803,530607704,6922032507
2014-12-21,All-Floors,TPG,96,1050,1016037,2195501292,347698297,2543199589
2014-12-21,All-Floors,RPG,145,601,523632,359511326,101342307,460853633
2014-12-21,All-Floors,UG,249,1015,616831,6198416309,469012421,6667428730
2014-12-21,All-Floors,Alumni,21,180,156442,227318753,128619194,355937947
2014-12-21,All-Floors,Others(HKUST),6,256,758998,8905639108,2269931659,11175570767
2014-12-21,All-Floors,Non-HKUST,16,69,56520,0,0,0
2014-12-21,All-Floors,Total,595,3598,3448073,24277811591,3847211582,28125023173
2014-12-22,1,Staff,56,628,557400,11409415098,1111457533,12520872631
2014-12-22,1,TPG,14,122,174931,2123035051,1471596009,3594631060
2014-12-22,1,RPG,16,41,36069,41790087,2131356,43921443
2014-12-22,1,UG,27,147,158419,1047758226,139988233,1187746459
2014-12-22,1,Alumni,1,2,10502,266977,143318,410295
2014-12-22,1,Others(HKUST),1,52,13557,4055440,1006527,5061967
2014-12-22,1,Non-HKUST,1,11,1204,50805,26173,76978
2014-12-22,1,Total,116,1003,952082,14626371684,2726349149,17352720833
2014-12-22,G,Staff,107,587,383980,2232555925,518548276,2751104201
2014-12-22,G,TPG,76,488,488048,1666642535,102313185,1768955720
2014-12-22,G,RPG,93,352,396660,860040490,101763266,961803756
2014-12-22,G,UG,170,756,486925,1675870006,127812047,1803682053
2014-12-22,G,Alumni,5,8,243,0,0,0
2014-12-22,G,Others(HKUST),8,25,126373,25728223,22754599,48482822
2014-12-22,G,Non-HKUST,10,18,14738,0,0,0
2014-12-22,G,Total,469,2234,1896967,6460837179,873191373,7334028552
2014-12-22,LG1,Staff,61,295,176789,1230793672,80770233,1311563905
2014-12-22,LG1,TPG,88,682,748764,5005815622,575859493,5581675115
2014-12-22,LG1,RPG,83,692,695693,2619028510,1625517604,4244546114
2014-12-22,LG1,UG,177,1047,859673,1845700589,181249320,2026949909
2014-12-22,LG1,Alumni,7,67,59143,112493185,10414395,122907580
2014-12-22,LG1,Others(HKUST),12,148,472791,119653863,48642574,168296437
2014-12-22,LG1,Non-HKUST,14,64,34661,2940222,88734896,91675118
2014-12-22,LG1,Total,442,2995,3047514,10936425663,2611188515,13547614178
2014-12-22,LG3,Staff,125,277,169869,6140882542,6916981327,13057863869
2014-12-22,LG3,TPG,53,221,181454,6098934668,344654155,6443588823
2014-12-22,LG3,RPG,111,440,477029,15692055564,1308586647,17000642211
2014-12-22,LG3,UG,183,498,283271,394682186,20539262,415221448
2014-12-22,LG3,Alumni,5,21,33977,384741668,35103340,419845008
2014-12-22,LG3,Others(HKUST),5,32,43329,171065395,9730711,180796106
2014-12-22,LG3,Non-HKUST,12,34,39482,19662682,185686118,205348800
2014-12-22,LG3,Total,494,1523,1228411,28902024705,8821281560,37723306265
2014-12-22,LG4,Staff,71,242,128039,1148651365,97783694,1246435059
2014-12-22,LG4,TPG,43,320,387859,93311787388,1388095349,94699882737
2014-12-22,LG4,RPG,88,482,439031,1710705714,2406914456,4117620170
2014-12-22,LG4,UG,164,474,276923,442498159,131217632,573715791
2014-12-22,LG4,Alumni,4,170,99811,18348354545,389951626,18738306171
2014-12-22,LG4,Others(HKUST),8,179,232785,8986168298,2260169693,11246337991
2014-12-22,LG4,Non-HKUST,7,26,17579,304,0,304
2014-12-22,LG4,Total,385,1893,1582027,123948165773,6674132450,130622298223
2014-12-22,All-Floors,Staff,274,2029,1416077,22162298602,8725541063,30887839665
2014-12-22,All-Floors,TPG,142,1833,1981056,108206215264,3882518191,112088733455
2014-12-22,All-Floors,RPG,258,2007,2044482,20923620365,5444913329,26368533694
2014-12-22,All-Floors,UG,496,2922,2065211,5406509166,600806494,6007315660
2014-12-22,All-Floors,Alumni,10,268,203676,18845856375,435612679,19281469054
2014-12-22,All-Floors,Others(HKUST),23,436,888835,9306671219,2342304104,11648975323
2014-12-22,All-Floors,Non-HKUST,27,153,107664,22654013,274447187,297101200
2014-12-22,All-Floors,Total,1230,9648,8707001,184873825004,21706143047,206579968051
2014-12-23,1,Staff,52,569,709660,23426881881,1248200135,24675082016
2014-12-23,1,TPG,4,15,15026,230974064,11377471,242351535
2014-12-23,1,RPG,13,25,54287,25783148,4737703,30520851
2014-12-23,1,UG,30,241,244870,8015250830,229320400,8244571230
2014-12-23,1,Alumni,1,6,27434,4090289,1806500,5896789
2014-12-23,1,Others(HKUST),2,27,27687,144116,90512,234628
2014-12-23,1,Non-HKUST,1,15,16727,601924,444292,1046216
2014-12-23,1,Total,103,898,1095691,31703726252,1495977013,33199703265
2014-12-23,G,Staff,107,667,348240,3788922294,353571536,4142493830
2014-12-23,G,TPG,67,529,498553,818933293,567036906,1385970199
2014-12-23,G,RPG,99,511,537680,971381094,140678347,1112059441
2014-12-23,G,UG,184,748,435561,1113593183,169065015,1282658198
2014-12-23,G,Alumni,5,14,21359,1695915,318854,2014769
2014-12-23,G,Others(HKUST),7,29,136835,24278941,19753240,44032181
2014-12-23,G,Non-HKUST,6,16,1457,601924,444292,1046216
2014-12-23,G,Total,475,2514,1979685,6719406644,1250868190,7970274834
2014-12-23,LG1,Staff,77,360,320533,740176931,129281865,869458796
2014-12-23,LG1,TPG,85,732,949819,1306807890,147417893,1454225783
2014-12-23,LG1,RPG,106,833,948094,3176423029,971305274,4147728303
2014-12-23,LG1,UG,240,1937,1607179,5046141694,403319554,5449461248
2014-12-23,LG1,Alumni,9,197,149593,24729085,3623169,28352254
2014-12-23,LG1,Others(HKUST),10,249,615726,38999244,37258500,76257744
2014-12-23,LG1,Non-HKUST,14,92,59027,2795053,1777973,4573026
2014-12-23,LG1,Total,541,4400,4649971,10336072926,1693984228,12030057154
2014-12-23,LG3,Staff,119,389,248747,699471888,63767167,763239055
2014-12-23,LG3,TPG,51,147,158791,694290494,19965760,714256254
2014-12-23,LG3,RPG,135,466,528777,226754766,52075247,278830013
2014-12-23,LG3,UG,209,587,288868,888172352,69481695,957654047
2014-12-23,LG3,Alumni,6,19,24763,0,0,0
2014-12-23,LG3,Others(HKUST),12,37,57304,3175188,834688,4009876
2014-12-23,LG3,Non-HKUST,12,40,45971,15329873,1703011,17032884
2014-12-23,LG3,Total,544,1685,1353221,2527194561,207827568,2735022129
2014-12-23,LG4,Staff,80,290,106717,784277485,80728458,865005943
2014-12-23,LG4,TPG,42,262,295873,64689893,6688388,71378281
2014-12-23,LG4,RPG,106,584,488222,1945580447,105466141,2051046588
2014-12-23,LG4,UG,157,588,343754,890971876,133491817,1024463693
2014-12-23,LG4,Alumni,9,155,122572,29678843,3998392,33677235
2014-12-23,LG4,Others(HKUST),9,163,156936,18117878,4718006,22835884
2014-12-23,LG4,Non-HKUST,6,63,59744,0,0,0
2014-12-23,LG4,Total,409,2105,1573818,3733316422,335091202,4068407624
2014-12-23,All-Floors,Staff,254,2275,1733897,29439730479,1875549161,31315279640
2014-12-23,All-Floors,TPG,130,1685,1918062,3115695634,752486418,3868182052
2014-12-23,All-Floors,RPG,298,2419,2557060,6345922484,1274262712,7620185196
2014-12-23,All-Floors,UG,551,4101,2920232,15954129935,1004678481,16958808416
2014-12-23,All-Floors,Alumni,17,391,345721,60194132,9746915,69941047
2014-12-23,All-Floors,Others(HKUST),24,505,994488,84715367,62654946,147370313
2014-12-23,All-Floors,Non-HKUST,21,226,182926,19328774,4369568,23698342
2014-12-23,All-Floors,Total,1295,11602,10652386,55019716805,4983748201,60003465006
2014-12-24,1,Staff,44,310,368726,2521147553,441905502,2963053055
2014-12-24,1,TPG,5,18,4088,10032,2454,12486
2014-12-24,1,RPG,7,19,64990,3260915,1382145,4643060
2014-12-24,1,UG,8,22,36481,20027232,3347807,23375039
2014-12-24,1,Alumni,1,3,0,120471,73148,193619
2014-12-24,1,Others(HKUST),1,19,16456,39569,25268,64837
2014-12-24,1,Non-HKUST,1,3,14190,20233004,1650154,21883158
2014-12-24,1,Total,67,394,504931,2564838776,448386478,3013225254
2014-12-24,G,Staff,62,246,145101,473473069,47518855,520991924
2014-12-24,G,TPG,23,97,91270,273626,78109,351735
2014-12-24,G,RPG,45,141,121967,34715132,4332040,39047172
2014-12-24,G,UG,54,178,104364,29928449,3013594,32942043
2014-12-24,G,Alumni,4,10,984,82094,50022,132116
2014-12-24,G,Others(HKUST),5,8,102258,6981196,6598904,13580100
2014-12-24,G,Non-HKUST,6,8,1058,0,0,0
2014-12-24,G,Total,199,688,567002,545453566,61591524,607045090
2014-12-24,LG1,Staff,34,130,108447,1315959,505242,1821201
2014-12-24,LG1,TPG,29,131,171344,239554363,17596573,257150936
2014-12-24,LG1,RPG,43,190,168670,4838997,750206,5589203
2014-12-24,LG1,UG,56,338,246614,430707151,30773448,461480599
2014-12-24,LG1,Alumni,4,24,31081,268248,162745,430993
2014-12-24,LG1,Others(HKUST),4,112,459986,68742284,42667944,111410228
2014-12-24,LG1,Non-HKUST,5,15,4098,404873152,12859647,417732799
2014-12-24,LG1,Total,175,940,1190240,1150300154,105315805,1255615959
2014-12-24,LG3,Staff,67,170,105563,120980889,8663241,129644130
2014-12-24,LG3,TPG,27,80,94724,47937836629,2621867662,50559704291
2014-12-24,LG3,RPG,87,253,202727,175670868,12590604,188261472
2014-12-24,LG3,UG,98,169,87802,17998310,1124679,19122989
2014-12-24,LG3,Alumni,4,9,14518,0,0,0
2014-12-24,LG3,Others(HKUST),6,22,26916,1928538,438634,2367172
2014-12-24,LG3,Non-HKUST,5,7,4591,12543900,2870318,15414218
2014-12-24,LG3,Total,294,710,536841,48266959134,2647555138,50914514272
2014-12-24,LG4,Staff,43,115,28437,55372299,7902448,63274747
2014-12-24,LG4,TPG,15,36,22439,5510,2319,7829
2014-12-24,LG4,RPG,58,161,108969,617307729,63840171,681147900
2014-12-24,LG4,UG,58,147,104613,212606932,36727490,249334422
2014-12-24,LG4,Alumni,2,27,16840,11473,3841,15314
2014-12-24,LG4,Others(HKUST),6,155,196875,325558358,25718805,351277163
2014-12-24,LG4,Non-HKUST,3,28,8184,0,0,0
2014-12-24,LG4,Total,185,669,486357,1210862301,134195074,1345057375
2014-12-24,All-Floors,Staff,169,971,756274,3172289769,506495288,3678785057
2014-12-24,All-Floors,TPG,63,362,383865,48177680160,2639547117,50817227277
2014-12-24,All-Floors,RPG,168,764,667323,835793641,82895166,918688807
2014-12-24,All-Floors,UG,209,854,579874,711268074,74987018,786255092
2014-12-24,All-Floors,Alumni,9,73,63423,482286,289756,772042
2014-12-24,All-Floors,Others(HKUST),14,316,802491,403249945,75449555,478699500
2014-12-24,All-Floors,Non-HKUST,12,61,32121,437650056,17380119,455030175
2014-12-24,All-Floors,Total,644,3401,3285371,53738413931,3397044019,57135457950
2014-12-25,1,Staff,7,128,23450,4514099,966400,5480499
2014-12-25,1,TPG,0,0,0,0,0,0
2014-12-25,1,RPG,4,6,24234,0,0,0
2014-12-25,1,UG,0,0,0,0,0,0
2014-12-25,1,Alumni,0,0,0,0,0,0
2014-12-25,1,Others(HKUST),2,25,16336,0,0,0
2014-12-25,1,Non-HKUST,1,1,0,0,0,0
2014-12-25,1,Total,14,160,64020,4514099,966400,5480499
2014-12-25,G,Staff,0,0,0,0,0,0
2014-12-25,G,TPG,0,0,0,0,0,0
2014-12-25,G,RPG,1,1,0,0,0,0
2014-12-25,G,UG,4,4,0,9919,4426,14345
2014-12-25,G,Alumni,0,0,0,0,0,0
2014-12-25,G,Others(HKUST),1,1,86399,6981196,6598904,13580100
2014-12-25,G,Non-HKUST,0,0,0,0,0,0
2014-12-25,G,Total,6,6,86399,6991115,6603330,13594445
2014-12-25,LG1,Staff,3,11,242,229734,63597,293331
2014-12-25,LG1,TPG,0,0,0,0,0,0
2014-12-25,LG1,RPG,6,6,0,0,0,0
2014-12-25,LG1,UG,5,5,0,659913,99582,759495
2014-12-25,LG1,Alumni,1,3,481,0,0,0
2014-12-25,LG1,Others(HKUST),3,59,441459,20900011,19420571,40320582
2014-12-25,LG1,Non-HKUST,0,0,0,0,0,0
2014-12-25,LG1,Total,18,84,442182,21789658,19583750,41373408
2014-12-25,LG3,Staff,8,12,723,6718230,1599123,8317353
2014-12-25,LG3,TPG,5,8,244,0,0,0
2014-12-25,LG3,RPG,17,20,15941,0,0,0
2014-12-25,LG3,UG,39,43,956,0,0,0
2014-12-25,LG3,Alumni,1,1,0,0,0,0
2014-12-25,LG3,Others(HKUST),2,5,0,0,0,0
2014-12-25,LG3,Non-HKUST,0,0,0,0,0,0
2014-12-25,LG3,Total,72,89,17864,6718230,1599123,8317353
2014-12-25,LG4,Staff,11,17,606,1264559,421543,1686102
2014-12-25,LG4,TPG,5,6,476,0,0,0
2014-12-25,LG4,RPG,21,23,2162,987971,464743,1452714
2014-12-25,LG4,UG,42,76,18683,37356065,1835464,39191529
2014-12-25,LG4,Alumni,1,1,0,0,0,0
2014-12-25,LG4,Others(HKUST),2,93,167007,61303047,119688191,180991238
2014-12-25,LG4,Non-HKUST,2,2,0,0,0,0
2014-12-25,LG4,Total,84,218,188934,100911642,122409941,223321583
2014-12-25,All-Floors,Staff,23,168,25021,12726622,3050663,15777285
2014-12-25,All-Floors,TPG,9,14,720,0,0,0
2014-12-25,All-Floors,RPG,48,56,42337,987971,464743,1452714
2014-12-25,All-Floors,UG,84,128,19639,38025897,1939472,39965369
2014-12-25,All-Floors,Alumni,3,5,481,0,0,0
2014-12-25,All-Floors,Others(HKUST),7,183,711201,89184254,145707666,234891920
2014-12-25,All-Floors,Non-HKUST,3,3,0,0,0,0
2014-12-25,All-Floors,Total,177,557,799399,140924744,151162544,292087288
2014-12-26,1,Staff,5,87,41472,2640498414,67980777,2708479191
2014-12-26,1,TPG,0,0,0,0,0,0
2014-12-26,1,RPG,4,10,7311,202451608,10351217,212802825
2014-12-26,1,UG,1,1,240,0,0,0
2014-12-26,1,Alumni,0,0,0,0,0,0
2014-12-26,1,Others(HKUST),1,29,23980,49654,27611,77265
2014-12-26,1,Non-HKUST,0,0,0,0,0,0
2014-12-26,1,Total,11,127,73003,2842999676,78359605,2921359281
2014-12-26,G,Staff,2,5,121,66054,40950,107004
2014-12-26,G,TPG,2,2,0,0,0,0
2014-12-26,G,RPG,3,3,241,1562407,361752,1924159
2014-12-26,G,UG,2,2,0,0,0,0
2014-12-26,G,Alumni,0,0,0,0,0,0
2014-12-26,G,Others(HKUST),2,2,86399,6981196,6598904,13580100
2014-12-26,G,Non-HKUST,0,0,0,0,0,0
2014-12-26,G,Total,11,14,86761,8609657,7001606,15611263
2014-12-26,LG1,Staff,5,5,117,0,0,0
2014-12-26,LG1,TPG,0,0,0,0,0,0
2014-12-26,LG1,RPG,6,6,0,80206,63274,143480
2014-12-26,LG1,UG,16,18,849,0,0,0
2014-12-26,LG1,Alumni,0,0,0,0,0,0
2014-12-26,LG1,Others(HKUST),3,20,430189,51538276,48378640,99916916
2014-12-26,LG1,Non-HKUST,1,1,599,0,0,0
2014-12-26,LG1,Total,31,50,431754,51618482,48441914,100060396
2014-12-26,LG3,Staff,8,8,119,0,0,0
2014-12-26,LG3,TPG,5,11,26392,11091366,4225291,15316657
2014-12-26,LG3,RPG,28,33,3491,4960084,926804,5886888
2014-12-26,LG3,UG,46,61,12011,795332334,17301891,812634225
2014-12-26,LG3,Alumni,1,1,0,0,0,0
2014-12-26,LG3,Others(HKUST),2,5,0,140258,121531,261789
2014-12-26,LG3,Non-HKUST,2,2,118,0,0,0
2014-12-26,LG3,Total,92,121,42131,811524042,22575517,834099559
2014-12-26,LG4,Staff,8,14,358,0,0,0
2014-12-26,LG4,TPG,7,13,2278,0,0,0
2014-12-26,LG4,RPG,21,23,475,22657912,5930271,28588183
2014-12-26,LG4,UG,44,108,9844,189425016,33192728,222617744
2014-12-26,LG4,Alumni,2,4,0,461052,268167,729219
2014-12-26,LG4,Others(HKUST),2,66,160328,5500661,4673147,10173808
2014-12-26,LG4,Non-HKUST,5,6,8400,0,0,0
2014-12-26,LG4,Total,89,234,181683,218044641,44064313,262108954
2014-12-26,All-Floors,Staff,27,119,42187,2640564468,68021727,2708586195
2014-12-26,All-Floors,TPG,13,26,28670,11091366,4225291,15316657
2014-12-26,All-Floors,RPG,60,75,11518,231712217,17633318,249345535
2014-12-26,All-Floors,UG,102,190,22944,984757350,50494619,1035251969
2014-12-26,All-Floors,Alumni,3,5,0,461052,268167,729219
2014-12-26,All-Floors,Others(HKUST),6,122,700896,64210045,59799833,124009878
2014-12-26,All-Floors,Non-HKUST,8,9,9117,0,0,0
2014-12-26,All-Floors,Total,219,546,815332,3932796498,200442955,4133239453
2014-12-27,1,Staff,11,120,81706,74286887,14378176,88665063
2014-12-27,1,TPG,1,2,2889,0,0,0
2014-12-27,1,RPG,9,24,27829,64120007,12149794,76269801
2014-12-27,1,UG,3,9,491,55021,51409,106430
2014-12-27,1,Alumni,1,1,0,0,0,0
2014-12-27,1,Others(HKUST),2,38,23296,1664846,323466,1988312
2014-12-27,1,Non-HKUST,1,1,0,0,0,0
2014-12-27,1,Total,28,195,136211,140126761,26902845,167029606
2014-12-27,G,Staff,26,173,173579,22382916,7215969,29598885
2014-12-27,G,TPG,57,379,431239,1667277320,174070357,1841347677
2014-12-27,G,RPG,59,197,282787,465052114,62960536,528012650
2014-12-27,G,UG,76,392,312439,918395171,23796356,942191527
2014-12-27,G,Alumni,18,85,65686,429921325,19284086,449205411
2014-12-27,G,Others(HKUST),6,41,140402,405348230,144917229,550265459
2014-12-27,G,Non-HKUST,5,15,5885,0,0,0
2014-12-27,G,Total,247,1282,1412017,3908377076,432244533,4340621609
2014-12-27,LG1,Staff,21,179,203251,414220340,49156358,463376698
2014-12-27,LG1,TPG,50,497,633442,116798243,157185203,273983446
2014-12-27,LG1,RPG,62,518,604335,371573976,17788440,389362416
2014-12-27,LG1,UG,95,792,1006839,1238708944,77064482,1315773426
2014-12-27,LG1,Alumni,15,183,128345,80642553,62956732,143599285
2014-12-27,LG1,Others(HKUST),7,69,480494,52415267,49424260,101839527
2014-12-27,LG1,Non-HKUST,7,15,32508,0,0,0
2014-12-27,LG1,Total,257,2253,3089214,2274359323,413575475,2687934798
2014-12-27,LG3,Staff,30,69,33186,8337401,1982087,10319488
2014-12-27,LG3,TPG,40,201,178062,2204369115,505122455,2709491570
2014-12-27,LG3,RPG,88,408,478924,7782634343,2999733330,10782367673
2014-12-27,LG3,UG,84,281,140069,416258550,10668547,426927097
2014-12-27,LG3,Alumni,20,76,77834,65504494,11900482,77404976
2014-12-27,LG3,Others(HKUST),9,38,45692,5440279,3444609,8884888
2014-12-27,LG3,Non-HKUST,7,11,11882,0,0,0
2014-12-27,LG3,Total,278,1084,965649,10482544182,3532851510,14015395692
2014-12-27,LG4,Staff,22,61,70941,663745179,1015742652,1679487831
2014-12-27,LG4,TPG,26,333,361838,931932096,307602107,1239534203
2014-12-27,LG4,RPG,43,248,254767,11374144720,7090931430,18465076150
2014-12-27,LG4,UG,65,329,177316,229225989,58210150,287436139
2014-12-27,LG4,Alumni,14,153,123006,1954900378,77198932,2032099310
2014-12-27,LG4,Others(HKUST),6,150,233763,204017948,54172846,258190794
2014-12-27,LG4,Non-HKUST,2,14,35042,0,0,0
2014-12-27,LG4,Total,178,1288,1256673,15357966310,8603858117,23961824427
2014-12-27,All-Floors,Staff,70,602,562663,1182972723,1088475242,2271447965
2014-12-27,All-Floors,TPG,96,1412,1607470,4920376774,1143980122,6064356896
2014-12-27,All-Floors,RPG,160,1395,1648642,20057525160,10183563530,30241088690
2014-12-27,All-Floors,UG,216,1803,1637154,2802643675,169790944,2972434619
2014-12-27,All-Floors,Alumni,35,498,394871,2530968750,171340232,2702308982
2014-12-27,All-Floors,Others(HKUST),16,336,923647,668886570,252282410,921168980
2014-12-27,All-Floors,Non-HKUST,15,56,85317,0,0,0
2014-12-27,All-Floors,Total,608,6102,6859764,32163373652,13009432480,45172806132
2014-12-28,1,Staff,5,76,16645,315401,97411,412812
2014-12-28,1,TPG,1,1,7558,0,0,0
2014-12-28,1,RPG,14,51,50784,4701658227,75017493,4776675720
2014-12-28,1,UG,7,16,18349,47620,22441,70061
2014-12-28,1,Alumni,0,0,0,0,0,0
2014-12-28,1,Others(HKUST),1,28,20387,428908,154420,583328
2014-12-28,1,Non-HKUST,0,0,0,0,0,0
2014-12-28,1,Total,28,172,113723,4702450156,75291765,4777741921
2014-12-28,G,Staff,14,63,46052,98784,110331,209115
2014-12-28,G,TPG,24,124,120899,9300251442,156185260,9456436702
2014-12-28,G,RPG,36,156,151439,12952443668,351881471,13304325139
2014-12-28,G,UG,36,129,96287,383374061,19604223,402978284
2014-12-28,G,Alumni,11,44,54147,56576480,1802662,58379142
2014-12-28,G,Others(HKUST),2,7,97692,7020080,6672480,13692560
2014-12-28,G,Non-HKUST,8,18,11172,0,0,0
2014-12-28,G,Total,131,541,577688,22699764515,536256427,23236020942
2014-12-28,LG1,Staff,16,93,89295,244576,260999,505575
2014-12-28,LG1,TPG,36,296,341375,2886620375,232599449,3119219824
2014-12-28,LG1,RPG,38,138,241671,105764477,2138288,107902765
2014-12-28,LG1,UG,47,311,361085,766676567,118134402,884810969
2014-12-28,LG1,Alumni,11,49,61764,0,0,0
2014-12-28,LG1,Others(HKUST),2,21,431145,19786896,18357077,38143973
2014-12-28,LG1,Non-HKUST,4,10,3722,0,0,0
2014-12-28,LG1,Total,154,918,1530057,3779092891,371490215,4150583106
2014-12-28,LG3,Staff,24,55,41533,309752,95776,405528
2014-12-28,LG3,TPG,30,72,53729,3626507526,230193924,3856701450
2014-12-28,LG3,RPG,58,103,71150,21434505,4860213,26294718
2014-12-28,LG3,UG,75,148,83064,24403409,4025320,28428729
2014-12-28,LG3,Alumni,9,58,58801,116940,84336,201276
2014-12-28,LG3,Others(HKUST),3,5,0,4906,1186,6092
2014-12-28,LG3,Non-HKUST,8,44,23012,0,0,0
2014-12-28,LG3,Total,207,485,331289,3672777038,239260755,3912037793
2014-12-28,LG4,Staff,15,28,4926,0,0,0
2014-12-28,LG4,TPG,23,73,96995,3464749615,5249182314,8713931929
2014-12-28,LG4,RPG,48,71,39214,187278,136650,323928
2014-12-28,LG4,UG,55,171,86536,206231988,63767914,269999902
2014-12-28,LG4,Alumni,6,40,53151,579581978,41806866,621388844
2014-12-28,LG4,Others(HKUST),3,72,142133,3770127336,1319340325,5089467661
2014-12-28,LG4,Non-HKUST,6,17,4470,0,0,0
2014-12-28,LG4,Total,156,472,427425,8020878195,6674234069,14695112264
2014-12-28,All-Floors,Staff,46,315,198451,968513,564517,1533030
2014-12-28,All-Floors,TPG,61,566,620556,19278128958,5868160947,25146289905
2014-12-28,All-Floors,RPG,143,519,554258,17781488155,434034115,18215522270
2014-12-28,All-Floors,UG,166,775,645321,1380733645,205554300,1586287945
2014-12-28,All-Floors,Alumni,25,191,227863,636275398,43693864,679969262
2014-12-28,All-Floors,Others(HKUST),6,133,691357,3797368126,1344525488,5141893614
2014-12-28,All-Floors,Non-HKUST,13,89,42376,0,0,0
2014-12-28,All-Floors,Total,460,2588,2980182,42874962795,7896533231,50771496026
2014-12-29,1,Staff,60,701,713418,5518862585,296516596,5815379181
2014-12-29,1,TPG,4,4,0,17391,6330,23721
2014-12-29,1,RPG,14,42,44616,286385876,27424216,313810092
2014-12-29,1,UG,19,68,54735,559563345,67706408,627269753
2014-12-29,1,Alumni,4,10,44367,550248,238848,789096
2014-12-29,1,Others(HKUST),2,68,39896,505689969,13827038,519517007
2014-12-29,1,Non-HKUST,2,15,16562,422952,80889,503841
2014-12-29,1,Total,105,908,913594,6871492366,405800325,7277292691
2014-12-29,G,Staff,108,538,527058,1140223336,91001342,1231224678
2014-12-29,G,TPG,42,340,301211,1174424179,190535126,1364959305
2014-12-29,G,RPG,99,550,533257,2201975980,932040098,3134016078
2014-12-29,G,UG,138,512,445946,51195174895,3808775192,55003950087
2014-12-29,G,Alumni,8,59,26941,0,0,0
2014-12-29,G,Others(HKUST),5,20,123235,13979006,13204729,27183735
2014-12-29,G,Non-HKUST,14,53,67154,47756415,29811335,77567750
2014-12-29,G,Total,414,2072,2024802,55773533811,5065367822,60838901633
2014-12-29,LG1,Staff,83,564,409552,355080263,27659909,382740172
2014-12-29,LG1,TPG,69,814,1011837,46780530,316946230,363726760
2014-12-29,LG1,RPG,96,686,851557,76238220547,4664542194,80902762741
2014-12-29,LG1,UG,189,1934,1733258,1730176253,79953431,1810129684
2014-12-29,LG1,Alumni,9,43,22010,5305786,2929442,8235228
2014-12-29,LG1,Others(HKUST),8,138,508284,30354419,28105589,58460008
2014-12-29,LG1,Non-HKUST,9,46,58693,0,0,0
2014-12-29,LG1,Total,463,4225,4595191,78405917798,5120136795,83526054593
2014-12-29,LG3,Staff,153,449,210210,354863824,417417103,772280927
2014-12-29,LG3,TPG,43,195,180120,5406631165,180651661,5587282826
2014-12-29,LG3,RPG,164,542,512468,4058241576,813403633,4871645209
2014-12-29,LG3,UG,176,649,391987,358360226,25495153,383855379
2014-12-29,LG3,Alumni,7,77,78699,0,0,0
2014-12-29,LG3,Others(HKUST),12,21,568,46494938,4286008,50780946
2014-12-29,LG3,Non-HKUST,15,56,107325,0,0,0
2014-12-29,LG3,Total,570,1989,1481377,10224591729,1441253558,11665845287
2014-12-29,LG4,Staff,87,315,175948,135488981,29151860,164640841
2014-12-29,LG4,TPG,35,314,337326,637468299,60598667,698066966
2014-12-29,LG4,RPG,118,529,424665,34445994978,2157433426,36603428404
2014-12-29,LG4,UG,121,520,373393,456747026,98367257,555114283
2014-12-29,LG4,Alumni,7,61,75085,39105,27921,67026
2014-12-29,LG4,Others(HKUST),7,134,176844,3865807459,770500060,4636307519
2014-12-29,LG4,Non-HKUST,4,61,29674,11387102,416357,11803459
2014-12-29,LG4,Total,379,1934,1592935,39552932950,3116495548,42669428498
2014-12-29,All-Floors,Staff,294,2567,2036186,7504518989,861746810,8366265799
2014-12-29,All-Floors,TPG,104,1667,1830494,7265321564,748738014,8014059578
2014-12-29,All-Floors,RPG,322,2349,2366563,117230818957,8594843567,125825662524
2014-12-29,All-Floors,UG,421,3683,2999319,54300021745,4080297441,58380319186
2014-12-29,All-Floors,Alumni,18,250,247102,5895139,3196211,9091350
2014-12-29,All-Floors,Others(HKUST),23,381,848827,4462325791,829923424,5292249215
2014-12-29,All-Floors,Non-HKUST,26,231,279408,59566469,30308581,89875050
2014-12-29,All-Floors,Total,1208,11128,10607899,190828468654,15149054048,205977522702
2014-12-30,1,Staff,56,594,584397,3788481342,234742534,4023223876
2014-12-30,1,TPG,2,23,15514,1961718,815340,2777058
2014-12-30,1,RPG,14,41,47031,356978581,8067899,365046480
2014-12-30,1,UG,14,81,83132,1454864757,115099966,1569964723
2014-12-30,1,Alumni,4,45,62473,7131054,49192540,56323594
2014-12-30,1,Others(HKUST),4,40,93555,151688385,4344529,156032914
2014-12-30,1,Non-HKUST,2,19,6393,4230,5273,9503
2014-12-30,1,Total,96,843,892495,5761110067,412268081,6173378148
2014-12-30,G,Staff,102,565,464483,1410367808,152202621,1562570429
2014-12-30,G,TPG,45,243,277385,282408094,42589765,324997859
2014-12-30,G,RPG,89,460,472763,914445575,63881407,978326982
2014-12-30,G,UG,83,293,264128,1116166174,88048827,1204215001
2014-12-30,G,Alumni,6,53,47071,977015,8097625,9074640
2014-12-30,G,Others(HKUST),7,13,132543,6981196,6598904,13580100
2014-12-30,G,Non-HKUST,10,80,52701,4230,5273,9503
2014-12-30,G,Total,342,1707,1711074,3731350092,361424422,4092774514
2014-12-30,LG1,Staff,66,429,298376,1349711453,80447712,1430159165
2014-12-30,LG1,TPG,47,409,498435,1476542173,66582515,1543124688
2014-12-30,LG1,RPG,110,897,1044722,2109546030,147683785,2257229815
2014-12-30,LG1,UG,125,1044,1128468,329471079,25927045,355398124
2014-12-30,LG1,Alumni,8,20,4189,362460,187045,549505
2014-12-30,LG1,Others(HKUST),6,79,440802,95027499,28683861,123711360
2014-12-30,LG1,Non-HKUST,10,62,60089,89993162,18039681,108032843
2014-12-30,LG1,Total,372,2940,3475081,5450653856,367551644,5818205500
2014-12-30,LG3,Staff,128,348,211725,231276228,73253694,304529922
2014-12-30,LG3,TPG,39,164,146063,416897469,167724386,584621855
2014-12-30,LG3,RPG,157,509,541855,1340124056,883448409,2223572465
2014-12-30,LG3,UG,139,751,666148,1052172184,449430769,1501602953
2014-12-30,LG3,Alumni,7,31,31334,8212,5043,13255
2014-12-30,LG3,Others(HKUST),10,14,1428,1583725,943732,2527457
2014-12-30,LG3,Non-HKUST,12,43,46905,0,0,0
2014-12-30,LG3,Total,492,1860,1645458,3042061874,1574806033,4616867907
2014-12-30,LG4,Staff,99,256,148776,1020918409,166822786,1187741195
2014-12-30,LG4,TPG,34,354,470912,2612934447,2356896849,4969831296
2014-12-30,LG4,RPG,110,521,479547,11662852050,468459412,12131311462
2014-12-30,LG4,UG,109,355,250259,116376386,7320558,123696944
2014-12-30,LG4,Alumni,7,83,90862,0,0,0
2014-12-30,LG4,Others(HKUST),9,193,186724,13696922330,403142249,14100064579
2014-12-30,LG4,Non-HKUST,9,79,73782,16204,8253,24457
2014-12-30,LG4,Total,377,1841,1700862,29110019826,3402650107,32512669933
2014-12-30,All-Floors,Staff,289,2192,1707757,7800755240,707469347,8508224587
2014-12-30,All-Floors,TPG,92,1193,1408309,4790743901,2634608855,7425352756
2014-12-30,All-Floors,RPG,320,2428,2585918,16383946292,1571540912,17955487204
2014-12-30,All-Floors,UG,326,2524,2392135,4069050580,685827165,4754877745
2014-12-30,All-Floors,Alumni,15,232,235929,8478741,57482253,65960994
2014-12-30,All-Floors,Others(HKUST),25,339,855052,13952203135,443713275,14395916410
2014-12-30,All-Floors,Non-HKUST,22,283,239870,90017826,18058480,108076306
2014-12-30,All-Floors,Total,1089,9191,9424970,47095195715,6118700287,53213896002
2014-12-31,1,Staff,37,299,270256,2748247936,74022212,2822270148
2014-12-31,1,TPG,0,0,0,0,0,0
2014-12-31,1,RPG,7,16,14607,5393925,19078012,24471937
2014-12-31,1,UG,7,24,27896,63312796,55573982,118886778
2014-12-31,1,Alumni,1,3,2162,204165,82555,286720
2014-12-31,1,Others(HKUST),2,45,92302,149754699,3889838,153644537
2014-12-31,1,Non-HKUST,1,3,4319,10296,3048,13344
2014-12-31,1,Total,55,390,411542,2966923817,152649647,3119573464
2014-12-31,G,Staff,51,247,268688,2173802990,103487480,2277290470
2014-12-31,G,TPG,7,16,16365,0,0,0
2014-12-31,G,RPG,41,174,185860,920817320,54278203,975095523
2014-12-31,G,UG,34,123,98937,27180886,3349151,30530037
2014-12-31,G,Alumni,3,18,14362,0,0,0
2014-12-31,G,Others(HKUST),6,62,142401,79835216,14306480,94141696
2014-12-31,G,Non-HKUST,1,1,0,0,0,0
2014-12-31,G,Total,143,641,726613,3201636412,175421314,3377057726
2014-12-31,LG1,Staff,56,233,145741,2993747945,73129614,3066877559
2014-12-31,LG1,TPG,14,104,125570,2886653854,44524311,2931178165
2014-12-31,LG1,RPG,41,166,196203,294617040,477448162,772065202
2014-12-31,LG1,UG,55,321,291621,81807,42603,124410
2014-12-31,LG1,Alumni,2,3,2778,0,0,0
2014-12-31,LG1,Others(HKUST),3,12,434766,11627498,10900558,22528056
2014-12-31,LG1,Non-HKUST,1,1,0,0,0,0
2014-12-31,LG1,Total,172,840,1196679,6186728144,606045248,6792773392
2014-12-31,LG3,Staff,77,219,70183,161474340,11120275,172594615
2014-12-31,LG3,TPG,15,23,13089,0,0,0
2014-12-31,LG3,RPG,104,244,170965,71155030,6554800,77709830
2014-12-31,LG3,UG,89,120,41059,200244414,74024185,274268599
2014-12-31,LG3,Alumni,5,8,15451,0,0,0
2014-12-31,LG3,Others(HKUST),6,10,0,501501686,10773629,512275315
2014-12-31,LG3,Non-HKUST,3,6,4946,0,0,0
2014-12-31,LG3,Total,299,630,315693,934375470,102472889,1036848359
2014-12-31,LG4,Staff,56,109,30643,117938377,8924416,126862793
2014-12-31,LG4,TPG,11,53,50121,1371050110,213530800,1584580910
2014-12-31,LG4,RPG,74,149,69023,16049031,3444376,19493407
2014-12-31,LG4,UG,82,173,55141,77538,40538,118076
2014-12-31,LG4,Alumni,5,20,20576,0,0,0
2014-12-31,LG4,Others(HKUST),1,195,250504,11437058025,5375193632,16812251657
2014-12-31,LG4,Non-HKUST,4,5,5287,91557,56061,147618
2014-12-31,LG4,Total,233,704,481295,12942264638,5601189823,18543454461
2014-12-31,All-Floors,Staff,185,1107,785511,8195211588,270683997,8465895585
2014-12-31,All-Floors,TPG,32,196,205145,4257703964,258055111,4515759075
2014-12-31,All-Floors,RPG,207,749,636658,1308032346,560803553,1868835899
2014-12-31,All-Floors,UG,197,761,514654,290897441,133030459,423927900
2014-12-31,All-Floors,Alumni,12,52,55329,204165,82555,286720
2014-12-31,All-Floors,Others(HKUST),12,324,919973,12179777124,5415064137,17594841261
2014-12-31,All-Floors,Non-HKUST,6,16,14552,101853,59109,160962
2014-12-31,All-Floors,Total,651,3205,3131822,26231928481,6637778921,32869707402