Date,Floor,User-Group,User-Count,WiFi-Conn,Duration-Sec,Traffic-In-Byte,Traffic-Out-Byte,Traffic-Both-Byte
2014-10-01,1,Staff,6,46,145939,7025184,3972213,10997397
2014-10-01,1,TPG,4,6,359,68669,59640,128309
2014-10-01,1,RPG,8,12,19559,22014883,1731085,23745968
2014-10-01,1,UG,8,8,1078,95312,59683,154995
2014-10-01,1,Alumni,0,0,0,0,0,0
2014-10-01,1,Others(HKUST),1,55,43078,1374498,2578224,3952722
2014-10-01,1,Non-HKUST,0,0,0,0,0,0
2014-10-01,1,Total,27,127,210013,30578546,8400845,38979391
2014-10-01,G,Staff,4,6,358,0,0,0
2014-10-01,G,TPG,11,64,9195,10412831,4178956,14591787
2014-10-01,G,RPG,7,7,7431,262696,140729,403425
2014-10-01,G,UG,30,33,31068,405420031,57534072,462954103
2014-10-01,G,Alumni,0,0,0,0,0,0
2014-10-01,G,Others(HKUST),1,1,0,28803,43349,72152
2014-10-01,G,Non-HKUST,1,1,0,0,0,0
2014-10-01,G,Total,54,112,48052,416124361,61897106,478021467
2014-10-01,LG1,Staff,25,169,266312,169943697,102421077,272364774
2014-10-01,LG1,TPG,237,4159,5522220,2108507896,406557736,2515065632
2014-10-01,LG1,RPG,114,1320,1897836,530779728,49916022,580695750
2014-10-01,LG1,UG,689,9238,13339090,51403075946,6064655077,57467731023
2014-10-01,LG1,Alumni,4,46,84569,0,0,0
2014-10-01,LG1,Others(HKUST),9,263,671205,89192307,63166530,152358837
2014-10-01,LG1,Non-HKUST,22,124,196756,35418781,3150549,38569330
2014-10-01,LG1,Total,1100,15319,21977988,54336918355,6689866991,61026785346
2014-10-01,LG3,Staff,23,39,12837,10886422,1113867,12000289
2014-10-01,LG3,TPG,64,144,65990,127410129,22366376,149776505
2014-10-01,LG3,RPG,97,131,47875,516777930,23932450,540710380
2014-10-01,LG3,UG,317,418,80399,289069064,60714441,349783505
2014-10-01,LG3,Alumni,1,1,0,7194,2984,10178
2014-10-01,LG3,Others(HKUST),10,79,14422,47878903,6566791,54445694
2014-10-01,LG3,Non-HKUST,14,18,8516,12210122,1725038,13935160
2014-10-01,LG3,Total,526,830,230039,1004239764,116421947,1120661711
2014-10-01,LG4,Staff,14,15,10198,1731454,603525,2334979
2014-10-01,LG4,TPG,24,51,29392,33066126,6467935,39534061
2014-10-01,LG4,RPG,49,62,20138,132784377,10422956,143207333
2014-10-01,LG4,UG,142,202,128019,1128585120,146952042,1275537162
2014-10-01,LG4,Alumni,2,3,484,161158,136073,297231
2014-10-01,LG4,Others(HKUST),2,65,149983,14657147952,7691346287,22348494239
2014-10-01,LG4,Non-HKUST,2,2,360,146382,104848,251230
2014-10-01,LG4,Total,235,400,338574,15953622569,7856033666,23809656235
2014-10-01,All-Floors,Staff,60,275,435644,189586757,108110682,297697439
2014-10-01,All-Floors,TPG,265,4424,5627156,2279465651,439630643,2719096294
2014-10-01,All-Floors,RPG,209,1532,1992839,1202619614,86143242,1288762856
2014-10-01,All-Floors,UG,868,9899,13579654,53226245473,6329915315,59556160788
2014-10-01,All-Floors,Alumni,7,50,85053,168352,139057,307409
2014-10-01,All-Floors,Others(HKUST),14,463,878688,14795622463,7763701181,22559323644
2014-10-01,All-Floors,Non-HKUST,31,145,205632,47775285,4980435,52755720
2014-10-01,All-Floors,Total,1454,16788,22804666,71741483595,14732620555,86474104150
2014-10-02,1,Staff,5,49,155354,7709076,4225054,11934130
2014-10-02,1,TPG,2,3,601,1671998,493676,2165674
2014-10-02,1,RPG,5,6,4916,88659772,6961530,95621302
2014-10-02,1,UG,7,7,956,161984,93577,255561
2014-10-02,1,Alumni,0,0,0,0,0,0
2014-10-02,1,Others(HKUST),1,47,16045,795775,731600,1527375
2014-10-02,1,Non-HKUST,0,0,0,0,0,0
2014-10-02,1,Total,20,112,177872,98998605,12505437,111504042
2014-10-02,G,Staff,3,3,0,41372978,18157483,59530461
2014-10-02,G,TPG,6,9,2647,5120364,627169,5747533
2014-10-02,G,RPG,6,6,475,6494,15604,22098
2014-10-02,G,UG,24,29,8758,1895071,633943,2529014
2014-10-02,G,Alumni,0,0,0,0,0,0
2014-10-02,G,Others(HKUST),1,2,0,0,0,0
2014-10-02,G,Non-HKUST,1,1,0,0,0,0
2014-10-02,G,Total,41,50,11880,48394907,19434199,67829106
2014-10-02,LG1,Staff,26,189,264547,333193183,103867678,437060861
2014-10-02,LG1,TPG,244,4561,6638438,1457057418,495965932,1953023350
2014-10-02,LG1,RPG,115,1184,1851743,1053020306,63251985,1116272291
2014-10-02,LG1,UG,713,9542,13812176,22935839963,2396037098,25331877061
2014-10-02,LG1,Alumni,7,122,103358,8512,12566,21078
2014-10-02,LG1,Others(HKUST),8,238,525316,197639960,62647355,260287315
2014-10-02,LG1,Non-HKUST,19,176,228619,11373378,128704354,140077732
2014-10-02,LG1,Total,1132,16012,23424197,25988132720,3250486968,29238619688
2014-10-02,LG3,Staff,33,52,6837,150536349,12140915,162677264
2014-10-02,LG3,TPG,80,149,54224,57231384,48702780,105934164
2014-10-02,LG3,RPG,84,109,46933,186558516,28431842,214990358
2014-10-02,LG3,UG,325,501,189013,1189182358,161427003,1350609361
2014-10-02,LG3,Alumni,14,16,4079,7263306,590382,7853688
2014-10-02,LG3,Others(HKUST),4,60,10882,81482129,6513928,87996057
2014-10-02,LG3,Non-HKUST,8,8,1917,243350,198526,441876
2014-10-02,LG3,Total,548,895,313885,1672497392,258005376,1930502768
2014-10-02,LG4,Staff,15,16,1800,731499,248230,979729
2014-10-02,LG4,TPG,37,59,35668,226849797,100928027,327777824
2014-10-02,LG4,RPG,65,84,27265,40561931,13508051,54069982
2014-10-02,LG4,UG,182,313,109629,569015030,85886321,654901351
2014-10-02,LG4,Alumni,1,1,0,5102,15240,20342
2014-10-02,LG4,Others(HKUST),4,79,147268,33162380963,12556744835,45719125798
2014-10-02,LG4,Non-HKUST,5,5,959,191305,158485,349790
2014-10-02,LG4,Total,309,557,322589,33999735627,12757489189,46757224816
2014-10-02,All-Floors,Staff,69,309,428538,533543085,138639360,672182445
2014-10-02,All-Floors,TPG,263,4781,6731578,1747930961,646717584,2394648545
2014-10-02,All-Floors,RPG,221,1389,1931332,1368807019,112169012,1480976031
2014-10-02,All-Floors,UG,926,10392,14120532,24696094406,2644077942,27340172348
2014-10-02,All-Floors,Alumni,19,139,107437,7276920,618188,7895108
2014-10-02,All-Floors,Others(HKUST),11,426,699511,33442298827,12626637718,46068936545
2014-10-02,All-Floors,Non-HKUST,26,190,231495,11808033,129061365,140869398
2014-10-02,All-Floors,Total,1535,17626,24250423,61807759251,16297921169,78105680420
2014-10-03,1,Staff,58,496,800276,5989726083,1215022686,7204748769
2014-10-03,1,TPG,86,841,1165571,37186202863,14922290706,52108493569
2014-10-03,1,RPG,33,150,321185,4940345565,825549594,5765895159
2014-10-03,1,UG,426,2167,3083131,88131401899,7023228402,95154630301
2014-10-03,1,Alumni,4,11,19663,784766110,34430433,819196543
2014-10-03,1,Others(HKUST),5,91,44659,94807526,25667284,120474810
2014-10-03,1,Non-HKUST,5,12,49810,25848850,16874583,42723433
2014-10-03,1,Total,617,3768,5484295,137153098896,24063063688,161216162584
2014-10-03,G,Staff,114,604,421249,2829245430,146166792,2975412222
2014-10-03,G,TPG,314,1578,1147405,2227990425,714960600,2942951025
2014-10-03,G,RPG,180,654,499262,837459425,156399560,993858985
2014-10-03,G,UG,1396,6089,4145939,18553847650,1037371742,19591219392
2014-10-03,G,Alumni,6,20,27221,0,0,0
2014-10-03,G,Others(HKUST),10,60,58313,512004784,44149867,556154651
2014-10-03,G,Non-HKUST,23,99,144452,24024396,1421783,25446179
2014-10-03,G,Total,2043,9104,6443841,24984572110,2100470344,27085042454
2014-10-03,LG1,Staff,97,481,435758,2337001770,111420694,2448422464
2014-10-03,LG1,TPG,446,3791,4325514,16326215456,2377155129,18703370585
2014-10-03,LG1,RPG,221,1690,2060741,4131881472,3623752331,7755633803
2014-10-03,LG1,UG,2077,15082,15377439,63838065527,11031021286,74869086813
2014-10-03,LG1,Alumni,17,130,144394,2019371,958135,2977506
2014-10-03,LG1,Others(HKUST),19,442,699536,469832460,147425972,617258432
2014-10-03,LG1,Non-HKUST,29,190,157333,2245874692,155367495,2401242187
2014-10-03,LG1,Total,2906,21806,23200715,89350890748,17447101042,106797991790
2014-10-03,LG3,Staff,156,320,186755,1918452391,287315713,2205768104
2014-10-03,LG3,TPG,336,1966,2495138,72009365261,10724257261,82733622522
2014-10-03,LG3,RPG,252,947,812511,21395523080,3186649521,24582172601
2014-10-03,LG3,UG,1545,4424,4317326,107876667977,8469797350,116346465327
2014-10-03,LG3,Alumni,12,42,26216,818917682,1085276449,1904194131
2014-10-03,LG3,Others(HKUST),16,185,79569,312218307,72491409,384709716
2014-10-03,LG3,Non-HKUST,17,67,54240,242588069,34731268,277319337
2014-10-03,LG3,Total,2334,7951,7971755,204573732767,23860518971,228434251738
2014-10-03,LG4,Staff,99,293,282234,20250019433,1783467193,22033486626
2014-10-03,LG4,TPG,314,3256,5008621,97047699408,16701337598,113749037006
2014-10-03,LG4,RPG,188,1104,1324736,27181605168,5549943716,32731548884
2014-10-03,LG4,UG,1241,5980,7355258,164158086391,18718816443,182876902834
2014-10-03,LG4,Alumni,8,54,170974,5544385912,5247276953,10791662865
2014-10-03,LG4,Others(HKUST),11,145,225390,34936476682,5727302327,40663779009
2014-10-03,LG4,Non-HKUST,21,113,167926,404169580,81862944,486032524
2014-10-03,LG4,Total,1882,10945,14535139,349522442574,53810007174,403332449748
2014-10-03,All-Floors,Staff,322,2194,2126272,33324445107,3543393078,36867838185
2014-10-03,All-Floors,TPG,630,11432,14142249,224797473413,45440001294,270237474707
2014-10-03,All-Floors,RPG,503,4545,5018435,58486814710,13342294722,71829109432
2014-10-03,All-Floors,UG,3451,33742,34279093,442558069444,46280235223,488838304667
2014-10-03,All-Floors,Alumni,25,257,388468,7150089075,6367941970,13518031045
2014-10-03,All-Floors,Others(HKUST),28,923,1107467,36325339759,6017036859,42342376618
2014-10-03,All-Floors,Non-HKUST,58,481,573761,2942505587,290258073,3232763660
2014-10-03,All-Floors,Total,5017,53574,57635745,805584737095,121281161219,926865898314
2014-10-04,1,Staff,13,95,201877,1945353124,344298414,2289651538
2014-10-04,1,TPG,85,692,1202103,32474491060,6119465700,38593956760
2014-10-04,1,RPG,24,113,240478,6442706050,2368917047,8811623097
2014-10-04,1,UG,93,781,1336729,29890726912,3603026336,33493753248
2014-10-04,1,Alumni,8,124,268272,14301524168,853634928,15155159096
2014-10-04,1,Others(HKUST),4,78,71009,401290186,27126735,428416921
2014-10-04,1,Non-HKUST,5,13,40659,75528772,7744133,83272905
2014-10-04,1,Total,232,1896,3361127,85531620272,13324213293,98855833565
2014-10-04,G,Staff,45,263,174263,134914486,28154669,163069155
2014-10-04,G,TPG,279,1306,1056375,2758788696,966061848,3724850544
2014-10-04,G,RPG,96,435,453369,837190453,103123634,940314087
2014-10-04,G,UG,337,1669,1540449,9238293256,1206781885,10445075141
2014-10-04,G,Alumni,20,59,43895,639123031,66577261,705700292
2014-10-04,G,Others(HKUST),10,32,20886,3485054,408168,3893222
2014-10-04,G,Non-HKUST,16,107,86662,35057629,7313747,42371376
2014-10-04,G,Total,803,3871,3375899,13646852605,2378421212,16025273817
2014-10-04,LG1,Staff,45,240,323313,759339552,30435006,789774558
2014-10-04,LG1,TPG,467,4948,5838559,12212810443,1912536791,14125347234
2014-10-04,LG1,RPG,170,1416,1552319,10171525998,809163364,10980689362
2014-10-04,LG1,UG,824,9381,12495409,41960834523,3508608979,45469443502
2014-10-04,LG1,Alumni,24,208,229056,434408095,8965341,443373436
2014-10-04,LG1,Others(HKUST),14,245,727677,2617607825,123980100,2741587925
2014-10-04,LG1,Non-HKUST,32,209,236621,484475397,29089399,513564796
2014-10-04,LG1,Total,1576,16647,21402954,68641001833,6422778980,75063780813
2014-10-04,LG3,Staff,48,129,226291,3095194901,531847587,3627042488
2014-10-04,LG3,TPG,298,1431,1720107,43703800637,7622968754,51326769391
2014-10-04,LG3,RPG,152,633,650659,22259643901,4636244742,26895888643
2014-10-04,LG3,UG,503,1564,1543130,55867945820,3668143874,59536089694
2014-10-04,LG3,Alumni,21,95,81464,2773870587,676928862,3450799449
2014-10-04,LG3,Others(HKUST),13,116,38240,2913504439,159216996,3072721435
2014-10-04,LG3,Non-HKUST,23,70,93065,1262125948,98657148,1360783096
2014-10-04,LG3,Total,1058,4038,4352956,131876086233,17394007963,149270094196
2014-10-04,LG4,Staff,31,94,150943,3481475940,176281450,3657757390
2014-10-04,LG4,TPG,223,1650,2480346,50300813532,6389786557,56690600089
2014-10-04,LG4,RPG,109,556,716127,42611865537,6689612930,49301478467
2014-10-04,LG4,UG,399,2392,3421215,98627776026,12210376589,110838152615
2014-10-04,LG4,Alumni,22,157,222432,10614119485,448440196,11062559681
2014-10-04,LG4,Others(HKUST),9,206,422049,64621871516,2101976862,66723848378
2014-10-04,LG4,Non-HKUST,16,131,196747,7143775105,2015454004,9159229109
2014-10-04,LG4,Total,809,5186,7609859,277401697141,30031928588,307433625729
2014-10-04,All-Floors,Staff,118,821,1076687,9416278003,1111017126,10527295129
2014-10-04,All-Floors,TPG,627,10027,12297490,141450704368,23010819650,164461524018
2014-10-04,All-Floors,RPG,321,3153,3612952,82322931939,14607061717,96929993656
2014-10-04,All-Floors,UG,1157,15787,20336932,235585576537,24196937663,259782514200
2014-10-04,All-Floors,Alumni,50,643,845119,28763045366,2054546588,30817591954
2014-10-04,All-Floors,Others(HKUST),20,677,1279861,70557759020,2412708861,72970467881
2014-10-04,All-Floors,Non-HKUST,54,530,653754,9000962851,2158258431,11159221282
2014-10-04,All-Floors,Total,2347,31638,40102795,577097258084,69551350036,646648608120
2014-10-05,1,Staff,18,116,227791,516231068,539238475,1055469543
2014-10-05,1,TPG,73,688,1291258,40143281894,5812000978,45955282872
2014-10-05,1,RPG,31,137,241888,2665368614,421135543,3086504157
2014-10-05,1,UG,121,826,1550922,60053742181,15348740194,75402482375
2014-10-05,1,Alumni,5,52,188306,10653638855,666199178,11319838033
2014-10-05,1,Others(HKUST),2,44,64588,3802207,2459136,6261343
2014-10-05,1,Non-HKUST,11,117,136192,5543499672,371914203,5915413875
2014-10-05,1,Total,261,1980,3700945,119579564491,23161687707,142741252198
2014-10-05,G,Staff,41,214,159972,448948951,37291224,486240175
2014-10-05,G,TPG,250,1539,1289559,2702701468,629059401,3331760869
2014-10-05,G,RPG,106,519,435606,1036844370,1406156246,2443000616
2014-10-05,G,UG,413,2266,2322053,5060814585,6812231354,11873045939
2014-10-05,G,Alumni,27,109,67188,2046857250,165396613,2212253863
2014-10-05,G,Others(HKUST),8,102,116730,4843701,1948406,6792107
2014-10-05,G,Non-HKUST,26,140,101035,126847827,13410717,140258544
2014-10-05,G,Total,871,4889,4492143,11427858152,9065493961,20493352113
2014-10-05,LG1,Staff,41,270,320501,1599798450,143308146,1743106596
2014-10-05,LG1,TPG,426,5538,6410199,18202988984,3258815210,21461804194
2014-10-05,LG1,RPG,186,1995,2551666,3714999879,1376319468,5091319347
2014-10-05,LG1,UG,983,11878,14238207,45395937515,10520851750,55916789265
2014-10-05,LG1,Alumni,40,384,447593,645572618,34873156,680445774
2014-10-05,LG1,Others(HKUST),11,311,782677,117167307,44807988,161975295
2014-10-05,LG1,Non-HKUST,35,191,232838,158076465,21725087,179801552
2014-10-05,LG1,Total,1722,20567,24983681,69834541218,15400700805,85235242023
2014-10-05,LG3,Staff,40,156,119752,4911448951,3032831474,7944280425
2014-10-05,LG3,TPG,284,1846,2273332,89161978770,9070351891,98232330661
2014-10-05,LG3,RPG,172,710,832626,16796327642,3167516734,19963844376
2014-10-05,LG3,UG,614,2599,2355389,88997371495,10865019256,99862390751
2014-10-05,LG3,Alumni,27,82,104560,7266836397,3073011739,10339848136
2014-10-05,LG3,Others(HKUST),9,215,117106,4178421202,2522066024,6700487226
2014-10-05,LG3,Non-HKUST,29,116,108099,2512522060,278436377,2790958437
2014-10-05,LG3,Total,1175,5724,5910864,213824906517,32009233495,245834140012
2014-10-05,LG4,Staff,41,154,211920,4564734333,607185681,5171920014
2014-10-05,LG4,TPG,252,3223,4903541,257106297354,21091257577,278197554931
2014-10-05,LG4,RPG,143,918,1364545,23878818248,23954659317,47833477565
2014-10-05,LG4,UG,481,3579,5271490,101899763100,14559543421,116459306521
2014-10-05,LG4,Alumni,31,399,507984,25978811239,2597790243,28576601482
2014-10-05,LG4,Others(HKUST),8,115,249138,41151451330,1496635555,42648086885
2014-10-05,LG4,Non-HKUST,33,281,547288,24560688113,13942167745,38502855858
2014-10-05,LG4,Total,989,8669,13055906,479140563717,78249239539,557389803256
2014-10-05,All-Floors,Staff,98,910,1039936,12041161753,4359855000,16401016753
2014-10-05,All-Floors,TPG,544,12834,16167889,407317248470,39861485057,447178733527
2014-10-05,All-Floors,RPG,352,4279,5426331,48092358753,30325787308,78418146061
2014-10-05,All-Floors,UG,1320,21148,25738061,301407628876,58106385975,359514014851
2014-10-05,All-Floors,Alumni,63,1026,1315631,46591716359,6537270929,53128987288
2014-10-05,All-Floors,Others(HKUST),15,787,1330239,45455685747,4067917109,49523602856
2014-10-05,All-Floors,Non-HKUST,74,845,1125452,32901634137,14627654129,47529288266
2014-10-05,All-Floors,Total,2466,41829,52143539,893807434095,157886355507,1051693789602
2014-10-06,1,Staff,76,703,1094649,9687032125,1529594436,11216626561
2014-10-06,1,TPG,114,883,1288781,21413371425,2784842662,24198214087
2014-10-06,1,RPG,54,388,494201,7523351674,5955841881,13479193555
2014-10-06,1,UG,698,4581,6520050,154558918154,17467134605,172026052759
2014-10-06,1,Alumni,2,9,9381,8657981,2683034,11341015
2014-10-06,1,Others(HKUST),3,107,90984,23819324,9666477,33485801
2014-10-06,1,Non-HKUST,11,52,82546,17289921718,765373913,18055295631
2014-10-06,1,Total,958,6723,9580592,210505072401,28515137008,239020209409
2014-10-06,G,Staff,135,963,717345,1378174594,694820465,2072995059
2014-10-06,G,TPG,430,3184,2180058,11001506530,1983450152,12984956682
2014-10-06,G,RPG,182,933,628496,3126795731,260698936,3387494667
2014-10-06,G,UG,1838,8921,5288206,16327077279,2375423869,18702501148
2014-10-06,G,Alumni,4,17,951,196181,116219,312400
2014-10-06,G,Others(HKUST),14,77,108184,46930162,11324400,58254562
2014-10-06,G,Non-HKUST,29,207,98743,436250619,146788848,583039467
2014-10-06,G,Total,2632,14302,9021983,32316931096,5472622889,37789553985
2014-10-06,LG1,Staff,148,691,571502,241065086,82898523,323963609
2014-10-06,LG1,TPG,586,5422,5115152,24310868834,5914109182,30224978016
2014-10-06,LG1,RPG,247,2117,2042688,19540162354,749861160,20290023514
2014-10-06,LG1,UG,2825,25601,22831285,86700253880,8993872884,95694126764
2014-10-06,LG1,Alumni,15,83,121570,68617877,5882702,74500579
2014-10-06,LG1,Others(HKUST),16,302,681434,112980253,72603727,185583980
2014-10-06,LG1,Non-HKUST,47,249,249146,20798799,4506475,25305274
2014-10-06,LG1,Total,3884,34465,31612777,130994747083,15823734653,146818481736
2014-10-06,LG3,Staff,216,506,314294,2926888573,244533107,3171421680
2014-10-06,LG3,TPG,447,2847,3097825,72848335215,9856082137,82704417352
2014-10-06,LG3,RPG,330,1207,1182766,28032330250,4086781998,32119112248
2014-10-06,LG3,UG,2266,7503,5833662,127922672311,15023690575,142946362886
2014-10-06,LG3,Alumni,8,38,28167,307453769,36772633,344226402
2014-10-06,LG3,Others(HKUST),16,173,96261,208241459,65010922,273252381
2014-10-06,LG3,Non-HKUST,33,151,170435,2136660171,242045323,2378705494
2014-10-06,LG3,Total,3316,12425,10723410,234382581748,29554916695,263937498443
2014-10-06,LG4,Staff,135,424,312419,4273519354,322848428,4596367782
2014-10-06,LG4,TPG,410,5379,6891877,149333544926,26865270381,176198815307
2014-10-06,LG4,RPG,257,1520,2154668,33366782177,5915163906,39281946083
2014-10-06,LG4,UG,1981,10753,11930482,199496878092,26502774425,225999652517
2014-10-06,LG4,Alumni,9,127,157291,7994989646,425724474,8420714120
2014-10-06,LG4,Others(HKUST),11,251,261214,51960610314,17038888204,68999498518
2014-10-06,LG4,Non-HKUST,29,168,223269,891337422,403003114,1294340536
2014-10-06,LG4,Total,2832,18622,21931220,447317661931,77473672932,524791334863
2014-10-06,All-Floors,Staff,433,3287,3010209,18506679732,2874694959,21381374691
2014-10-06,All-Floors,TPG,805,17715,18573693,278907626930,47403754514,326311381444
2014-10-06,All-Floors,RPG,586,6165,6502819,91589422186,16968347881,108557770067
2014-10-06,All-Floors,UG,4711,57359,52403685,585005799716,70362896358,655368696074
2014-10-06,All-Floors,Alumni,22,274,317360,8379915454,471179062,8851094516
2014-10-06,All-Floors,Others(HKUST),26,910,1238077,52352581512,17197493730,69550075242
2014-10-06,All-Floors,Non-HKUST,91,827,824139,20774968729,1561717673,22336686402
2014-10-06,All-Floors,Total,6674,86537,82869982,1055516994259,156840084177,1212357078436
2014-10-07,1,Staff,82,672,973985,3454238351,1673904169,5128142520
2014-10-07,1,TPG,150,1494,2080878,62660652049,11359200974,74019853023
2014-10-07,1,RPG,53,298,554756,27455630922,2618065834,30073696756
2014-10-07,1,UG,694,4187,5145583,101868742628,17438538354,119307280982
2014-10-07,1,Alumni,1,1,3718,34186299,2977119,37163418
2014-10-07,1,Others(HKUST),5,192,212319,3829829177,390804559,4220633736
2014-10-07,1,Non-HKUST,8,53,44040,15188023545,588219173,15776242718
2014-10-07,1,Total,993,6897,9015279,214491302971,34071710182,248563013153
2014-10-07,G,Staff,121,693,554282,1276462502,194161815,1470624317
2014-10-07,G,TPG,453,2640,1627969,4633088797,1345304014,5978392811
2014-10-07,G,RPG,184,909,658167,2868465917,406938232,3275404149
2014-10-07,G,UG,1793,8293,5219661,17552700568,2584240983,20136941551
2014-10-07,G,Alumni,3,7,484,58597,37795,96392
2014-10-07,G,Others(HKUST),12,120,81135,20800204,6002626,26802830
2014-10-07,G,Non-HKUST,18,65,50632,120284084,18276183,138560267
2014-10-07,G,Total,2584,12727,8192330,26471860669,4554961648,31026822317
2014-10-07,LG1,Staff,116,500,466626,1523365316,1062155634,2585520950
2014-10-07,LG1,TPG,595,4596,4222606,12009702234,4318443820,16328146054
2014-10-07,LG1,RPG,221,1761,1989054,3272668757,779330535,4051999292
2014-10-07,LG1,UG,2874,24201,23336320,56446025020,9746475794,66192500814
2014-10-07,LG1,Alumni,9,122,75648,1254143,630653,1884796
2014-10-07,LG1,Others(HKUST),18,354,695247,172624306,84255981,256880287
2014-10-07,LG1,Non-HKUST,46,200,186852,134858243,553774740,688632983
2014-10-07,LG1,Total,3879,31734,30972353,73560498019,16545067157,90105565176
2014-10-07,LG3,Staff,204,422,253869,2105166207,222669293,2327835500
2014-10-07,LG3,TPG,479,2443,2665588,51379459644,33138611157,84518070801
2014-10-07,LG3,RPG,294,1203,1183025,20102467329,1614385263,21716852592
2014-10-07,LG3,UG,2298,6929,5040460,139147928272,15793281475,154941209747
2014-10-07,LG3,Alumni,7,29,45724,275788704,42681859,318470563
2014-10-07,LG3,Others(HKUST),19,168,113716,983979896,153706408,1137686304
2014-10-07,LG3,Non-HKUST,25,105,118979,4079741033,289455538,4369196571
2014-10-07,LG3,Total,3326,11299,9421361,218074531085,51254790993,269329322078
2014-10-07,LG4,Staff,154,479,369044,4363596622,710101052,5073697674
2014-10-07,LG4,TPG,455,5094,7145122,99093796068,41192309003,140286105071
2014-10-07,LG4,RPG,247,1555,2116728,77529492666,14993008918,92522501584
2014-10-07,LG4,UG,2093,10471,11235653,210713506526,21870000825,232583507351
2014-10-07,LG4,Alumni,4,51,51180,1469549,922754,2392303
2014-10-07,LG4,Others(HKUST),16,251,288416,17370037665,2141458909,19511496574
2014-10-07,LG4,Non-HKUST,28,185,202394,859989094,398968574,1258957668
2014-10-07,LG4,Total,2997,18086,21408537,409931888190,81306770035,491238658225
2014-10-07,All-Floors,Staff,408,2766,2617806,12722828998,3862991963,16585820961
2014-10-07,All-Floors,TPG,877,16267,17742163,229776698792,91353868968,321130567760
2014-10-07,All-Floors,RPG,574,5726,6501730,131228725591,20411728782,151640454373
2014-10-07,All-Floors,UG,4869,54081,49977677,525728903014,67432537431,593161440445
2014-10-07,All-Floors,Alumni,15,210,176754,312757292,47250180,360007472
2014-10-07,All-Floors,Others(HKUST),30,1085,1390833,22377271248,2776228483,25153499731
2014-10-07,All-Floors,Non-HKUST,79,608,602897,20382895999,1848694208,22231590207
2014-10-07,All-Floors,Total,6852,80743,79009860,942530080934,187733300015,1130263380949
2014-10-08,1,Staff,77,640,929564,6115231472,18876863569,24992095041
2014-10-08,1,TPG,129,1122,1865872,49206497148,9878655976,59085153124
2014-10-08,1,RPG,38,244,337424,5018735148,1584572491,6603307639
2014-10-08,1,UG,638,3691,5261336,108323482943,14925682804,123249165747
2014-10-08,1,Alumni,2,35,45595,27049659,20436041,47485700
2014-10-08,1,Others(HKUST),6,153,103478,210735418,44566526,255301944
2014-10-08,1,Non-HKUST,11,50,55915,893892045,103768955,997661000
2014-10-08,1,Total,901,5935,8599184,169795623833,45434546362,215230170195
2014-10-08,G,Staff,115,650,422505,501114127,64934935,566049062
2014-10-08,G,TPG,453,2527,1744833,5754640965,1037504725,6792145690
2014-10-08,G,RPG,165,671,554706,1944537839,299236296,2243774135
2014-10-08,G,UG,1770,7927,5268031,32765275727,3525495981,36290771708
2014-10-08,G,Alumni,11,46,11355,4406044,1201759,5607803
2014-10-08,G,Others(HKUST),15,98,137976,14717525,4612095,19329620
2014-10-08,G,Non-HKUST,33,95,45973,7060962,2833067,9894029
2014-10-08,G,Total,2562,12014,8185379,40991753189,4935818858,45927572047
2014-10-08,LG1,Staff,112,490,425180,704373786,332280198,1036653984
2014-10-08,LG1,TPG,600,5054,4663884,11901583805,2494634123,14396217928
2014-10-08,LG1,RPG,264,1831,1930403,2049698591,393664240,2443362831
2014-10-08,LG1,UG,2766,23400,22712007,84205780921,11271381989,95477162910
2014-10-08,LG1,Alumni,15,119,211024,9117068557,364938245,9482006802
2014-10-08,LG1,Others(HKUST),21,369,640300,924376089,1840114521,2764490610
2014-10-08,LG1,Non-HKUST,53,237,207686,1809909655,75937291,1885846946
2014-10-08,LG1,Total,3831,31500,30790484,110712791404,16772950607,127485742011
2014-10-08,LG3,Staff,170,455,334638,18212701729,5002687240,23215388969
2014-10-08,LG3,TPG,476,2576,2996251,179900720214,16835171710,196735891924
2014-10-08,LG3,RPG,279,967,1126731,15736061698,2372596065,18108657763
2014-10-08,LG3,UG,2144,6328,4967908,109597135923,11270568328,120867704251
2014-10-08,LG3,Alumni,9,37,44549,3771459223,165879626,3937338849
2014-10-08,LG3,Others(HKUST),16,91,59633,67815732,14427758,82243490
2014-10-08,LG3,Non-HKUST,28,108,96866,1593481360,261106922,1854588282
2014-10-08,LG3,Total,3122,10562,9626576,328879375879,35922437649,364801813528
2014-10-08,LG4,Staff,125,431,447588,4370331640,345295156,4715626796
2014-10-08,LG4,TPG,455,4385,5958770,137311317621,32245574299,169556891920
2014-10-08,LG4,RPG,224,1371,1808919,65867285123,3654095029,69521380152
2014-10-08,LG4,UG,2025,9004,9798634,168971646854,35601848190,204573495044
2014-10-08,LG4,Alumni,10,114,152627,9731176514,417025016,10148201530
2014-10-08,LG4,Others(HKUST),14,318,411120,37556149027,33485893396,71042042423
2014-10-08,LG4,Non-HKUST,35,300,318785,3827149737,789903286,4617053023
2014-10-08,LG4,Total,2888,15923,18896443,427635056516,106539634372,534174690888
2014-10-08,All-Floors,Staff,385,2666,2559475,29903752754,24622061098,54525813852
2014-10-08,All-Floors,TPG,893,15664,17229610,384074759753,62491540833,446566300586
2014-10-08,All-Floors,RPG,563,5084,5758183,90616318399,8304164121,98920482520
2014-10-08,All-Floors,UG,4705,50350,48007916,503863322368,76594977292,580458299660
2014-10-08,All-Floors,Alumni,22,351,465150,22651159997,969480687,23620640684
2014-10-08,All-Floors,Others(HKUST),31,1029,1352507,38773793791,35389614296,74163408087
2014-10-08,All-Floors,Non-HKUST,93,790,725225,8131493759,1233549521,9365043280
2014-10-08,All-Floors,Total,6692,75934,76098066,1078014600821,209605387848,1287619988669
2014-10-09,1,Staff,69,633,965713,3859722376,505920067,4365642443
2014-10-09,1,TPG,144,1210,1967937,39902406958,3029283809,42931690767
2014-10-09,1,RPG,57,302,345726,1968748523,265040145,2233788668
2014-10-09,1,UG,719,4161,5506188,124155405819,15638410474,139793816293
2014-10-09,1,Alumni,3,22,33235,18880637,11807425,30688062
2014-10-09,1,Others(HKUST),8,137,92343,182879879,22179436,205059315
2014-10-09,1,Non-HKUST,11,26,34737,35837714,5833248,41670962
2014-10-09,1,Total,1011,6491,8945879,170123881906,19478474604,189602356510
2014-10-09,G,Staff,124,606,495329,1488415459,329957300,1818372759
2014-10-09,G,TPG,458,2361,1699921,4718034251,825542147,5543576398
2014-10-09,G,RPG,193,877,741834,3130851392,198009887,3328861279
2014-10-09,G,UG,1847,8622,5363915,28825989329,4459559996,33285549325
2014-10-09,G,Alumni,9,35,23263,6694966,3887080,10582046
2014-10-09,G,Others(HKUST),17,86,92197,50807490,9152808,59960298
2014-10-09,G,Non-HKUST,28,103,54141,163377133,11682889,175060022
2014-10-09,G,Total,2676,12690,8470600,38384170020,5837792107,44221962127
2014-10-09,LG1,Staff,112,531,584451,1454580144,254110442,1708690586
2014-10-09,LG1,TPG,583,4740,4031818,8768231917,1961752425,10729984342
2014-10-09,LG1,RPG,232,2002,2128229,6429155204,971448208,7400603412
2014-10-09,LG1,UG,2841,23953,23439943,67245934262,7681353821,74927288083
2014-10-09,LG1,Alumni,12,119,127339,142455762,29782813,172238575
2014-10-09,LG1,Others(HKUST),24,300,646262,350399864,47754505,398154369
2014-10-09,LG1,Non-HKUST,50,260,257242,381644614,36430518,418075132
2014-10-09,LG1,Total,3854,31905,31215284,84772401767,10982632732,95755034499
2014-10-09,LG3,Staff,210,452,236701,5170529268,274276120,5444805388
2014-10-09,LG3,TPG,501,2875,3262251,55761230670,8506620209,64267850879
2014-10-09,LG3,RPG,273,900,883314,23543564063,2943110554,26486674617
2014-10-09,LG3,UG,2266,7256,5764757,123507139202,12237290058,135744429260
2014-10-09,LG3,Alumni,5,44,74919,532390549,54670510,587061059
2014-10-09,LG3,Others(HKUST),24,133,53341,61504987,10593971,72098958
2014-10-09,LG3,Non-HKUST,29,87,117662,692704959,249453734,942158693
2014-10-09,LG3,Total,3308,11747,10392945,209269063698,24276015156,233545078854
2014-10-09,LG4,Staff,155,453,362467,1289900036,185343051,1475243087
2014-10-09,LG4,TPG,456,5556,6813467,135712098084,32638026312,168350124396
2014-10-09,LG4,RPG,265,1504,2012097,39822213805,8298287439,48120501244
2014-10-09,LG4,UG,2160,11070,12035117,203045027496,27358735660,230403763156
2014-10-09,LG4,Alumni,8,79,115913,1828809892,234978242,2063788134
2014-10-09,LG4,Others(HKUST),17,252,344926,22126010791,6917718981,29043729772
2014-10-09,LG4,Non-HKUST,31,103,173878,1238040359,194084630,1432124989
2014-10-09,LG4,Total,3092,19017,21857865,405062100463,75827174315,480889274778
2014-10-09,All-Floors,Staff,417,2675,2644661,13263147283,1549606980,14812754263
2014-10-09,All-Floors,TPG,855,16742,17775394,244862001880,46961224902,291823226782
2014-10-09,All-Floors,RPG,587,5585,6111200,74894532987,12675896233,87570429220
2014-10-09,All-Floors,UG,4851,55062,52109920,546779496108,67375350009,614154846117
2014-10-09,All-Floors,Alumni,20,299,374669,2529231806,335126070,2864357876
2014-10-09,All-Floors,Others(HKUST),39,908,1229069,22771603011,7007399701,29779002712
2014-10-09,All-Floors,Non-HKUST,84,579,637660,2511604779,497485019,3009089798
2014-10-09,All-Floors,Total,6853,81850,80882573,907611617854,136402088914,1044013706768
2014-10-10,1,Staff,66,549,796957,4938373706,1242218281,6180591987
2014-10-10,1,TPG,137,1354,2408547,47987651392,23821051266,71808702658
2014-10-10,1,RPG,39,245,402030,7577513381,3494457128,11071970509
2014-10-10,1,UG,608,3574,5033414,133026415284,9701816839,142728232123
2014-10-10,1,Alumni,2,28,12041,19368005,4656744,24024749
2014-10-10,1,Others(HKUST),3,90,48313,26124453,4621390,30745843
2014-10-10,1,Non-HKUST,11,43,84924,110052555,43300264,153352819
2014-10-10,1,Total,866,5883,8786226,193685498776,38312121912,231997620688
2014-10-10,G,Staff,107,663,634992,2808010213,721220254,3529230467
2014-10-10,G,TPG,413,2032,1534730,4748149502,754723513,5502873015
2014-10-10,G,RPG,169,834,878845,1593282445,163100434,1756382879
2014-10-10,G,UG,1692,7597,5212280,25047879679,4036943982,29084823661
2014-10-10,G,Alumni,7,33,2289,161285,115678,276963
2014-10-10,G,Others(HKUST),14,83,139898,897415852,1133162257,2030578109
2014-10-10,G,Non-HKUST,35,94,92277,23005019,4986510,27991529
2014-10-10,G,Total,2437,11336,8495311,35117903995,6814252628,41932156623
2014-10-10,LG1,Staff,107,509,733033,645086667,90439549,735526216
2014-10-10,LG1,TPG,566,4971,4618986,13376533249,3492995577,16869528826
2014-10-10,LG1,RPG,248,1608,1803921,2627156545,692896337,3320052882
2014-10-10,LG1,UG,2706,21731,22705183,50347397379,12636071666,62983469045
2014-10-10,LG1,Alumni,10,86,131873,22823625,2551449,25375074
2014-10-10,LG1,Others(HKUST),18,531,1001708,240931090,86684462,327615552
2014-10-10,LG1,Non-HKUST,54,310,259650,343096609,39852269,382948878
2014-10-10,LG1,Total,3709,29746,31254354,67603025164,17041491309,84644516473
2014-10-10,LG3,Staff,151,344,226644,1201537097,304557393,1506094490
2014-10-10,LG3,TPG,473,2722,3614405,94711871895,68786318064,163498189959
2014-10-10,LG3,RPG,242,791,867022,9049005290,1064926464,10113931754
2014-10-10,LG3,UG,2035,6179,4883867,104370107138,10375500558,114745607696
2014-10-10,LG3,Alumni,9,35,106213,8920098234,382097338,9302195572
2014-10-10,LG3,Others(HKUST),15,120,77986,530897415,129258266,660155681
2014-10-10,LG3,Non-HKUST,34,104,92301,1072797955,278114644,1350912599
2014-10-10,LG3,Total,2959,10295,9868438,219856315024,81320772727,301177087751
2014-10-10,LG4,Staff,114,265,175032,691509389,74000171,765509560
2014-10-10,LG4,TPG,423,4898,7207751,131797694523,23017170743,154814865266
2014-10-10,LG4,RPG,229,1312,1748435,22888596710,8351114053,31239710763
2014-10-10,LG4,UG,1964,10090,11740246,214348755114,20298443520,234647198634
2014-10-10,LG4,Alumni,10,75,116714,381626256,35569666,417195922
2014-10-10,LG4,Others(HKUST),12,224,400448,8149746807,1478776963,9628523770
2014-10-10,LG4,Non-HKUST,36,210,282036,5110836691,845304735,5956141426
2014-10-10,LG4,Total,2788,17074,21670662,383368765490,54100379851,437469145341
2014-10-10,All-Floors,Staff,334,2330,2566658,10284517072,2432435648,12716952720
2014-10-10,All-Floors,TPG,824,15977,19384419,292621900561,119872259163,412494159724
2014-10-10,All-Floors,RPG,542,4790,5700253,43735554371,13766494416,57502048787
2014-10-10,All-Floors,UG,4516,49171,49574990,527140554594,57048776565,584189331159
2014-10-10,All-Floors,Alumni,19,257,369130,9344077405,424990875,9769068280
2014-10-10,All-Floors,Others(HKUST),30,1048,1668353,9845115617,2832503338,12677618955
2014-10-10,All-Floors,Non-HKUST,98,761,811188,6659788829,1211558422,7871347251
2014-10-10,All-Floors,Total,6363,74334,80074991,899631508449,197589018427,1097220526876
2014-10-11,1,Staff,12,94,153645,196347691,27198516,223546207
2014-10-11,1,TPG,95,634,1153195,28807912223,9336544142,38144456365
2014-10-11,1,RPG,31,164,310397,8325934995,3512005439,11837940434
2014-10-11,1,UG,178,1162,1928151,47522187335,5617742946,53139930281
2014-10-11,1,Alumni,7,72,86672,1636192395,874517916,2510710311
2014-10-11,1,Others(HKUST),4,113,32905,5085614,1900696,6986310
2014-10-11,1,Non-HKUST,8,40,58801,707026103,70170906,777197009
2014-10-11,1,Total,335,2279,3723766,87200686356,19440080561,106640766917
2014-10-11,G,Staff,31,113,114261,203828726,12802026,216630752
2014-10-11,G,TPG,310,1310,1178419,7682428550,3558705489,11241134039
2014-10-11,G,RPG,100,378,329732,126747431,40319449,167066880
2014-10-11,G,UG,538,2262,2237624,7257105142,1681293911,8938399053
2014-10-11,G,Alumni,17,89,51525,91725125,13954889,105680014
2014-10-11,G,Others(HKUST),9,119,155191,19160890,6858176,26019066
2014-10-11,G,Non-HKUST,26,90,78312,728182810,190369954,918552764
2014-10-11,G,Total,1031,4361,4145064,16109178674,5504303894,21613482568
2014-10-11,LG1,Staff,33,186,233622,100293359,14660374,114953733
2014-10-11,LG1,TPG,524,6031,7980256,13780440344,9379318949,23159759293
2014-10-11,LG1,RPG,189,1633,2274927,1425105928,867479622,2292585550
2014-10-11,LG1,UG,1186,10622,14363245,67825450975,5413759854,73239210829
2014-10-11,LG1,Alumni,28,211,298041,183238054,14826027,198064081
2014-10-11,LG1,Others(HKUST),13,382,918255,1331364709,133809677,1465174386
2014-10-11,LG1,Non-HKUST,48,279,366481,2027015354,616286844,2643302198
2014-10-11,LG1,Total,2021,19344,26434827,86672908723,16440141347,103113050070
2014-10-11,LG3,Staff,48,134,94516,1079548592,93622486,1173171078
2014-10-11,LG3,TPG,326,1408,1725020,40151877534,3501859441,43653736975
2014-10-11,LG3,RPG,157,454,563539,12126090377,1111163654,13237254031
2014-10-11,LG3,UG,736,2447,2955645,51515419257,6979188836,58494608093
2014-10-11,LG3,Alumni,19,85,94655,916561349,112213432,1028774781
2014-10-11,LG3,Others(HKUST),12,61,14804,247748750,549473935,797222685
2014-10-11,LG3,Non-HKUST,29,79,78407,1252789634,85659690,1338449324
2014-10-11,LG3,Total,1327,4668,5526586,107290035493,12433181474,119723216967
2014-10-11,LG4,Staff,34,87,71405,145827820,27239417,173067237
2014-10-11,LG4,TPG,294,2334,3587991,48873230561,9957576828,58830807389
2014-10-11,LG4,RPG,142,678,937648,15438333663,1971608334,17409941997
2014-10-11,LG4,UG,649,3393,4881479,223515347173,13382087934,236897435107
2014-10-11,LG4,Alumni,26,172,326697,9042892234,1478939819,10521832053
2014-10-11,LG4,Others(HKUST),7,248,417778,6457956144,837003157,7294959301
2014-10-11,LG4,Non-HKUST,26,110,125434,137593435,16919442,154512877
2014-10-11,LG4,Total,1178,7022,10348432,303611181030,27671374931,331282555961
2014-10-11,All-Floors,Staff,110,614,667449,1725846188,175522819,1901369007
2014-10-11,All-Floors,TPG,729,11717,15624881,139295889212,35734004849,175029894061
2014-10-11,All-Floors,RPG,373,3307,4416243,37442212394,7502576498,44944788892
2014-10-11,All-Floors,UG,1799,19886,26366144,397635509882,33074073481,430709583363
2014-10-11,All-Floors,Alumni,51,629,857590,11870609157,2494452083,14365061240
2014-10-11,All-Floors,Others(HKUST),22,923,1538933,8061316107,1529045641,9590361748
2014-10-11,All-Floors,Non-HKUST,79,598,707435,4852607336,979406836,5832014172
2014-10-11,All-Floors,Total,3163,37674,50178675,600883990276,81489082207,682373072483
2014-10-12,1,Staff,14,96,189472,704834853,89990061,794824914
2014-10-12,1,TPG,92,1049,1768792,14457532246,1943297909,16400830155
2014-10-12,1,RPG,28,133,278696,2333084426,289261734,2622346160
2014-10-12,1,UG,159,1275,2252588,65394449119,7720781794,73115230913
2014-10-12,1,Alumni,6,91,179724,5147288980,380508519,5527797499
2014-10-12,1,Others(HKUST),3,110,30588,234930664,524379982,759310646
2014-10-12,1,Non-HKUST,10,26,40345,3536100661,201259913,3737360574
2014-10-12,1,Total,312,2780,4740205,91808220949,11149479912,102957700861
2014-10-12,G,Staff,31,181,78837,722257,2429672,3151929
2014-10-12,G,TPG,276,1490,1281665,6853419470,723081206,7576500676
2014-10-12,G,RPG,121,528,448892,8582953789,363048147,8946001936
2014-10-12,G,UG,566,3195,3134016,16394612802,3018068143,19412680945
2014-10-12,G,Alumni,21,56,37692,10270988,1127875,11398863
2014-10-12,G,Others(HKUST),8,100,106884,12677459,2642409,15319868
2014-10-12,G,Non-HKUST,31,158,189729,28425627,9919817,38345444
2014-10-12,G,Total,1054,5708,5277715,31883082392,4120317269,36003399661
2014-10-12,LG1,Staff,33,164,172635,307338344,15081436,322419780
2014-10-12,LG1,TPG,504,7687,8576812,8289906322,6067187327,14357093649
2014-10-12,LG1,RPG,169,1501,1617633,3687975449,1795211484,5483186933
2014-10-12,LG1,UG,1204,14331,17352097,73406299975,10983216882,84389516857
2014-10-12,LG1,Alumni,25,217,290932,520749963,101754602,622504565
2014-10-12,LG1,Others(HKUST),12,595,1051816,882388287,199176334,1081564621
2014-10-12,LG1,Non-HKUST,43,291,267614,2540108,1916891,4456999
2014-10-12,LG1,Total,1990,24786,29329539,87097198448,19163544956,106260743404
2014-10-12,LG3,Staff,49,173,118749,1449211512,114096890,1563308402
2014-10-12,LG3,TPG,318,1866,2124068,36698017423,8250173264,44948190687
2014-10-12,LG3,RPG,187,723,694428,44050730129,2742954327,46793684456
2014-10-12,LG3,UG,766,3525,3509392,72441410000,12352204887,84793614887
2014-10-12,LG3,Alumni,21,105,154786,3941144259,3413379009,7354523268
2014-10-12,LG3,Others(HKUST),13,103,89976,2909541063,10700964355,13610505418
2014-10-12,LG3,Non-HKUST,36,157,203091,7080139869,2015081061,9095220930
2014-10-12,LG3,Total,1390,6652,6894490,168570194255,39588853793,208159048048
2014-10-12,LG4,Staff,29,107,54245,7370239545,327593348,7697832893
2014-10-12,LG4,TPG,303,4002,5610681,81064657617,40783632214,121848289831
2014-10-12,LG4,RPG,172,1199,1655732,51692719124,10238475707,61931194831
2014-10-12,LG4,UG,753,5646,7403147,150822774720,19266507182,170089281902
2014-10-12,LG4,Alumni,29,402,444216,19551589894,1724430642,21276020536
2014-10-12,LG4,Others(HKUST),9,220,358242,11214659767,2064017174,13278676941
2014-10-12,LG4,Non-HKUST,40,357,368130,15168419660,1330913109,16499332769
2014-10-12,LG4,Total,1335,11933,15894393,336885060327,75735569376,412620629703
2014-10-12,All-Floors,Staff,88,721,613938,9832346511,549191407,10381537918
2014-10-12,All-Floors,TPG,606,16094,19362018,147363533078,57767371920,205130904998
2014-10-12,All-Floors,RPG,365,4084,4695381,110347462917,15428951399,125776414316
2014-10-12,All-Floors,UG,1658,27972,33651240,378459546616,53340778888,431800325504
2014-10-12,All-Floors,Alumni,55,871,1107350,29171044084,5621200647,34792244731
2014-10-12,All-Floors,Others(HKUST),20,1128,1637506,15254197240,13491180254,28745377494
2014-10-12,All-Floors,Non-HKUST,84,989,1068909,25815625925,3559090791,29374716716
2014-10-12,All-Floors,Total,2876,51859,62136342,716243756371,149757765306,866001521677
2014-10-13,1,Staff,71,623,875476,5296614055,1302377403,6598991458
2014-10-13,1,TPG,128,1313,2228016,21419571312,8369597586,29789168898
2014-10-13,1,RPG,41,249,361563,4663152308,711768034,5374920342
2014-10-13,1,UG,767,4689,6485265,117155197546,16778264163,133933461709
2014-10-13,1,Alumni,2,4,8755,390904728,236336884,627241612
2014-10-13,1,Others(HKUST),6,83,47438,482618535,23266209,505884744
2014-10-13,1,Non-HKUST,13,52,95494,976878446,45513072,1022391518
2014-10-13,1,Total,1028,7013,10102007,150384936930,27467123351,177852060281
2014-10-13,G,Staff,132,792,639909,1426312670,174024009,1600336679
2014-10-13,G,TPG,446,2558,2027602,9990643950,1281978537,11272622487
2014-10-13,G,RPG,177,841,639960,3130317856,238522783,3368840639
2014-10-13,G,UG,1974,9861,6348415,23373802329,6067366325,29441168654
2014-10-13,G,Alumni,8,36,12006,378452712,26508810,404961522
2014-10-13,G,Others(HKUST),15,238,217440,572667606,345021840,917689446
2014-10-13,G,Non-HKUST,39,128,84127,295879962,828965908,1124845870
2014-10-13,G,Total,2791,14454,9969459,39168077085,8962388212,48130465297
2014-10-13,LG1,Staff,133,639,422813,3381714323,273125024,3654839347
2014-10-13,LG1,TPG,623,5634,5095073,11721182937,10455204063,22176387000
2014-10-13,LG1,RPG,230,1617,1692649,1187199522,689069625,1876269147
2014-10-13,LG1,UG,2995,27831,25599362,86735048724,37693082128,124428130852
2014-10-13,LG1,Alumni,15,115,114991,1342937,1186553,2529490
2014-10-13,LG1,Others(HKUST),19,379,639704,284904416,115673347,400577763
2014-10-13,LG1,Non-HKUST,70,307,269388,24643941,3244930,27888871
2014-10-13,LG1,Total,4085,36522,33833980,103336036800,49230585670,152566622470
2014-10-13,LG3,Staff,198,498,298908,2601545322,383932845,2985478167
2014-10-13,LG3,TPG,489,2808,2838783,59346600568,14131001657,73477602225
2014-10-13,LG3,RPG,306,983,866445,15862380385,1599579807,17461960192
2014-10-13,LG3,UG,2348,8522,6676096,126804004377,12772361681,139576366058
2014-10-13,LG3,Alumni,11,57,116123,1338253418,118422883,1456676301
2014-10-13,LG3,Others(HKUST),15,94,26891,120421127,96284461,216705588
2014-10-13,LG3,Non-HKUST,45,169,187533,2209224601,404986452,2614211053
2014-10-13,LG3,Total,3412,13131,11010779,208282429798,29506569786,237788999584
2014-10-13,LG4,Staff,163,485,313710,3441650808,292591973,3734242781
2014-10-13,LG4,TPG,500,6846,8486355,116897180690,32276688395,149173869085
2014-10-13,LG4,RPG,269,1834,2479225,33865432983,5221109901,39086542884
2014-10-13,LG4,UG,2285,13748,15041937,223144647048,32805096563,255949743611
2014-10-13,LG4,Alumni,10,104,121303,2363366402,272700506,2636066908
2014-10-13,LG4,Others(HKUST),18,404,576261,19581554858,3422415654,23003970512
2014-10-13,LG4,Non-HKUST,45,411,465384,16890022665,1577120591,18467143256
2014-10-13,LG4,Total,3290,23832,27484175,416183855454,75867723583,492051579037
2014-10-13,All-Floors,Staff,435,3037,2550816,16147837178,2426051254,18573888432
2014-10-13,All-Floors,TPG,877,19159,20675829,219375179457,66514470238,285889649695
2014-10-13,All-Floors,RPG,566,5524,6039842,58708483054,8460050150,67168533204
2014-10-13,All-Floors,UG,4832,64651,60151075,577212700024,106116170860,683328870884
2014-10-13,All-Floors,Alumni,21,316,373178,4472320197,655155636,5127475833
2014-10-13,All-Floors,Others(HKUST),33,1198,1507734,21042166542,4002661511,25044828053
2014-10-13,All-Floors,Non-HKUST,112,1067,1101926,20396649615,2859830953,23256480568
2014-10-13,All-Floors,Total,6876,94952,92400400,917355336067,191034390602,1108389726669
2014-10-14,1,Staff,76,689,1012241,10946736668,1003892186,11950628854
2014-10-14,1,TPG,186,1670,2960290,42554668527,4465306762,47019975289
2014-10-14,1,RPG,46,324,394681,9253916812,1863466113,11117382925
2014-10-14,1,UG,745,4615,6351597,102282292699,15386120294,117668412993
2014-10-14,1,Alumni,2,7,5556,6484642,1273795,7758437
2014-10-14,1,Others(HKUST),5,31,32218,403392754,32856933,436249687
2014-10-14,1,Non-HKUST,7,22,43684,1529718,1438145,2967863
2014-10-14,1,Total,1067,7358,10800267,165449021820,22754354228,188203376048
2014-10-14,G,Staff,113,698,545867,868843857,483445746,1352289603
2014-10-14,G,TPG,475,2427,1675671,1818859357,327546802,2146406159
2014-10-14,G,RPG,190,892,807189,3742348545,328660455,4071009000
2014-10-14,G,UG,2058,9161,6180423,35704571166,5325295831,41029866997
2014-10-14,G,Alumni,3,7,4409,16235,10018,26253
2014-10-14,G,Others(HKUST),15,175,157968,311016064,50067109,361083173
2014-10-14,G,Non-HKUST,24,96,56074,176897129,33132157,210029286
2014-10-14,G,Total,2878,13456,9427601,42622552353,6548158118,49170710471
2014-10-14,LG1,Staff,113,456,297106,750422350,71745817,822168167
2014-10-14,LG1,TPG,628,5444,5043942,10877731547,1247232184,12124963731
2014-10-14,LG1,RPG,231,1585,1768544,5406542113,535085468,5941627581
2014-10-14,LG1,UG,3063,26782,26080544,112842135725,17166002068,130008137793
2014-10-14,LG1,Alumni,7,125,255737,116429526,17443366,133872892
2014-10-14,LG1,Others(HKUST),19,338,714769,170397656,143453840,313851496
2014-10-14,LG1,Non-HKUST,48,237,211788,75544211,68327130,143871341
2014-10-14,LG1,Total,4109,34967,34372430,130239203128,19249289873,149488493001
2014-10-14,LG3,Staff,194,458,317989,8396010971,638422667,9034433638
2014-10-14,LG3,TPG,511,3474,3282047,95686225361,20379373394,116065598755
2014-10-14,LG3,RPG,301,1059,1077541,11482898472,1632911654,13115810126
2014-10-14,LG3,UG,2396,8289,6248376,108816468812,18553467086,127369935898
2014-10-14,LG3,Alumni,4,11,34248,199996290,30450045,230446335
2014-10-14,LG3,Others(HKUST),17,112,97447,252898839,47088348,299987187
2014-10-14,LG3,Non-HKUST,26,78,84724,1548677468,202723746,1751401214
2014-10-14,LG3,Total,3449,13481,11142372,226383176213,41484436940,267867613153
2014-10-14,LG4,Staff,148,443,394723,21691058184,3118466090,24809524274
2014-10-14,LG4,TPG,519,6577,8998792,108796533449,38311395823,147107929272
2014-10-14,LG4,RPG,259,1544,2140626,51269837007,6094699604,57364536611
2014-10-14,LG4,UG,2288,13765,15701852,264309177025,50278680698,314587857723
2014-10-14,LG4,Alumni,4,46,87519,3635929454,328338852,3964268306
2014-10-14,LG4,Others(HKUST),15,269,462347,11255406841,6938011412,18193418253
2014-10-14,LG4,Non-HKUST,37,239,295356,2169432648,159138094,2328570742
2014-10-14,LG4,Total,3270,22883,28081215,463127374608,105228730573,568356105181
2014-10-14,All-Floors,Staff,387,2744,2567926,42653072030,5315972506,47969044536
2014-10-14,All-Floors,TPG,916,19592,21960742,259734018241,64730854965,324464873206
2014-10-14,All-Floors,RPG,577,5404,6188581,81155542949,10454823294,91610366243
2014-10-14,All-Floors,UG,4979,62612,60562792,623954645427,106709565977,730664211404
2014-10-14,All-Floors,Alumni,13,196,387469,3958856147,377516076,4336372223
2014-10-14,All-Floors,Others(HKUST),35,925,1464749,12393112154,7211477642,19604589796
2014-10-14,All-Floors,Non-HKUST,81,672,691626,3972081174,464759272,4436840446
2014-10-14,All-Floors,Total,6988,92145,93823885,1027821328122,195264969732,1223086297854
2014-10-15,1,Staff,69,652,897146,6023166231,899134298,6922300529
2014-10-15,1,TPG,122,1360,1985685,49554577926,5589211827,55143789753
2014-10-15,1,RPG,39,160,263382,1869358422,224972197,2094330619
2014-10-15,1,UG,734,4608,6536422,123384662298,16248499986,139633162284
2014-10-15,1,Alumni,2,29,45359,25569883,16457138,42027021
2014-10-15,1,Others(HKUST),6,41,85572,1154915827,169531151,1324446978
2014-10-15,1,Non-HKUST,8,34,19342,1725873,641584,2367457
2014-10-15,1,Total,980,6884,9832908,182013976460,23148448181,205162424641
2014-10-15,G,Staff,104,613,470007,1070017286,208169548,1278186834
2014-10-15,G,TPG,448,2294,1753251,8283167856,3113839366,11397007222
2014-10-15,G,RPG,185,988,763161,3130907915,373255445,3504163360
2014-10-15,G,UG,1991,9077,6316958,25469290859,3712584977,29181875836
2014-10-15,G,Alumni,7,27,17274,672748,13790691,14463439
2014-10-15,G,Others(HKUST),17,227,176879,312787766,87114004,399901770
2014-10-15,G,Non-HKUST,39,132,126682,61819119,13661122,75480241
2014-10-15,G,Total,2791,13358,9624212,38328663549,7522415153,45851078702
2014-10-15,LG1,Staff,111,509,320732,387241418,31108159,418349577
2014-10-15,LG1,TPG,616,5392,4624058,9759696152,4851681815,14611377967
2014-10-15,LG1,RPG,230,1261,1215395,5927793165,285979051,6213772216
2014-10-15,LG1,UG,3185,28505,28570524,82410948895,10895569451,93306518346
2014-10-15,LG1,Alumni,8,63,59407,18576041,4566161,23142202
2014-10-15,LG1,Others(HKUST),20,399,765798,2118788960,248125446,2366914406
2014-10-15,LG1,Non-HKUST,56,251,225195,3705978,931637,4637615
2014-10-15,LG1,Total,4226,36380,35781109,100626750609,16317961720,116944712329
2014-10-15,LG3,Staff,202,419,214829,2720563144,266590187,2987153331
2014-10-15,LG3,TPG,495,2922,3356895,40555794247,7884941349,48440735596
2014-10-15,LG3,RPG,279,1025,1073769,19686556538,2196770715,21883327253
2014-10-15,LG3,UG,2320,7766,6522196,137052958922,14753239468,151806198390
2014-10-15,LG3,Alumni,8,39,58552,140092609,33479373,173571982
2014-10-15,LG3,Others(HKUST),11,60,33743,252526833,28084821,280611654
2014-10-15,LG3,Non-HKUST,35,112,93585,1603901784,275618132,1879519916
2014-10-15,LG3,Total,3350,12343,11353569,202012394077,25438724045,227451118122
2014-10-15,LG4,Staff,138,478,477827,5473129990,2151501506,7624631496
2014-10-15,LG4,TPG,523,6741,8767231,135225064527,26061619024,161286683551
2014-10-15,LG4,RPG,256,1693,2250218,78120026721,17065570735,95185597456
2014-10-15,LG4,UG,2295,13819,15854095,260224617277,42926999327,303151616604
2014-10-15,LG4,Alumni,10,66,89316,278142567,50941231,329083798
2014-10-15,LG4,Others(HKUST),16,291,470862,8844072045,4885016953,13729088998
2014-10-15,LG4,Non-HKUST,45,339,517507,3401003414,1345996221,4746999635
2014-10-15,LG4,Total,3283,23427,28427056,491566056541,94487644997,586053701538
2014-10-15,All-Floors,Staff,387,2671,2380541,15674118069,3556503698,19230621767
2014-10-15,All-Floors,TPG,877,18709,20487120,243378300708,47501293381,290879594089
2014-10-15,All-Floors,RPG,565,5127,5565925,108734642761,20146548143,128881190904
2014-10-15,All-Floors,UG,4938,63775,63800195,628542478251,88536893209,717079371460
2014-10-15,All-Floors,Alumni,18,224,269908,463053848,119234594,582288442
2014-10-15,All-Floors,Others(HKUST),34,1018,1532854,12683091431,5417872375,18100963806
2014-10-15,All-Floors,Non-HKUST,97,868,982311,5072156168,1636848696,6709004864
2014-10-15,All-Floors,Total,6916,92392,95018854,1014547841236,166915194096,1181463035332
2014-10-16,1,Staff,64,649,905669,13808906707,1598726678,15407633385
2014-10-16,1,TPG,120,1141,1852744,17639100962,3608720829,21247821791
2014-10-16,1,RPG,33,177,244134,3726005671,578914359,4304920030
2014-10-16,1,UG,722,4684,6932542,151469203984,27340487314,178809691298
2014-10-16,1,Alumni,0,0,0,0,0,0
2014-10-16,1,Others(HKUST),2,5,727,8227528,1263877,9491405
2014-10-16,1,Non-HKUST,13,40,66182,1072806118,89265873,1162071991
2014-10-16,1,Total,954,6696,10001998,187724250970,33217378930,220941629900
2014-10-16,G,Staff,115,616,491483,2022955744,172443786,2195399530
2014-10-16,G,TPG,423,2094,1497604,4054899013,398447014,4453346027
2014-10-16,G,RPG,175,888,671025,9405535354,571429949,9976965303
2014-10-16,G,UG,1987,9225,6020913,22513410598,4760898647,27274309245
2014-10-16,G,Alumni,8,22,6462,73406,45037,118443
2014-10-16,G,Others(HKUST),17,109,120128,24372919,8608106,32981025
2014-10-16,G,Non-HKUST,28,85,34767,399148314,29210423,428358737
2014-10-16,G,Total,2753,13039,8842382,38420395348,5941082962,44361478310
2014-10-16,LG1,Staff,110,492,477073,226120570,69954840,296075410
2014-10-16,LG1,TPG,600,5256,4703360,3775918175,720950380,4496868555
2014-10-16,LG1,RPG,202,1211,1311553,3637798068,180528210,3818326278
2014-10-16,LG1,UG,3074,28328,27668808,63901773644,14969414328,78871187972
2014-10-16,LG1,Alumni,10,84,106051,18957443,3157922,22115365
2014-10-16,LG1,Others(HKUST),18,161,522210,124353453,98301919,222655372
2014-10-16,LG1,Non-HKUST,47,186,181196,184473760,14610328,199084088
2014-10-16,LG1,Total,4061,35718,34970251,71869395113,16056917927,87926313040
2014-10-16,LG3,Staff,195,372,173454,2808041592,145445997,2953487589
2014-10-16,LG3,TPG,493,3298,3360292,85010949019,41838569227,126849518246
2014-10-16,LG3,RPG,274,1032,1124526,18256521169,2481981204,20738502373
2014-10-16,LG3,UG,2389,8058,6395402,162818610531,13805643106,176624253637
2014-10-16,LG3,Alumni,8,18,39340,780492393,62094394,842586787
2014-10-16,LG3,Others(HKUST),15,75,62667,158907699,24282398,183190097
2014-10-16,LG3,Non-HKUST,25,94,61307,2303883864,150325465,2454209329
2014-10-16,LG3,Total,3399,12947,11216988,272137406267,58508341791,330645748058
2014-10-16,LG4,Staff,162,636,524682,71972509599,6727966742,78700476341
2014-10-16,LG4,TPG,464,5977,8460206,115363222384,50837647116,166200869500
2014-10-16,LG4,RPG,255,1577,2017797,54419414738,14957432776,69376847514
2014-10-16,LG4,UG,2237,13159,15196492,227569859523,32710853711,260280713234
2014-10-16,LG4,Alumni,15,83,136192,4101212182,288599931,4389812113
2014-10-16,LG4,Others(HKUST),14,258,297379,11161458041,6219089562,17380547603
2014-10-16,LG4,Non-HKUST,34,201,279421,2763663645,345622931,3109286576
2014-10-16,LG4,Total,3181,21891,26912169,487351340112,112087212769,599438552881
2014-10-16,All-Floors,Staff,387,2765,2572361,90838534212,8714538043,99553072255
2014-10-16,All-Floors,TPG,855,17766,19874206,225844089553,97404334566,323248424119
2014-10-16,All-Floors,RPG,548,4885,5369035,89445275000,18770286498,108215561498
2014-10-16,All-Floors,UG,4954,63454,62214157,628272858280,93587297106,721860155386
2014-10-16,All-Floors,Alumni,22,207,288045,4900735424,353897284,5254632708
2014-10-16,All-Floors,Others(HKUST),31,608,1003111,11477319640,6351545862,17828865502
2014-10-16,All-Floors,Non-HKUST,84,606,622873,6723975701,629035020,7353010721
2014-10-16,All-Floors,Total,6881,90291,91943788,1057502787810,225810934379,1283313722189
2014-10-17,1,Staff,67,638,938200,7900951749,960571774,8861523523
2014-10-17,1,TPG,147,1518,2504648,63656301911,5778489175,69434791086
2014-10-17,1,RPG,29,80,113377,1268453505,2332429740,3600883245
2014-10-17,1,UG,639,3598,6056917,107394561197,11548151689,118942712886
2014-10-17,1,Alumni,1,9,48473,115732074,29378296,145110370
2014-10-17,1,Others(HKUST),6,23,38850,163776540,22707827,186484367
2014-10-17,1,Non-HKUST,6,11,34973,363915889,41541071,405456960
2014-10-17,1,Total,895,5877,9735438,180863692865,20713269572,201576962437
2014-10-17,G,Staff,89,440,349426,3981507466,212438732,4193946198
2014-10-17,G,TPG,422,2367,1966719,3491262432,493034388,3984296820
2014-10-17,G,RPG,154,802,707685,6870534972,1034682413,7905217385
2014-10-17,G,UG,1708,8120,5920785,34320697222,5816799373,40137496595
2014-10-17,G,Alumni,5,27,6944,118262948,8686112,126949060
2014-10-17,G,Others(HKUST),14,61,126386,108820169,31013861,139834030
2014-10-17,G,Non-HKUST,33,95,34460,194477172,69015139,263492311
2014-10-17,G,Total,2425,11912,9112405,49085562381,7665670018,56751232399
2014-10-17,LG1,Staff,87,320,203485,291579899,43444674,335024573
2014-10-17,LG1,TPG,579,5194,5216151,7487213783,1145627316,8632841099
2014-10-17,LG1,RPG,202,1244,1253405,2518972689,310439694,2829412383
2014-10-17,LG1,UG,2741,24076,25587629,92828280683,12127652189,104955932872
2014-10-17,LG1,Alumni,8,78,74300,52329943,8584329,60914272
2014-10-17,LG1,Others(HKUST),13,128,490635,106067034,85273414,191340448
2014-10-17,LG1,Non-HKUST,52,149,146100,55033000,6064298,61097298
2014-10-17,LG1,Total,3682,31189,32971705,103339477031,13727085914,117066562945
2014-10-17,LG3,Staff,184,360,158452,2271525501,152476618,2424002119
2014-10-17,LG3,TPG,456,2802,3362693,120534029910,12778507090,133312537000
2014-10-17,LG3,RPG,258,768,722477,12106002466,2121947446,14227949912
2014-10-17,LG3,UG,2000,6812,5772488,140083211742,14129063009,154212274751
2014-10-17,LG3,Alumni,5,14,9835,307035841,33286289,340322130
2014-10-17,LG3,Others(HKUST),12,56,48376,1093968851,46379318,1140348169
2014-10-17,LG3,Non-HKUST,39,192,129404,3545137313,267034938,3812172251
2014-10-17,LG3,Total,2954,11004,10203725,279940911624,29528694708,309469606332
2014-10-17,LG4,Staff,106,258,202458,5145936052,1578017173,6723953225
2014-10-17,LG4,TPG,427,5492,7561935,142319163620,25180843916,167500007536
2014-10-17,LG4,RPG,216,1126,1671726,55440272891,4807419931,60247692822
2014-10-17,LG4,UG,1863,10169,12088179,190091852019,22412401266,212504253285
2014-10-17,LG4,Alumni,8,73,101582,4711528586,335095508,5046624094
2014-10-17,LG4,Others(HKUST),12,142,245420,6816194780,2343184929,9159379709
2014-10-17,LG4,Non-HKUST,53,350,436506,2078256663,277379842,2355636505
2014-10-17,LG4,Total,2685,17610,22307806,406603204611,56934342565,463537547176
2014-10-17,All-Floors,Staff,335,2016,1852021,19591500667,2946948971,22538449638
2014-10-17,All-Floors,TPG,807,17373,20612146,337487971656,45376501885,382864473541
2014-10-17,All-Floors,RPG,514,4020,4468670,78204236523,10606919224,88811155747
2014-10-17,All-Floors,UG,4421,52775,55425998,564718602863,66034067526,630752670389
2014-10-17,All-Floors,Alumni,19,201,241134,5304889392,415030534,5719919926
2014-10-17,All-Floors,Others(HKUST),29,410,949667,8288827374,2528559349,10817386723
2014-10-17,All-Floors,Non-HKUST,103,797,781443,6236820037,661035288,6897855325
2014-10-17,All-Floors,Total,6228,77592,84331079,1019832848512,128569062777,1148401911289
2014-10-18,1,Staff,18,138,259504,6306562504,857830030,7164392534
2014-10-18,1,TPG,108,889,1666738,20369387706,2725691665,23095079371
2014-10-18,1,RPG,34,123,186447,2641855456,169499808,2811355264
2014-10-18,1,UG,238,1462,2404805,52462830034,36485630243,88948460277
2014-10-18,1,Alumni,5,26,50027,58864402,11176598,70041000
2014-10-18,1,Others(HKUST),3,11,91326,92352508,15320174,107672682
2014-10-18,1,Non-HKUST,6,14,30609,57957957,10388626,68346583
2014-10-18,1,Total,412,2663,4689456,81989810567,40275537144,122265347711
2014-10-18,G,Staff,40,162,124404,5011668263,175295406,5186963669
2014-10-18,G,TPG,372,1430,1148505,3130824167,230269207,3361093374
2014-10-18,G,RPG,105,498,484426,525370447,91411049,616781496
2014-10-18,G,UG,790,3092,2745012,19821762327,2131392136,21953154463
2014-10-18,G,Alumni,21,71,48640,11225864,2578388,13804252
2014-10-18,G,Others(HKUST),9,28,132904,219739032,19271177,239010209
2014-10-18,G,Non-HKUST,23,66,55693,204467115,35049144,239516259
2014-10-18,G,Total,1360,5347,4739584,28925057215,2685266507,31610323722
2014-10-18,LG1,Staff,38,161,236845,43484884,11471894,54956778
2014-10-18,LG1,TPG,556,6370,8395944,32400017867,3613372788,36013390655
2014-10-18,LG1,RPG,174,1150,1659210,18583264324,900565952,19483830276
2014-10-18,LG1,UG,1382,13031,18749158,29290715635,3249062771,32539778406
2014-10-18,LG1,Alumni,29,105,71062,118172673,12437127,130609800
2014-10-18,LG1,Others(HKUST),11,163,566875,92049477,73914586,165964063
2014-10-18,LG1,Non-HKUST,45,213,341895,198570278,11512228,210082506
2014-10-18,LG1,Total,2235,21193,30020989,80726275138,7872337346,88598612484
2014-10-18,LG3,Staff,48,84,53662,294980902,42628565,337609467
2014-10-18,LG3,TPG,326,1550,1755720,39459290968,6840755612,46300046580
2014-10-18,LG3,RPG,153,515,577324,6260287101,898540857,7158827958
2014-10-18,LG3,UG,846,2948,3002445,51036208961,8649106425,59685315386
2014-10-18,LG3,Alumni,21,122,164024,11588451914,658579743,12247031657
2014-10-18,LG3,Others(HKUST),8,41,30046,35861085,6343240,42204325
2014-10-18,LG3,Non-HKUST,17,54,77570,1329001327,142632993,1471634320
2014-10-18,LG3,Total,1419,5314,5660791,110004082258,17238587435,127242669693
2014-10-18,LG4,Staff,33,112,98417,5536596689,259303496,5795900185
2014-10-18,LG4,TPG,303,2353,3197250,67260319747,6515427056,73775746803
2014-10-18,LG4,RPG,103,509,707902,17359345477,2474882560,19834228037
2014-10-18,LG4,UG,696,4144,6158106,134103860615,31771812931,165875673546
2014-10-18,LG4,Alumni,28,302,491414,19374474754,1258256118,20632730872
2014-10-18,LG4,Others(HKUST),9,166,356631,26019921861,4439537560,30459459421
2014-10-18,LG4,Non-HKUST,36,200,298987,6892427107,405775461,7298202568
2014-10-18,LG4,Total,1208,7786,11308707,276546946250,47124995182,323671941432
2014-10-18,All-Floors,Staff,109,657,772832,17193293242,1346529391,18539822633
2014-10-18,All-Floors,TPG,739,12592,16164157,162619840455,19925516328,182545356783
2014-10-18,All-Floors,RPG,321,2795,3615309,45370122805,4534900226,49905023031
2014-10-18,All-Floors,UG,2074,24677,33059526,286715377572,82287004506,369002382078
2014-10-18,All-Floors,Alumni,53,626,825167,31151189607,1943027974,33094217581
2014-10-18,All-Floors,Others(HKUST),24,409,1177782,26459923963,4554386737,31014310700
2014-10-18,All-Floors,Non-HKUST,87,547,804754,8682423784,605358452,9287782236
2014-10-18,All-Floors,Total,3407,42303,56419527,578192171428,115196723614,693388895042
2014-10-19,1,Staff,17,122,127346,4176080049,1743649730,5919729779
2014-10-19,1,TPG,104,1010,1730816,30835340044,13289494902,44124834946
2014-10-19,1,RPG,30,133,236346,5176882167,1050203450,6227085617
2014-10-19,1,UG,228,1614,2790010,115927388607,45950364062,161877752669
2014-10-19,1,Alumni,8,75,135983,2969868544,197722499,3167591043
2014-10-19,1,Others(HKUST),3,24,80766,6376495,4894601,11271096
2014-10-19,1,Non-HKUST,3,29,38405,4152830965,208596999,4361427964
2014-10-19,1,Total,393,3007,5139672,163244766871,62444926243,225689693114
2014-10-19,G,Staff,25,92,128206,2636158635,370646572,3006805207
2014-10-19,G,TPG,373,2036,1636519,3060886322,380545915,3441432237
2014-10-19,G,RPG,111,596,596774,1146591567,106141716,1252733283
2014-10-19,G,UG,793,3735,3309950,22737459704,2988524974,25725984678
2014-10-19,G,Alumni,29,125,58622,483902525,40517030,524419555
2014-10-19,G,Others(HKUST),11,54,123593,24467538,7589107,32056645
2014-10-19,G,Non-HKUST,33,116,161218,1237690641,78609240,1316299881
2014-10-19,G,Total,1375,6754,6014882,31327156932,3972574554,35299731486
2014-10-19,LG1,Staff,31,106,72107,1533098622,133129117,1666227739
2014-10-19,LG1,TPG,523,8511,9297985,19973111804,3770345230,23743457034
2014-10-19,LG1,RPG,183,1438,1888514,5224260797,422936096,5647196893
2014-10-19,LG1,UG,1335,16589,19240129,62123954363,6832480670,68956435033
2014-10-19,LG1,Alumni,37,232,255819,154310568,32499130,186809698
2014-10-19,LG1,Others(HKUST),11,165,524344,122630868,85698451,208329319
2014-10-19,LG1,Non-HKUST,34,155,209814,2065945291,78843992,2144789283
2014-10-19,LG1,Total,2154,27196,31488712,91197312313,11355932686,102553244999
2014-10-19,LG3,Staff,35,109,119112,1882947918,190191733,2073139651
2014-10-19,LG3,TPG,356,3006,3729598,75825889413,25041538760,100867428173
2014-10-19,LG3,RPG,176,853,907353,8309039420,5766981071,14076020491
2014-10-19,LG3,UG,839,3437,3269259,84143352248,12739830159,96883182407
2014-10-19,LG3,Alumni,30,182,253519,18804762230,1387504773,20192267003
2014-10-19,LG3,Others(HKUST),10,100,29374,93053932,20357602,113411534
2014-10-19,LG3,Non-HKUST,21,133,164149,12576760673,457723437,13034484110
2014-10-19,LG3,Total,1467,7820,8472364,201635805834,45604127535,247239933369
2014-10-19,LG4,Staff,34,121,200648,1784950290,245942459,2030892749
2014-10-19,LG4,TPG,272,3509,4868655,98669768932,43437890985,142107659917
2014-10-19,LG4,RPG,122,917,1204825,53531301555,5849357064,59380658619
2014-10-19,LG4,UG,734,5913,8177713,159177493159,18982944789,178160437948
2014-10-19,LG4,Alumni,31,386,441972,6538745315,26386181183,32924926498
2014-10-19,LG4,Others(HKUST),10,189,318873,27486729156,5845761995,33332491151
2014-10-19,LG4,Non-HKUST,46,314,447651,9348010835,30500410615,39848421450
2014-10-19,LG4,Total,1249,11349,15660337,356536999242,131248489090,487785488332
2014-10-19,All-Floors,Staff,87,550,647419,12013235514,2683559611,14696795125
2014-10-19,All-Floors,TPG,635,18072,21263573,228364996515,85919815792,314284812307
2014-10-19,All-Floors,RPG,320,3937,4833812,73388075506,13195619397,86583694903
2014-10-19,All-Floors,UG,1830,31288,36787061,444109648081,87494144654,531603792735
2014-10-19,All-Floors,Alumni,61,1000,1145915,28951589182,28044424615,56996013797
2014-10-19,All-Floors,Others(HKUST),19,532,1076950,27733257989,5964301756,33697559745
2014-10-19,All-Floors,Non-HKUST,78,747,1021237,29381238405,31324184283,60705422688
2014-10-19,All-Floors,Total,3030,56126,66775967,843942041192,254626050108,1098568091300
2014-10-20,1,Staff,76,624,759201,7050410587,679283474,7729694061
2014-10-20,1,TPG,137,1601,2290717,88999069129,4019246279,93018315408
2014-10-20,1,RPG,40,261,391650,39764761667,2871142888,42635904555
2014-10-20,1,UG,822,5482,6872550,139088465404,31076750451,170165215855
2014-10-20,1,Alumni,6,46,68487,2058634997,184009632,2242644629
2014-10-20,1,Others(HKUST),8,64,139421,26919624,11165164,38084788
2014-10-20,1,Non-HKUST,12,79,60840,740086934,68471590,808558524
2014-10-20,1,Total,1101,8157,10582866,277728348342,38910069478,316638417820
2014-10-20,G,Staff,129,855,630437,2098548470,224770773,2323319243
2014-10-20,G,TPG,528,3504,2461204,3997773105,793728848,4791501953
2014-10-20,G,RPG,215,946,581789,326859341,50594612,377453953
2014-10-20,G,UG,2675,12371,6613034,37743700407,11358321392,49102021799
2014-10-20,G,Alumni,12,68,14179,275557,99071,374628
2014-10-20,G,Others(HKUST),20,153,137195,539158464,91990890,631149354
2014-10-20,G,Non-HKUST,41,101,85214,156476823,65812347,222289170
2014-10-20,G,Total,3620,17998,10523052,44862792167,12585317933,57448110100
2014-10-20,LG1,Staff,125,597,449692,3319956569,159760118,3479716687
2014-10-20,LG1,TPG,654,7187,6544372,17650576714,3076571649,20727148363
2014-10-20,LG1,RPG,219,1616,1600191,3907172310,508490352,4415662662
2014-10-20,LG1,UG,3251,29473,25796033,65698568319,8082018693,73780587012
2014-10-20,LG1,Alumni,11,78,87599,6935,6186,13121
2014-10-20,LG1,Others(HKUST),16,189,427712,1157601033,156320369,1313921402
2014-10-20,LG1,Non-HKUST,66,317,376941,104060570,10236119,114296689
2014-10-20,LG1,Total,4342,39457,35282540,91837942450,11993403486,103831345936
2014-10-20,LG3,Staff,185,517,284703,7460690900,403716897,7864407797
2014-10-20,LG3,TPG,452,3415,3412946,63796518946,10690039956,74486558902
2014-10-20,LG3,RPG,252,1157,1144010,75899619308,6880156679,82779775987
2014-10-20,LG3,UG,2182,8553,6403617,165065746252,15517219826,180582966078
2014-10-20,LG3,Alumni,6,21,17894,256783994,22459128,279243122
2014-10-20,LG3,Others(HKUST),16,55,48074,1744954495,123455069,1868409564
2014-10-20,LG3,Non-HKUST,36,153,131011,1048630523,578566987,1627197510
2014-10-20,LG3,Total,3129,13871,11442255,315272944418,34215614542,349488558960
2014-10-20,LG4,Staff,134,529,742504,10034548821,1482619435,11517168256
2014-10-20,LG4,TPG,452,6209,8333713,138733872358,17968411045,156702283403
2014-10-20,LG4,RPG,229,1517,1911381,62729586805,10716086184,73445672989
2014-10-20,LG4,UG,2163,15308,15363174,319776716131,39997568687,359774284818
2014-10-20,LG4,Alumni,6,73,127536,11412106890,543447846,11955554736
2014-10-20,LG4,Others(HKUST),21,266,275264,62053715015,11832239495,73885954510
2014-10-20,LG4,Non-HKUST,44,223,311052,6274725233,1761297544,8036022777
2014-10-20,LG4,Total,3049,24125,27064624,611015271253,84301670236,695316941489
2014-10-20,All-Floors,Staff,374,3122,2866537,29964155347,2950150697,32914306044
2014-10-20,All-Floors,TPG,837,21916,23042952,313177810252,36547997777,349725808029
2014-10-20,All-Floors,RPG,497,5497,5629021,182627999431,21026470715,203654470146
2014-10-20,All-Floors,UG,4883,71187,61048408,727373196513,106031879049,833405075562
2014-10-20,All-Floors,Alumni,18,286,315695,13727808373,750021863,14477830236
2014-10-20,All-Floors,Others(HKUST),30,727,1027666,65522348631,12215170987,77737519618
2014-10-20,All-Floors,Non-HKUST,109,873,965058,8323980083,2484384587,10808364670
2014-10-20,All-Floors,Total,6748,103608,94895337,1340717298630,182006075675,1522723374305
2014-10-21,1,Staff,67,618,713009,6340923437,552933293,6893856730
2014-10-21,1,TPG,113,1207,2007357,34121836542,3456546356,37578382898
2014-10-21,1,RPG,51,195,407851,7958453222,1178726233,9137179455
2014-10-21,1,UG,688,4435,6629263,112287790722,16398279111,128686069833
2014-10-21,1,Alumni,1,5,22390,29802416,3411974,33214390
2014-10-21,1,Others(HKUST),6,52,181526,218125863,34380161,252506024
2014-10-21,1,Non-HKUST,15,71,86222,365427363,34885364,400312727
2014-10-21,1,Total,941,6583,10047618,161322359565,21659162492,182981522057
2014-10-21,G,Staff,121,604,524457,1289032535,229868376,1518900911
2014-10-21,G,TPG,521,2685,1854627,14376895536,1138374471,15515270007
2014-10-21,G,RPG,192,790,561525,11874858877,1550148754,13425007631
2014-10-21,G,UG,2457,10559,6778683,32371588901,4598250198,36969839099
2014-10-21,G,Alumni,3,8,802,1075,0,1075
2014-10-21,G,Others(HKUST),16,62,120051,79739292,28678094,108417386
2014-10-21,G,Non-HKUST,29,117,72558,402044108,27078849,429122957
2014-10-21,G,Total,3339,14825,9912703,60394160324,7572398742,67966559066
2014-10-21,LG1,Staff,120,707,522974,1670228786,496604872,2166833658
2014-10-21,LG1,TPG,615,5424,4886521,11972387724,2067073126,14039460850
2014-10-21,LG1,RPG,216,1761,1820001,5142522535,674977323,5817499858
2014-10-21,LG1,UG,3002,26578,25847642,64628026371,13667961481,78295987852
2014-10-21,LG1,Alumni,9,37,5657,59040962,19304451,78345413
2014-10-21,LG1,Others(HKUST),22,136,370073,4932457,3229238,8161695
2014-10-21,LG1,Non-HKUST,44,175,221114,266321150,51627024,317948174
2014-10-21,LG1,Total,4028,34818,33673982,83743459985,16980777515,100724237500
2014-10-21,LG3,Staff,161,487,334374,7984183915,1031160847,9015344762
2014-10-21,LG3,TPG,428,3012,3411083,62819851976,11736901106,74556753082
2014-10-21,LG3,RPG,243,999,1095096,20240395805,9714689886,29955085691
2014-10-21,LG3,UG,2042,7438,6574364,158944991608,14407028614,173352020222
2014-10-21,LG3,Alumni,9,48,41877,451514019,63351023,514865042
2014-10-21,LG3,Others(HKUST),11,29,5509,6129022,1764087,7893109
2014-10-21,LG3,Non-HKUST,29,102,112063,399007132,158764433,557771565
2014-10-21,LG3,Total,2923,12115,11574366,250846073477,37113659996,287959733473
2014-10-21,LG4,Staff,114,374,398774,10680186540,1509412537,12189599077
2014-10-21,LG4,TPG,478,7020,9132645,117590465855,21357360680,138947826535
2014-10-21,LG4,RPG,194,1496,2043309,34281407889,6403671994,40685079883
2014-10-21,LG4,UG,1973,12216,14403683,323808283243,34116633369,357924916612
2014-10-21,LG4,Alumni,8,114,89840,9532197261,478030262,10010227523
2014-10-21,LG4,Others(HKUST),15,260,312583,14563297936,2833540282,17396838218
2014-10-21,LG4,Non-HKUST,39,188,309854,3223222702,312998676,3536221378
2014-10-21,LG4,Total,2821,21668,26690688,513679061426,67011647800,580690709226
2014-10-21,All-Floors,Staff,348,2790,2493588,27964555213,3819979925,31784535138
2014-10-21,All-Floors,TPG,837,19348,21292233,240881437633,39756255739,280637693372
2014-10-21,All-Floors,RPG,476,5241,5927782,79497638328,19522214190,99019852518
2014-10-21,All-Floors,UG,4736,61226,60233635,692040680845,83188152773,775228833618
2014-10-21,All-Floors,Alumni,15,212,160566,10072555733,564097710,10636653443
2014-10-21,All-Floors,Others(HKUST),32,539,989742,14872224570,2901591862,17773816432
2014-10-21,All-Floors,Non-HKUST,95,653,801811,4656022455,585354346,5241376801
2014-10-21,All-Floors,Total,6539,90009,91899357,1069985114777,150337646545,1220322761322
2014-10-22,1,Staff,68,570,807634,7460766562,585230460,8045997022
2014-10-22,1,TPG,105,1159,2052458,20639940333,9272305769,29912246102
2014-10-22,1,RPG,32,168,320445,3406128704,1152925658,4559054362
2014-10-22,1,UG,650,3870,6264299,111678403181,15320508493,126998911674
2014-10-22,1,Alumni,3,21,33416,165516014,21504062,187020076
2014-10-22,1,Others(HKUST),2,39,195804,5169229914,93438819,5262668733
2014-10-22,1,Non-HKUST,10,33,58499,303078684,38850882,341929566
2014-10-22,1,Total,870,5860,9732555,148823063392,26484764143,175307827535
2014-10-22,G,Staff,117,512,460382,987132218,172810294,1159942512
2014-10-22,G,TPG,475,2486,2040089,4407973761,474652670,4882626431
2014-10-22,G,RPG,180,731,613987,1557879185,143894226,1701773411
2014-10-22,G,UG,2144,8799,6378475,18381680716,2742851064,21124531780
2014-10-22,G,Alumni,7,33,13170,490490,55334,545824
2014-10-22,G,Others(HKUST),12,43,106665,24231904,13543736,37775640
2014-10-22,G,Non-HKUST,33,98,89627,8168748025,4139801138,12308549163
2014-10-22,G,Total,2968,12702,9702395,33528136299,7687608462,41215744761
2014-10-22,LG1,Staff,83,347,379974,555421408,657459992,1212881400
2014-10-22,LG1,TPG,573,4507,4673688,27413214040,1722328166,29135542206
2014-10-22,LG1,RPG,199,1265,1583761,11425346309,816616878,12241963187
2014-10-22,LG1,UG,2798,23381,25596044,70451157454,8391528267,78842685721
2014-10-22,LG1,Alumni,13,70,96014,170733263,38064337,208797600
2014-10-22,LG1,Others(HKUST),13,126,384169,154049415,42900081,196949496
2014-10-22,LG1,Non-HKUST,39,125,166343,566930557,29190864,596121421
2014-10-22,LG1,Total,3718,29821,32879993,110736852446,11698088585,122434941031
2014-10-22,LG3,Staff,116,307,268298,32010422545,1209553908,33219976453
2014-10-22,LG3,TPG,378,2641,3568057,74066611356,9505547422,83572158778
2014-10-22,LG3,RPG,218,927,1198808,12449703762,1507366872,13957070634
2014-10-22,LG3,UG,1539,5480,5438617,127895167254,13557835000,141453002254
2014-10-22,LG3,Alumni,10,43,51958,566357819,97743010,664100829
2014-10-22,LG3,Others(HKUST),9,19,16427,27418549,10231522,37650071
2014-10-22,LG3,Non-HKUST,21,80,132209,1293756593,147638770,1441395363
2014-10-22,LG3,Total,2291,9497,10674374,248309437878,26035916504,274345354382
2014-10-22,LG4,Staff,76,271,286656,5296642500,266723258,5563365758
2014-10-22,LG4,TPG,451,5632,8585963,134692473429,35493774285,170186247714
2014-10-22,LG4,RPG,182,1285,2016868,23503955418,8332843256,31836798674
2014-10-22,LG4,UG,1740,11715,14624239,232199499700,30551967552,262751467252
2014-10-22,LG4,Alumni,9,165,130111,733718490,169979618,903698108
2014-10-22,LG4,Others(HKUST),11,144,181895,5516208407,1239520518,6755728925
2014-10-22,LG4,Non-HKUST,32,165,265694,1772910767,126888060,1899798827
2014-10-22,LG4,Total,2501,19377,26091426,403715408711,76181696547,479897105258
2014-10-22,All-Floors,Staff,287,2007,2202944,46310385233,2891777912,49202163145
2014-10-22,All-Floors,TPG,831,16425,20920255,261220212919,56468608312,317688821231
2014-10-22,All-Floors,RPG,451,4376,5733869,52343013378,11953646890,64296660268
2014-10-22,All-Floors,UG,4505,53245,58301674,560605908305,70564690376,631170598681
2014-10-22,All-Floors,Alumni,23,332,324669,1636816076,327346361,1964162437
2014-10-22,All-Floors,Others(HKUST),24,371,884960,10891138189,1399634676,12290772865
2014-10-22,All-Floors,Non-HKUST,83,501,712372,12105424626,4482369714,16587794340
2014-10-22,All-Floors,Total,6204,77257,89080743,945112898726,148088074241,1093200972967
2014-10-23,1,Staff,60,539,636006,14900677735,1399915723,16300593458
2014-10-23,1,TPG,82,472,477510,10947172754,1090483559,12037656313
2014-10-23,1,RPG,20,69,67054,1549426655,2800403231,4349829886
2014-10-23,1,UG,552,2643,3838062,90573222293,8554293265,99127515558
2014-10-23,1,Alumni,2,23,12746,2811155617,141630086,2952785703
2014-10-23,1,Others(HKUST),1,42,151909,1352397584,48183912,1400581496
2014-10-23,1,Non-HKUST,7,24,53019,253616561,57502790,311119351
2014-10-23,1,Total,724,3812,5236306,122387669199,14092412566,136480081765
2014-10-23,G,Staff,113,621,533257,769597698,140760932,910358630
2014-10-23,G,TPG,452,2198,1493998,12480339626,2327502916,14807842542
2014-10-23,G,RPG,177,700,443128,11688743375,1024064698,12712808073
2014-10-23,G,UG,2222,9191,6295818,28213919968,3183841852,31397761820
2014-10-23,G,Alumni,3,4,0,0,0,0
2014-10-23,G,Others(HKUST),13,64,168707,11965098,6853419,18818517
2014-10-23,G,Non-HKUST,28,120,106124,257678645,88834991,346513636
2014-10-23,G,Total,3008,12898,9041032,53422244410,6771858808,60194103218
2014-10-23,LG1,Staff,99,413,310269,251423407,132697997,384121404
2014-10-23,LG1,TPG,533,4647,4533982,9196608019,5940650010,15137258029
2014-10-23,LG1,RPG,185,1577,1562590,5237660597,318215773,5555876370
2014-10-23,LG1,UG,2778,24644,25245953,79591747898,8185645763,87777393661
2014-10-23,LG1,Alumni,4,26,30521,88526930,11642124,100169054
2014-10-23,LG1,Others(HKUST),18,214,417780,438836649,15498129,454334778
2014-10-23,LG1,Non-HKUST,43,243,197754,583617221,96516152,680133373
2014-10-23,LG1,Total,3660,31764,32298849,95388420721,14700865948,110089286669
2014-10-23,LG3,Staff,131,290,249304,6243396881,477195987,6720592868
2014-10-23,LG3,TPG,392,2446,3246042,53102334787,6497398685,59599733472
2014-10-23,LG3,RPG,220,899,1091924,14460141918,1693190164,16153332082
2014-10-23,LG3,UG,1721,6696,6263415,159077158795,18767426089,177844584884
2014-10-23,LG3,Alumni,2,3,0,1001877,255562,1257439
2014-10-23,LG3,Others(HKUST),10,44,45556,52590981,6692878,59283859
2014-10-23,LG3,Non-HKUST,20,71,107448,5714909988,270975220,5985885208
2014-10-23,LG3,Total,2496,10449,11003689,238651535227,27713134585,266364669812
2014-10-23,LG4,Staff,87,324,265441,1151381866,270382914,1421764780
2014-10-23,LG4,TPG,398,5333,7240240,137643684002,31798540322,169442224324
2014-10-23,LG4,RPG,169,1404,2125534,36559807347,5906138726,42465946073
2014-10-23,LG4,UG,1755,12545,16036207,304485268868,89154057702,393639326570
2014-10-23,LG4,Alumni,6,114,114201,4738313344,310544129,5048857473
2014-10-23,LG4,Others(HKUST),9,182,280077,14742606298,4234345282,18976951580
2014-10-23,LG4,Non-HKUST,23,158,236843,2716396546,419057455,3135454001
2014-10-23,LG4,Total,2447,20060,26298543,502037458271,132093066530,634130524801
2014-10-23,All-Floors,Staff,294,2187,1994277,23316477587,2420953553,25737431140
2014-10-23,All-Floors,TPG,752,15096,16991772,223370139188,47654575492,271024714680
2014-10-23,All-Floors,RPG,424,4649,5290230,69495779892,11742012592,81237792484
2014-10-23,All-Floors,UG,4408,55719,57679455,661941317822,127845264671,789786582493
2014-10-23,All-Floors,Alumni,10,170,157468,7638997768,464071901,8103069669
2014-10-23,All-Floors,Others(HKUST),25,546,1064029,16598396610,4311573620,20909970230
2014-10-23,All-Floors,Non-HKUST,75,616,701188,9526218961,932886608,10459105569
2014-10-23,All-Floors,Total,5988,78983,83878419,1011887327828,195371338437,1207258666265
2014-10-24,1,Staff,58,502,689960,10106184748,497022306,10603207054
2014-10-24,1,TPG,56,360,566764,8616124991,1678403670,10294528661
2014-10-24,1,RPG,20,48,56287,887922389,171767042,1059689431
2014-10-24,1,UG,437,2005,2912057,60124208774,8748327858,68872536632
2014-10-24,1,Alumni,4,41,80671,60756203,18180872,78937075
2014-10-24,1,Others(HKUST),3,46,93486,811358378,30485813,841844191
2014-10-24,1,Non-HKUST,4,21,33126,15378240,19244574,34622814
2014-10-24,1,Total,582,3023,4432351,80621933723,11163432135,91785365858
2014-10-24,G,Staff,109,585,507814,2854423682,238527928,3092951610
2014-10-24,G,TPG,399,1678,1438292,1817938242,230775429,2048713671
2014-10-24,G,RPG,159,566,355854,554384750,68544310,622929060
2014-10-24,G,UG,1905,8180,6103697,26956874438,3571047724,30527922162
2014-10-24,G,Alumni,7,20,5122,459532959,15629392,475162351
2014-10-24,G,Others(HKUST),8,54,121330,1017946434,555184056,1573130490
2014-10-24,G,Non-HKUST,23,56,59442,41941431,6238272,48179703
2014-10-24,G,Total,2610,11139,8591551,33703041936,4685947111,38388989047
2014-10-24,LG1,Staff,99,416,300727,548884351,86648529,635532880
2014-10-24,LG1,TPG,508,5061,4998893,3590755000,433543040,4024298040
2014-10-24,LG1,RPG,187,1298,1350722,1711686651,1235280511,2946967162
2014-10-24,LG1,UG,2584,21721,23547324,68967951849,5550016760,74517968609
2014-10-24,LG1,Alumni,12,91,99674,134144074,20727662,154871736
2014-10-24,LG1,Others(HKUST),14,105,389253,1047778887,49284915,1097063802
2014-10-24,LG1,Non-HKUST,39,207,218634,26879840,8910047,35789887
2014-10-24,LG1,Total,3443,28899,30905227,76028080652,7384411464,83412492116
2014-10-24,LG3,Staff,119,341,430036,12179224196,23872143480,36051367676
2014-10-24,LG3,TPG,344,2154,3137023,50955302232,12621693144,63576995376
2014-10-24,LG3,RPG,197,778,1034657,10875007335,1396329145,12271336480
2014-10-24,LG3,UG,1554,5876,5523847,95680183449,11163568030,106843751479
2014-10-24,LG3,Alumni,6,9,7317,58674670,3129778,61804448
2014-10-24,LG3,Others(HKUST),11,21,28656,48615208,2454794,51070002
2014-10-24,LG3,Non-HKUST,19,105,120685,2755440688,140082726,2895523414
2014-10-24,LG3,Total,2250,9284,10282221,172552447778,49199401097,221751848875
2014-10-24,LG4,Staff,82,291,306309,8094987403,379793800,8474781203
2014-10-24,LG4,TPG,380,5511,7941603,175958884955,72935033122,248893918077
2014-10-24,LG4,RPG,143,1194,1673089,60213014785,4666020237,64879035022
2014-10-24,LG4,UG,1461,10212,13444494,250571608564,20966690579,271538299143
2014-10-24,LG4,Alumni,8,100,114699,4708676647,288786125,4997462772
2014-10-24,LG4,Others(HKUST),8,175,232563,8520501676,2189971581,10710473257
2014-10-24,LG4,Non-HKUST,17,71,120535,930692369,370337449,1301029818
2014-10-24,LG4,Total,2099,17554,23833292,508998366399,101796632893,610794999292
2014-10-24,All-Floors,Staff,284,2135,2234846,33783704380,25074136043,58857840423
2014-10-24,All-Floors,TPG,703,14764,18082575,240939005420,87899448405,328838453825
2014-10-24,All-Floors,RPG,411,3884,4470609,74242015910,7537941245,81779957155
2014-10-24,All-Floors,UG,4021,47994,51531419,502300827074,49999650951,552300478025
2014-10-24,All-Floors,Alumni,22,261,307483,5421784553,346453829,5768238382
2014-10-24,All-Floors,Others(HKUST),28,401,865288,11446200583,2827381159,14273581742
2014-10-24,All-Floors,Non-HKUST,66,460,552422,3770332568,544813068,4315145636
2014-10-24,All-Floors,Total,5535,69899,78044642,871903870488,174229824700,1046133695188
2014-10-25,1,Staff,7,147,54726,2158919658,68172066,2227091724
2014-10-25,1,TPG,28,99,181702,2231103847,179993978,2411097825
2014-10-25,1,RPG,20,28,37960,2420127772,317214494,2737342266
2014-10-25,1,UG,145,686,1190491,23446686725,4962341030,28409027755
2014-10-25,1,Alumni,4,28,50781,1233813967,68122076,1301936043
2014-10-25,1,Others(HKUST),2,28,95873,1292434170,35042230,1327476400
2014-10-25,1,Non-HKUST,3,3,120,835516,229706,1065222
2014-10-25,1,Total,209,1019,1611653,32783921655,5631115580,38415037235
2014-10-25,G,Staff,33,122,131113,26549921,81329234,107879155
2014-10-25,G,TPG,287,1210,1161644,9422647100,1357330689,10779977789
2014-10-25,G,RPG,100,474,396271,1999097364,124829040,2123926404
2014-10-25,G,UG,772,3023,3106897,7087745564,410261679,7498007243
2014-10-25,G,Alumni,13,43,28725,133071670,6620936,139692606
2014-10-25,G,Others(HKUST),7,23,127956,71892284,10942898,82835182
2014-10-25,G,Non-HKUST,23,121,100839,722199865,34437300,756637165
2014-10-25,G,Total,1235,5016,5053445,19463203768,2025751776,21488955544
2014-10-25,LG1,Staff,36,173,239106,4272982,2062239,6335221
2014-10-25,LG1,TPG,441,4724,5904484,5281229552,1422370468,6703600020
2014-10-25,LG1,RPG,137,1124,1469120,3555228544,230361114,3785589658
2014-10-25,LG1,UG,1477,14761,20565711,34515237904,2511847641,37027085545
2014-10-25,LG1,Alumni,20,73,102529,8075037,2489224,10564261
2014-10-25,LG1,Others(HKUST),9,117,484795,333025280,55439568,388464848
2014-10-25,LG1,Non-HKUST,37,148,247670,293862375,103749373,397611748
2014-10-25,LG1,Total,2157,21120,29013415,43990931674,4328319627,48319251301
2014-10-25,LG3,Staff,38,107,148173,2605667834,520259669,3125927503
2014-10-25,LG3,TPG,227,1087,1451780,37534242425,3973590307,41507832732
2014-10-25,LG3,RPG,128,449,600077,25003965252,4784111958,29788077210
2014-10-25,LG3,UG,637,2550,3066577,86007157608,9036279139,95043436747
2014-10-25,LG3,Alumni,9,51,65857,12006966679,963590146,12970556825
2014-10-25,LG3,Others(HKUST),6,9,967,55872931,10540610,66413541
2014-10-25,LG3,Non-HKUST,23,109,133990,2960664228,227193652,3187857880
2014-10-25,LG3,Total,1068,4362,5467421,166174536957,19515565481,185690102438
2014-10-25,LG4,Staff,33,133,206239,3016233369,355880789,3372114158
2014-10-25,LG4,TPG,206,1608,2703611,58977309688,21975738114,80953047802
2014-10-25,LG4,RPG,95,610,855986,8831000622,1937255982,10768256604
2014-10-25,LG4,UG,575,4013,6907467,123761097500,13924124932,137685222432
2014-10-25,LG4,Alumni,18,194,283316,10309820953,4225602584,14535423537
2014-10-25,LG4,Others(HKUST),7,211,414274,129451986342,21380459557,150832445899
2014-10-25,LG4,Non-HKUST,23,123,227892,1182459423,110526598,1292986021
2014-10-25,LG4,Total,957,6892,11598785,335529907897,63909588556,399439496453
2014-10-25,All-Floors,Staff,98,682,779357,7811643764,1027703997,8839347761
2014-10-25,All-Floors,TPG,600,8728,11403221,113446532612,28909023556,142355556168
2014-10-25,All-Floors,RPG,284,2685,3359414,41809419554,7393772588,49203192142
2014-10-25,All-Floors,UG,2066,25033,34837143,274817925301,30844854421,305662779722
2014-10-25,All-Floors,Alumni,37,389,531208,23691748306,5266424966,28958173272
2014-10-25,All-Floors,Others(HKUST),19,388,1123865,131205211007,21492424863,152697635870
2014-10-25,All-Floors,Non-HKUST,67,504,710511,5160021407,476136629,5636158036
2014-10-25,All-Floors,Total,3171,38409,52744719,597942501951,95410341020,693352842971
2014-10-26,1,Staff,9,200,98152,807085207,90220743,897305950
2014-10-26,1,TPG,35,165,300549,5185190578,2041520589,7226711167
2014-10-26,1,RPG,19,88,94282,1025095214,166050639,1191145853
2014-10-26,1,UG,88,718,1345552,25809035800,6965132871,32774168671
2014-10-26,1,Alumni,4,31,59882,1389677673,112205135,1501882808
2014-10-26,1,Others(HKUST),4,43,138830,3873513761,100855244,3974369005
2014-10-26,1,Non-HKUST,3,7,15117,631600944,35533805,667134749
2014-10-26,1,Total,162,1252,2052364,38721199177,9511519026,48232718203
2014-10-26,G,Staff,30,141,118948,96610650,220762733,317373383
2014-10-26,G,TPG,252,1555,1573007,7157912880,844975974,8002888854
2014-10-26,G,RPG,115,484,490259,2103150857,198620925,2301771782
2014-10-26,G,UG,546,2919,2924936,8323888766,10378165503,18702054269
2014-10-26,G,Alumni,25,81,32164,644844,309554,954398
2014-10-26,G,Others(HKUST),8,39,143745,903055261,76433881,979489142
2014-10-26,G,Non-HKUST,20,82,118735,8823757,6496586,15320343
2014-10-26,G,Total,996,5301,5401794,18594087015,11725765156,30319852171
2014-10-26,LG1,Staff,34,173,170904,584382168,36200799,620582967
2014-10-26,LG1,TPG,359,5891,6715572,29913217178,3063812710,32977029888
2014-10-26,LG1,RPG,156,1870,2458048,10945569131,1317217516,12262786647
2014-10-26,LG1,UG,1183,14386,17109612,43605175976,6749796467,50354972443
2014-10-26,LG1,Alumni,29,184,186673,466195861,51639844,517835705
2014-10-26,LG1,Others(HKUST),13,135,490594,79745929,32887819,112633748
2014-10-26,LG1,Non-HKUST,37,223,326760,1317328776,452694857,1770023633
2014-10-26,LG1,Total,1811,22862,27458163,86911615019,11704250012,98615865031
2014-10-26,LG3,Staff,30,144,154249,2684862421,292552950,2977415371
2014-10-26,LG3,TPG,245,1797,2282144,55531411706,11470705425,67002117131
2014-10-26,LG3,RPG,131,627,788178,10919563648,1840055709,12759619357
2014-10-26,LG3,UG,629,2325,2481423,59148244565,9588666182,68736910747
2014-10-26,LG3,Alumni,27,224,179385,15609773337,924256574,16534029911
2014-10-26,LG3,Others(HKUST),9,37,34714,47050748,3031100,50081848
2014-10-26,LG3,Non-HKUST,23,158,194148,4091417744,184101957,4275519701
2014-10-26,LG3,Total,1094,5312,6114241,148032324169,24303369897,172335694066
2014-10-26,LG4,Staff,30,128,178582,2312327875,222329553,2534657428
2014-10-26,LG4,TPG,192,2762,3887259,106079696447,13610439639,119690136086
2014-10-26,LG4,RPG,106,866,1034366,20091714508,3766449143,23858163651
2014-10-26,LG4,UG,462,3551,5071344,79980077176,15281016758,95261093934
2014-10-26,LG4,Alumni,39,474,662539,33773428267,3490541794,37263970061
2014-10-26,LG4,Others(HKUST),5,164,255891,329800217817,56988647394,386788865211
2014-10-26,LG4,Non-HKUST,34,221,269589,8188181884,5963357669,14151539553
2014-10-26,LG4,Total,868,8166,11359570,580225643974,99322781950,679548425924
2014-10-26,All-Floors,Staff,83,786,720835,6485268321,862066778,7347335099
2014-10-26,All-Floors,TPG,482,12170,14758531,203867428789,31031454337,234898883126
2014-10-26,All-Floors,RPG,288,3935,4865133,45085093358,7288393932,52373487290
2014-10-26,All-Floors,UG,1635,23899,28932867,216866422283,48962777781,265829200064
2014-10-26,All-Floors,Alumni,62,994,1120643,51239719982,4578952901,55818672883
2014-10-26,All-Floors,Others(HKUST),18,418,1063774,334703583516,57201855438,391905438954
2014-10-26,All-Floors,Non-HKUST,75,691,924349,14237353105,6642184874,20879537979
2014-10-26,All-Floors,Total,2643,42893,52386132,872484869354,156567686041,1029052555395
2014-10-27,1,Staff,67,691,803076,11190835070,2666530274,13857365344
2014-10-27,1,TPG,35,182,200051,13638491328,1184204451,14822695779
2014-10-27,1,RPG,29,55,106092,1175223560,24589619,1199813179
2014-10-27,1,UG,401,1634,2172969,30786797995,5400481001,36187278996
2014-10-27,1,Alumni,4,10,10427,305207999,24175180,329383179
2014-10-27,1,Others(HKUST),4,68,108395,1322942442,41462108,1364404550
2014-10-27,1,Non-HKUST,4,27,35143,44581937,11315798,55897735
2014-10-27,1,Total,544,2667,3436153,58464080331,9352758431,67816838762
2014-10-27,G,Staff,126,607,440932,479360152,166903263,646263415
2014-10-27,G,TPG,420,2350,1874982,10883289342,1532877948,12416167290
2014-10-27,G,RPG,179,684,553960,1426814866,66210403,1493025269
2014-10-27,G,UG,2228,10055,6679888,24567526603,5110271043,29677797646
2014-10-27,G,Alumni,8,41,16421,35714,41359,77073
2014-10-27,G,Others(HKUST),12,111,146206,299866074,27496653,327362727
2014-10-27,G,Non-HKUST,36,82,35273,491531787,26026908,517558695
2014-10-27,G,Total,3009,13930,9747662,38148424538,6929827577,45078252115
2014-10-27,LG1,Staff,107,588,436210,419589246,358101278,777690524
2014-10-27,LG1,TPG,576,6251,5816502,37397092524,4491633798,41888726322
2014-10-27,LG1,RPG,219,1555,1678105,11607276532,2211287939,13818564471
2014-10-27,LG1,UG,2825,24841,22683126,193562938803,41686176966,235249115769
2014-10-27,LG1,Alumni,13,138,159430,898872254,105425756,1004298010
2014-10-27,LG1,Others(HKUST),17,306,646835,2587152813,266908494,2854061307
2014-10-27,LG1,Non-HKUST,59,352,317467,2692716597,761098686,3453815283
2014-10-27,LG1,Total,3816,34031,31737675,249165638769,49880632917,299046271686
2014-10-27,LG3,Staff,137,401,306119,2344281374,325093443,2669374817
2014-10-27,LG3,TPG,330,2277,2740574,47194581269,4676539081,51871120350
2014-10-27,LG3,RPG,223,1038,1218783,16185931535,3600843066,19786774601
2014-10-27,LG3,UG,1522,5817,5357870,107632277765,13736706788,121368984553
2014-10-27,LG3,Alumni,7,35,32566,1746811679,209772628,1956584307
2014-10-27,LG3,Others(HKUST),12,29,17322,13678786,80622728,94301514
2014-10-27,LG3,Non-HKUST,28,137,105933,234350120,212329001,446679121
2014-10-27,LG3,Total,2259,9734,9779167,175351912528,22841906735,198193819263
2014-10-27,LG4,Staff,104,331,300391,5325820115,3222163621,8547983736
2014-10-27,LG4,TPG,379,4961,7185664,106521793647,15040125797,121561919444
2014-10-27,LG4,RPG,192,1420,1773961,30109615599,7679450799,37789066398
2014-10-27,LG4,UG,1729,12225,13784941,282055589882,32975795543,315031385425
2014-10-27,LG4,Alumni,10,147,152234,2541660274,288494834,2830155108
2014-10-27,LG4,Others(HKUST),13,210,309559,32115809907,4713606771,36829416678
2014-10-27,LG4,Non-HKUST,24,146,215293,1992742135,133126264,2125868399
2014-10-27,LG4,Total,2451,19440,23722043,460663031559,64052763629,524715795188
2014-10-27,All-Floors,Staff,333,2618,2286728,19759885957,6738791879,26498677836
2014-10-27,All-Floors,TPG,763,16021,17817773,215635248110,26925381075,242560629185
2014-10-27,All-Floors,RPG,475,4752,5330901,60504862092,13582381826,74087243918
2014-10-27,All-Floors,UG,4303,54572,50678794,638605131048,98909431341,737514562389
2014-10-27,All-Floors,Alumni,23,371,371078,5492587920,627909757,6120497677
2014-10-27,All-Floors,Others(HKUST),24,724,1228317,36339450022,5130096754,41469546776
2014-10-27,All-Floors,Non-HKUST,86,744,709109,5455922576,1143896657,6599819233
2014-10-27,All-Floors,Total,6007,79802,78422700,981793087725,153057889289,1134850977014
2014-10-28,1,Staff,72,525,678414,7718392440,413540953,8131933393
2014-10-28,1,TPG,55,234,358463,9313928140,1508842556,10822770696
2014-10-28,1,RPG,23,67,58972,205354347,31979388,237333735
2014-10-28,1,UG,389,1486,2144419,61082534322,11043334617,72125868939
2014-10-28,1,Alumni,3,10,11861,694515105,152314747,846829852
2014-10-28,1,Others(HKUST),6,115,67854,790672840,78777631,869450471
2014-10-28,1,Non-HKUST,10,78,54389,3278335620,136173025,3414508645
2014-10-28,1,Total,558,2515,3374372,83083732814,13364962917,96448695731
2014-10-28,G,Staff,123,831,623023,3280824654,225794835,3506619489
2014-10-28,G,TPG,484,2529,1856101,7722667217,984964695,8707631912
2014-10-28,G,RPG,178,715,648714,43338027135,1530258258,44868285393
2014-10-28,G,UG,2085,9418,6569974,35016528990,3475900333,38492429323
2014-10-28,G,Alumni,7,19,28890,1266969,3013060,4280029
2014-10-28,G,Others(HKUST),17,82,159006,810553494,55597073,866150567
2014-10-28,G,Non-HKUST,27,86,49110,32791302,7383096,40174398
2014-10-28,G,Total,2921,13680,9934818,90202659761,6282911350,96485571111
2014-10-28,LG1,Staff,118,494,244851,407067074,201595948,608663022
2014-10-28,LG1,TPG,610,6041,5618767,19495995185,2022750988,21518746173
2014-10-28,LG1,RPG,202,1300,1439254,11370674071,1314110499,12684784570
2014-10-28,LG1,UG,2697,22788,21233749,95564158842,14186705972,109750864814
2014-10-28,LG1,Alumni,8,60,41840,115322263,30952222,146274485
2014-10-28,LG1,Others(HKUST),18,188,518666,119333391,63975213,183308604
2014-10-28,LG1,Non-HKUST,48,189,231115,149516759,9431496,158948255
2014-10-28,LG1,Total,3701,31060,29328242,127222067585,17829522338,145051589923
2014-10-28,LG3,Staff,132,440,331965,3444574651,5340598970,8785173621
2014-10-28,LG3,TPG,397,2688,2968770,52776021279,15742462062,68518483341
2014-10-28,LG3,RPG,196,828,1122847,14041389329,1720813401,15762202730
2014-10-28,LG3,UG,1540,6127,5828831,100717781127,12440130290,113157911417
2014-10-28,LG3,Alumni,4,12,11134,33347781,5244038,38591819
2014-10-28,LG3,Others(HKUST),13,26,13306,61358497,13316402,74674899
2014-10-28,LG3,Non-HKUST,17,125,116503,1325670115,167399550,1493069665
2014-10-28,LG3,Total,2299,10246,10393356,172400142779,35429964713,207830107492
2014-10-28,LG4,Staff,88,297,258097,2485962867,661811230,3147774097
2014-10-28,LG4,TPG,465,6036,7999688,152471065126,57149689244,209620754370
2014-10-28,LG4,RPG,180,1170,1544593,24512465823,3542307001,28054772824
2014-10-28,LG4,UG,1744,11336,13415033,219141991737,34648734094,253790725831
2014-10-28,LG4,Alumni,8,83,148249,3508973913,693179303,4202153216
2014-10-28,LG4,Others(HKUST),12,288,289526,19505408608,2239347858,21744756466
2014-10-28,LG4,Non-HKUST,24,104,163617,150839730,38450449,189290179
2014-10-28,LG4,Total,2521,19314,23818803,421776707804,98973519179,520750226983
2014-10-28,All-Floors,Staff,310,2587,2136350,17336821686,6843341936,24180163622
2014-10-28,All-Floors,TPG,857,17528,18801789,241779676947,77408709545,319188386492
2014-10-28,All-Floors,RPG,454,4080,4814380,93467910705,8139468547,101607379252
2014-10-28,All-Floors,UG,4245,51155,49192006,511522995018,75794805306,587317800324
2014-10-28,All-Floors,Alumni,18,184,241974,4353426031,884703370,5238129401
2014-10-28,All-Floors,Others(HKUST),29,699,1048358,21287326830,2451014177,23738341007
2014-10-28,All-Floors,Non-HKUST,79,582,614734,4937153526,358837616,5295991142
2014-10-28,All-Floors,Total,5992,76815,76849591,894685310743,171880880497,1066566191240
2014-10-29,1,Staff,58,469,654717,5194353528,351084384,5545437912
2014-10-29,1,TPG,55,270,333053,6819608052,645456127,7465064179
2014-10-29,1,RPG,16,74,74778,3657998332,191593739,3849592071
2014-10-29,1,UG,350,1490,2358585,54311087212,6623750291,60934837503
2014-10-29,1,Alumni,3,24,42040,2038538056,121835133,2160373189
2014-10-29,1,Others(HKUST),6,79,66557,342671456,67053917,409725373
2014-10-29,1,Non-HKUST,3,11,62080,324483845,37896444,362380289
2014-10-29,1,Total,491,2417,3591810,72688740481,8038670035,80727410516
2014-10-29,G,Staff,118,555,326424,247909151,1071516114,1319425265
2014-10-29,G,TPG,474,2261,1867720,2862143291,275970599,3138113890
2014-10-29,G,RPG,158,724,658620,2341455334,1303804653,3645259987
2014-10-29,G,UG,2048,8786,6392084,25873947667,3880689909,29754637576
2014-10-29,G,Alumni,9,21,28249,368010942,18744196,386755138
2014-10-29,G,Others(HKUST),15,67,149873,103001956,20983162,123985118
2014-10-29,G,Non-HKUST,26,99,87299,3991708,2684421,6676129
2014-10-29,G,Total,2848,12513,9510269,31800460049,6574393054,38374853103
2014-10-29,LG1,Staff,113,375,211131,990114100,69403699,1059517799
2014-10-29,LG1,TPG,569,5301,5059294,19094579449,8170687652,27265267101
2014-10-29,LG1,RPG,196,1227,1194124,13592427980,1254794701,14847222681
2014-10-29,LG1,UG,2674,22450,21865462,76309489927,14153234921,90462724848
2014-10-29,LG1,Alumni,14,112,94999,1317267,585042,1902309
2014-10-29,LG1,Others(HKUST),18,186,517170,468396314,183502801,651899115
2014-10-29,LG1,Non-HKUST,41,154,179258,98049452,12081278,110130730
2014-10-29,LG1,Total,3625,29805,29121438,110554374489,23844290094,134398664583
2014-10-29,LG3,Staff,122,362,301298,7733243870,389964025,8123207895
2014-10-29,LG3,TPG,367,2619,3562465,79879977681,11446700919,91326678600
2014-10-29,LG3,RPG,194,872,1226748,9115960426,2216006479,11331966905
2014-10-29,LG3,UG,1432,5358,5023856,77914444219,12800819776,90715263995
2014-10-29,LG3,Alumni,8,67,91106,2039211786,292838338,2332050124
2014-10-29,LG3,Others(HKUST),16,58,63929,272654358,14756590,287410948
2014-10-29,LG3,Non-HKUST,16,98,80931,474951031,52404970,527356001
2014-10-29,LG3,Total,2155,9434,10350333,177430443371,27213491097,204643934468
2014-10-29,LG4,Staff,112,483,433955,9481340129,838723698,10320063827
2014-10-29,LG4,TPG,476,6047,9126374,164255679128,25046636362,189302315490
2014-10-29,LG4,RPG,186,1176,1568514,37520526868,3278640088,40799166956
2014-10-29,LG4,UG,1655,10042,12411946,181319005306,31316703334,212635708640
2014-10-29,LG4,Alumni,11,119,130656,1830660413,647026454,2477686867
2014-10-29,LG4,Others(HKUST),14,200,286979,7425437162,1312631962,8738069124
2014-10-29,LG4,Non-HKUST,25,131,170361,1237425343,133416126,1370841469
2014-10-29,LG4,Total,2479,18198,24128785,403070074349,62573778024,465643852373
2014-10-29,All-Floors,Staff,301,2244,1927525,23646960778,2720691920,26367652698
2014-10-29,All-Floors,TPG,829,16498,19948906,272911987601,45585451659,318497439260
2014-10-29,All-Floors,RPG,428,4073,4722784,66228368940,8244839660,74473208600
2014-10-29,All-Floors,UG,4267,48126,48051933,415727974331,68775198231,484503172562
2014-10-29,All-Floors,Alumni,24,343,387050,6277738464,1081029163,7358767627
2014-10-29,All-Floors,Others(HKUST),32,590,1084508,8612161246,1598928432,10211089678
2014-10-29,All-Floors,Non-HKUST,71,493,579929,2138901379,238483239,2377384618
2014-10-29,All-Floors,Total,5952,72367,76702635,795544092739,128244622304,923788715043
2014-10-30,1,Staff,61,528,599920,9494194613,525056210,10019250823
2014-10-30,1,TPG,51,216,417645,9173005815,1787116551,10960122366
2014-10-30,1,RPG,21,41,27714,183993688,26101103,210094791
2014-10-30,1,UG,310,1263,1932304,74176883267,7183632336,81360515603
2014-10-30,1,Alumni,2,7,7338,85147923,9829163,94977086
2014-10-30,1,Others(HKUST),3,30,71259,51641639,2948174,54589813
2014-10-30,1,Non-HKUST,5,12,26752,288101501,36575920,324677421
2014-10-30,1,Total,453,2097,3082932,93452968446,9571259457,103024227903
2014-10-30,G,Staff,112,539,476844,922601140,176144096,1098745236
2014-10-30,G,TPG,467,2755,2086347,4076017467,628389643,4704407110
2014-10-30,G,RPG,218,875,660837,639909972,66752119,706662091
2014-10-30,G,UG,1952,8373,6186563,33220466003,3407118991,36627584994
2014-10-30,G,Alumni,9,24,17081,2467998,215125,2683123
2014-10-30,G,Others(HKUST),15,47,201157,18793676,15724281,34517957
2014-10-30,G,Non-HKUST,25,84,71816,142076215,23283461,165359676
2014-10-30,G,Total,2798,12697,9700645,39022332471,4317627716,43339960187
2014-10-30,LG1,Staff,109,530,375525,1175280421,562303868,1737584289
2014-10-30,LG1,TPG,550,4954,4940338,12973201595,4077737676,17050939271
2014-10-30,LG1,RPG,243,1555,1532336,12079417753,1882512217,13961929970
2014-10-30,LG1,UG,2485,21915,20961202,97196886366,13510426368,110707312734
2014-10-30,LG1,Alumni,9,35,35880,86473715,41217326,127691041
2014-10-30,LG1,Others(HKUST),19,138,440773,222590927,126878493,349469420
2014-10-30,LG1,Non-HKUST,37,123,105478,99139441,9215291,108354732
2014-10-30,LG1,Total,3452,29250,28391532,123832990218,20210291239,144043281457
2014-10-30,LG3,Staff,131,400,305639,3178547254,330543259,3509090513
2014-10-30,LG3,TPG,350,2128,2608766,47269796550,6510724043,53780520593
2014-10-30,LG3,RPG,231,930,1104911,8126735770,2222455924,10349191694
2014-10-30,LG3,UG,1417,4803,4657875,88190739774,13206100850,101396840624
2014-10-30,LG3,Alumni,6,42,85793,331673723,35227104,366900827
2014-10-30,LG3,Others(HKUST),12,68,99111,1283950050,50164979,1334115029
2014-10-30,LG3,Non-HKUST,16,50,64701,563469017,41453715,604922732
2014-10-30,LG3,Total,2163,8421,8926796,148944912138,22396669874,171341582012
2014-10-30,LG4,Staff,97,355,225244,2540183129,825521355,3365704484
2014-10-30,LG4,TPG,392,4811,7411514,117967036143,32811585975,150778622118
2014-10-30,LG4,RPG,255,1781,2443289,39282940290,8502930623,47785870913
2014-10-30,LG4,UG,1431,8486,10668292,249576850741,26864477298,276441328039
2014-10-30,LG4,Alumni,12,199,229683,4138643192,315005973,4453649165
2014-10-30,LG4,Others(HKUST),18,229,266049,10051585011,2041533354,12093118365
2014-10-30,LG4,Non-HKUST,23,87,227472,1964347712,1045638878,3009986590
2014-10-30,LG4,Total,2228,15948,21471543,425521586218,72406693456,497928279674
2014-10-30,All-Floors,Staff,298,2352,1983172,17310806557,2419568788,19730375345
2014-10-30,All-Floors,TPG,788,14864,17464610,191459057570,45815553888,237274611458
2014-10-30,All-Floors,RPG,520,5182,5769087,60312997473,12700751986,73013749459
2014-10-30,All-Floors,UG,4045,44840,44406236,542361826151,64171755843,606533581994
2014-10-30,All-Floors,Alumni,22,307,375775,4644406551,401494691,5045901242
2014-10-30,All-Floors,Others(HKUST),30,512,1078349,11628561303,2237249281,13865810584
2014-10-30,All-Floors,Non-HKUST,72,356,496219,3057133886,1156167265,4213301151
2014-10-30,All-Floors,Total,5775,68413,71573448,830774789491,128902541742,959677331233
2014-10-31,1,Staff,53,470,721023,13043435953,451332973,13494768926
2014-10-31,1,TPG,31,159,257490,19121397185,769546675,19890943860
2014-10-31,1,RPG,18,28,20899,130273167,18344914,148618081
2014-10-31,1,UG,227,863,1236643,49864476582,8120723776,57985200358
2014-10-31,1,Alumni,2,10,48437,1091377942,77904744,1169282686
2014-10-31,1,Others(HKUST),5,69,122398,497865252,88469653,586334905
2014-10-31,1,Non-HKUST,7,43,75749,1188011621,78603724,1266615345
2014-10-31,1,Total,343,1642,2482639,84936837702,9604926459,94541764161
2014-10-31,G,Staff,104,623,499695,1119550469,94391796,1213942265
2014-10-31,G,TPG,333,1666,1365782,23851757991,1197566201,25049324192
2014-10-31,G,RPG,148,492,431619,1937978375,151690591,2089668966
2014-10-31,G,UG,1747,7467,5964828,27990387320,2435903413,30426290733
2014-10-31,G,Alumni,9,26,36399,1139197369,54437629,1193634998
2014-10-31,G,Others(HKUST),10,54,210203,18800812,15730691,34531503
2014-10-31,G,Non-HKUST,37,109,77577,106761480,85432855,192194335
2014-10-31,G,Total,2388,10437,8586103,56164433816,4035153176,60199586992
2014-10-31,LG1,Staff,109,417,333120,750705623,130558976,881264599
2014-10-31,LG1,TPG,437,3754,3815011,15701432877,1195982431,16897415308
2014-10-31,LG1,RPG,189,1214,1388196,18352969254,658428696,19011397950
2014-10-31,LG1,UG,2208,17015,17907605,78008148933,15361286903,93369435836
2014-10-31,LG1,Alumni,7,62,108464,35631068,11080721,46711789
2014-10-31,LG1,Others(HKUST),18,231,456370,174696614,140502970,315199584
2014-10-31,LG1,Non-HKUST,45,209,197221,500750992,18392904,519143896
2014-10-31,LG1,Total,3013,22902,24205987,113524335361,17516233601,131040568962
2014-10-31,LG3,Staff,113,289,225642,1825201129,425106587,2250307716
2014-10-31,LG3,TPG,282,1869,2563544,41299766195,10684835400,51984601595
2014-10-31,LG3,RPG,182,862,1158124,52721711056,4780769766,57502480822
2014-10-31,LG3,UG,1173,4074,4370146,85680528088,17513075105,103193603193
2014-10-31,LG3,Alumni,2,3,478,214574,1187254,1401828
2014-10-31,LG3,Others(HKUST),10,84,53614,46143755,8023283,54167038
2014-10-31,LG3,Non-HKUST,23,70,47419,84223923,56810092,141034015
2014-10-31,LG3,Total,1785,7251,8418967,181657788720,33469807487,215127596207
2014-10-31,LG4,Staff,88,243,301577,10761506411,1333723660,12095230071
2014-10-31,LG4,TPG,336,4133,6400657,223085141249,35168057968,258253199217
2014-10-31,LG4,RPG,139,988,1761910,59385519021,11028854514,70414373535
2014-10-31,LG4,UG,1280,6805,8467979,186895985022,18359094675,205255079697
2014-10-31,LG4,Alumni,9,89,119744,2225899853,166315135,2392214988
2014-10-31,LG4,Others(HKUST),13,221,225260,21709206265,6374086716,28083292981
2014-10-31,LG4,Non-HKUST,32,182,232591,190531782,39055200,229586982
2014-10-31,LG4,Total,1897,12661,17509718,504253789603,72469187868,576722977471
2014-10-31,All-Floors,Staff,290,2042,2081057,27500399585,2435113992,29935513577
2014-10-31,All-Floors,TPG,650,11581,14402484,323059495497,49015988675,372075484172
2014-10-31,All-Floors,RPG,408,3584,4760748,132528450873,16638088481,149166539354
2014-10-31,All-Floors,UG,3648,36224,37947201,428439525945,61790083872,490229609817
2014-10-31,All-Floors,Alumni,19,190,313522,4492320806,310925483,4803246289
2014-10-31,All-Floors,Others(HKUST),23,659,1067845,22446712698,6626813313,29073526011
2014-10-31,All-Floors,Non-HKUST,83,613,630557,2070279798,278294775,2348574573
2014-10-31,All-Floors,Total,5121,54893,61203414,940537185202,137095308591,1077632493793