Date,Floor,User-Group,User-Count,WiFi-Conn,Duration-Sec,Traffic-In-Byte,Traffic-Out-Byte,Traffic-Both-Byte
2019-12-01,1,Staff,8,14,186488,2389552507,159924652,2549477159
2019-12-01,1,TPG,7,40,68062,9204936715,1917054679,11121991394
2019-12-01,1,RPG,10,11,16205,88648713,19366626,108015339
2019-12-01,1,UG,29,147,545208,31485996010,4305361086,35791357096
2019-12-01,1,Alumni,2,5,13323,1064432014,24952440,1089384454
2019-12-01,1,Others(HKUST),2,29,342903,1938089398,202962486,2141051884
2019-12-01,1,Non-HKUST,2,4,16564,428891468,20153967,449045435
2019-12-01,1,Total,60,250,1188753,46600546825,6649775936,53250322761
2019-12-01,G,Staff,23,78,309612,17599212621,2202403836,19801616457
2019-12-01,G,TPG,82,250,366222,58398437934,5773752983,64172190917
2019-12-01,G,RPG,27,61,117212,9646625194,541241934,10187867128
2019-12-01,G,UG,77,226,321934,41622334825,4703494443,46325829268
2019-12-01,G,Alumni,12,38,74369,2406306401,306409387,2712715788
2019-12-01,G,Others(HKUST),3,6,271440,2445984230,279478423,2725462653
2019-12-01,G,Non-HKUST,10,33,26291,1458988133,313229488,1772217621
2019-12-01,G,Total,234,692,1487080,133577889338,14120010494,147697899832
2019-12-01,LG1,Staff,12,31,23764,4076688400,687407317,4764095717
2019-12-01,LG1,TPG,56,332,1087541,72220239470,8268920583,80489160053
2019-12-01,LG1,RPG,16,27,12421,17814854706,913756853,18728611559
2019-12-01,LG1,UG,66,257,721826,50990114954,4179247004,55169361958
2019-12-01,LG1,Alumni,1,4,5041,693175637,20706452,713882089
2019-12-01,LG1,Others(HKUST),3,19,521634,8983877594,870335310,9854212904
2019-12-01,LG1,Non-HKUST,3,9,11880,506582701,34747037,541329738
2019-12-01,LG1,Total,157,679,2384107,155285533462,14975120556,170260654018
2019-12-01,LG3,Staff,28,59,117730,7455191937,547083118,8002275055
2019-12-01,LG3,TPG,38,156,339950,58112454514,5442414192,63554868706
2019-12-01,LG3,RPG,45,106,83906,45500210240,2258840210,47759050450
2019-12-01,LG3,UG,67,131,207061,41319274320,3890851872,45210126192
2019-12-01,LG3,Alumni,3,3,538,106765312,5252959,112018271
2019-12-01,LG3,Others(HKUST),3,17,11348,7666468664,276093449,7942562113
2019-12-01,LG3,Non-HKUST,5,6,11163,579812030,66346769,646158799
2019-12-01,LG3,Total,189,478,771696,160740177017,12486882569,173227059586
2019-12-01,LG4,Staff,20,50,41052,8545764862,295844596,8841609458
2019-12-01,LG4,TPG,39,236,566253,162263664637,15027041964,177290706601
2019-12-01,LG4,RPG,31,46,16023,14923190684,488058253,15411248937
2019-12-01,LG4,UG,79,211,303578,57049232840,8116477784,65165710624
2019-12-01,LG4,Alumni,3,5,4501,162316558,10745423,173061981
2019-12-01,LG4,Others(HKUST),2,4,173325,22557554240,3846080073,26403634313
2019-12-01,LG4,Non-HKUST,9,21,37273,3118142760,102690457,3220833217
2019-12-01,LG4,Total,183,573,1142005,268619866581,27886938550,296506805131
2019-12-01,All-Floors,Staff,60,232,678646,40066410327,3892663519,43959073846
2019-12-01,All-Floors,TPG,129,1014,2428028,360199733270,36429184401,396628917671
2019-12-01,All-Floors,RPG,101,251,245767,87973529537,4221263876,92194793413
2019-12-01,All-Floors,UG,214,972,2099607,222466952949,25195432189,247662385138
2019-12-01,All-Floors,Alumni,17,55,97772,4432995922,368066661,4801062583
2019-12-01,All-Floors,Others(HKUST),9,75,1320650,43591974126,5474949741,49066923867
2019-12-01,All-Floors,Non-HKUST,21,73,103171,6092417092,537167718,6629584810
2019-12-01,All-Floors,Total,551,2672,6973641,764824013223,76118728105,840942741328
2019-12-02,1,Staff,72,668,1176010,44738497761,17091503760,61830001521
2019-12-02,1,TPG,28,151,476923,34254357035,4542982466,38797339501
2019-12-02,1,RPG,18,83,378968,18597711846,1638906430,20236618276
2019-12-02,1,UG,62,522,1592601,146665328803,26243641091,172908969894
2019-12-02,1,Alumni,2,5,14068,548895778,63995849,612891627
2019-12-02,1,Others(HKUST),3,75,341861,6950814725,701144054,7651958779
2019-12-02,1,Non-HKUST,8,21,86446,30707798134,1461956178,32169754312
2019-12-02,1,Total,193,1525,4066877,282463404082,51744129828,334207533910
2019-12-02,G,Staff,153,729,1160327,101722219092,19935577751,121657796843
2019-12-02,G,TPG,168,733,1281502,194392292434,42171633035,236563925469
2019-12-02,G,RPG,93,321,483151,38145553821,3874233266,42019787087
2019-12-02,G,UG,283,961,1102673,254169814069,32505775518,286675589587
2019-12-02,G,Alumni,8,17,31371,3292235953,236363289,3528599242
2019-12-02,G,Others(HKUST),7,25,266578,13236379902,961754278,14198134180
2019-12-02,G,Non-HKUST,35,112,131478,16124808008,2591155997,18715964005
2019-12-02,G,Total,747,2898,4457080,621083303279,102276493134,723359796413
2019-12-02,LG1,Staff,63,256,306297,19742866798,4487691348,24230558146
2019-12-02,LG1,TPG,114,924,2297076,353015443797,96481903266,449497347063
2019-12-02,LG1,RPG,60,348,506383,55719453272,9410413122,65129866394
2019-12-02,LG1,UG,250,1649,4161255,454242573207,57639417723,511881990930
2019-12-02,LG1,Alumni,5,23,53197,19055791704,1755231780,20811023484
2019-12-02,LG1,Others(HKUST),8,63,541236,28214157419,3490342192,31704499611
2019-12-02,LG1,Non-HKUST,23,117,379387,65921521284,2588978883,68510500167
2019-12-02,LG1,Total,523,3380,8244831,995911807481,175853978314,1171765785795
2019-12-02,LG3,Staff,116,323,289177,17929342214,1239783806,19169126020
2019-12-02,LG3,TPG,64,405,1051418,309209401748,37832555270,347041957018
2019-12-02,LG3,RPG,103,288,575762,141282948973,11908407093,153191356066
2019-12-02,LG3,UG,154,680,1077807,259125460852,21009299138,280134759990
2019-12-02,LG3,Alumni,7,54,91609,44506677506,2936243498,47442921004
2019-12-02,LG3,Others(HKUST),5,21,24131,17223509622,518796392,17742306014
2019-12-02,LG3,Non-HKUST,17,33,45714,5239454266,4937705560,10177159826
2019-12-02,LG3,Total,466,1804,3155618,794516795181,80382790757,874899585938
2019-12-02,LG4,Staff,72,145,94011,16024942717,1116496388,17141439105
2019-12-02,LG4,TPG,68,599,1457314,238444509057,22256437288,260700946345
2019-12-02,LG4,RPG,72,225,472683,99561971852,12341241915,111903213767
2019-12-02,LG4,UG,151,787,1833184,264988989382,22397054406,287386043788
2019-12-02,LG4,Alumni,9,94,58574,27706801916,2200660945,29907462861
2019-12-02,LG4,Others(HKUST),5,17,176578,46622378379,7877028602,54499406981
2019-12-02,LG4,Non-HKUST,18,90,196442,44476665967,4466903100,48943569067
2019-12-02,LG4,Total,395,1957,4288786,737826259270,72655822644,810482081914
2019-12-02,All-Floors,Staff,292,2121,3025822,200157868582,43871053053,244028921635
2019-12-02,All-Floors,TPG,225,2812,6564233,1129316004071,203285511325,1332601515396
2019-12-02,All-Floors,RPG,231,1265,2416947,353307639764,39173201826,392480841590
2019-12-02,All-Floors,UG,502,4599,9767520,1379192166313,159795187876,1538987354189
2019-12-02,All-Floors,Alumni,16,193,248819,95110402857,7192495361,102302898218
2019-12-02,All-Floors,Others(HKUST),14,201,1350384,112247240047,13549065518,125796305565
2019-12-02,All-Floors,Non-HKUST,62,373,839467,162470247659,16046699718,178516947377
2019-12-02,All-Floors,Total,1342,11564,24213192,3431801569293,482913214677,3914714783970
2019-12-03,1,Staff,71,663,1304956,63800909966,7305207157,71106117123
2019-12-03,1,TPG,39,248,972801,62467973270,160130906964,222598880234
2019-12-03,1,RPG,25,121,421660,18150691916,1073823338,19224515254
2019-12-03,1,UG,79,536,1812064,164230926337,13332534383,177563460720
2019-12-03,1,Alumni,1,13,25596,2638066439,244506061,2882572500
2019-12-03,1,Others(HKUST),3,46,343470,4018661612,426714392,4445376004
2019-12-03,1,Non-HKUST,11,39,192945,7203096033,1284622690,8487718723
2019-12-03,1,Total,229,1666,5073492,322510325573,183798314985,506308640558
2019-12-03,G,Staff,134,657,1124058,77833227145,44701564301,122534791446
2019-12-03,G,TPG,178,809,1450951,225329234977,32285856659,257615091636
2019-12-03,G,RPG,103,430,713641,53702643921,19370185781,73072829702
2019-12-03,G,UG,336,1080,1659733,255703771981,138222573496,393926345477
2019-12-03,G,Alumni,8,41,63717,9267556343,4733583874,14001140217
2019-12-03,G,Others(HKUST),7,23,342559,3668720333,374437698,4043158031
2019-12-03,G,Non-HKUST,38,138,193251,22894039383,5832196951,28726236334
2019-12-03,G,Total,804,3178,5547910,648399194083,245520398760,893919592843
2019-12-03,LG1,Staff,69,287,311392,14236256370,3092274579,17328530949
2019-12-03,LG1,TPG,119,776,2410139,231151605772,22803203377,253954809149
2019-12-03,LG1,RPG,72,354,944714,78342465002,24203668087,102546133089
2019-12-03,LG1,UG,284,1600,4697107,397157076461,56862978602,454020055063
2019-12-03,LG1,Alumni,2,4,5742,5001816,1967360,6969176
2019-12-03,LG1,Others(HKUST),7,40,532482,41349277540,1603884301,42953161841
2019-12-03,LG1,Non-HKUST,28,120,383163,32434928667,2019568271,34454496938
2019-12-03,LG1,Total,581,3181,9284739,794676611628,110587544577,905264156205
2019-12-03,LG3,Staff,98,263,359878,15475847337,2574591584,18050438921
2019-12-03,LG3,TPG,76,415,1489580,181709152470,14708347677,196417500147
2019-12-03,LG3,RPG,109,311,407322,90889204780,7666500935,98555705715
2019-12-03,LG3,UG,181,681,1216943,279369782704,18743716610,298113499314
2019-12-03,LG3,Alumni,3,10,14574,863721773,68785155,932506928
2019-12-03,LG3,Others(HKUST),8,23,16556,38855481156,793820901,39649302057
2019-12-03,LG3,Non-HKUST,16,24,31712,8799682992,226296692,9025979684
2019-12-03,LG3,Total,491,1727,3536565,615962873212,44782059554,660744932766
2019-12-03,LG4,Staff,63,190,131789,16400860248,2327724526,18728584774
2019-12-03,LG4,TPG,57,353,966969,792119022101,32297859192,824416881293
2019-12-03,LG4,RPG,72,215,456818,74701555303,125746752549,200448307852
2019-12-03,LG4,UG,156,858,2033631,299041427661,27645610158,326687037819
2019-12-03,LG4,Alumni,5,52,97358,5468085012,340894147,5808979159
2019-12-03,LG4,Others(HKUST),7,24,183396,47079837134,7715022700,54794859834
2019-12-03,LG4,Non-HKUST,18,53,175366,16845066615,1055226353,17900292968
2019-12-03,LG4,Total,378,1745,4045327,1251655854074,197129089625,1448784943699
2019-12-03,All-Floors,Staff,269,2060,3232073,187747101066,60001362147,247748463213
2019-12-03,All-Floors,TPG,240,2601,7290440,1492776988590,262226173869,1755003162459
2019-12-03,All-Floors,RPG,262,1431,2944155,315786560922,178060930690,493847491612
2019-12-03,All-Floors,UG,584,4755,11419478,1395502985144,254807413249,1650310398393
2019-12-03,All-Floors,Alumni,14,120,206987,18242431383,5389736597,23632167980
2019-12-03,All-Floors,Others(HKUST),19,156,1418463,134971977775,10913879992,145885857767
2019-12-03,All-Floors,Non-HKUST,69,374,976437,88176813690,10417910957,98594724647
2019-12-03,All-Floors,Total,1457,11497,27488033,3633204858570,781817407501,4415022266071
2019-12-04,1,Staff,59,640,1198654,52145791518,3640370505,55786162023
2019-12-04,1,TPG,45,236,932613,39800311783,3529035804,43329347587
2019-12-04,1,RPG,22,184,459986,12982307164,1207762862,14190070026
2019-12-04,1,UG,108,759,2375189,205704913670,29191657528,234896571198
2019-12-04,1,Alumni,3,12,61733,13887386461,507374544,14394761005
2019-12-04,1,Others(HKUST),5,38,340360,2709562768,292762162,3002324930
2019-12-04,1,Non-HKUST,10,71,136315,4652215793,364374970,5016590763
2019-12-04,1,Total,252,1940,5504850,331882489157,38733338375,370615827532
2019-12-04,G,Staff,142,677,1193397,68496677520,12310270963,80806948483
2019-12-04,G,TPG,178,859,1558668,286669864781,85300357149,371970221930
2019-12-04,G,RPG,129,364,623801,78538937040,8749968203,87288905243
2019-12-04,G,UG,441,1679,2351973,519962569158,71984895260,591947464418
2019-12-04,G,Alumni,7,14,24658,14076645072,466605476,14543250548
2019-12-04,G,Others(HKUST),6,26,340733,9171007874,743513596,9914521470
2019-12-04,G,Non-HKUST,39,151,273385,19341632279,5046747211,24388379490
2019-12-04,G,Total,942,3770,6366615,996257333724,184602357858,1180859691582
2019-12-04,LG1,Staff,60,240,281498,24660071084,2268317010,26928388094
2019-12-04,LG1,TPG,128,969,2615141,209220826261,202429566523,411650392784
2019-12-04,LG1,RPG,75,439,1020010,123280210850,16234847554,139515058404
2019-12-04,LG1,UG,327,2023,5536222,589544703332,81723896435,671268599767
2019-12-04,LG1,Alumni,1,8,27556,5184342993,207737671,5392080664
2019-12-04,LG1,Others(HKUST),7,125,578005,30251299852,2045564338,32296864190
2019-12-04,LG1,Non-HKUST,28,125,429561,42199986956,7712947344,49912934300
2019-12-04,LG1,Total,626,3929,10487993,1024341441328,312622876875,1336964318203
2019-12-04,LG3,Staff,99,289,460678,24325751065,4260718556,28586469621
2019-12-04,LG3,TPG,55,448,1371808,254224440130,31272590320,285497030450
2019-12-04,LG3,RPG,108,420,881160,150757457192,10487743149,161245200341
2019-12-04,LG3,UG,208,740,1314394,315710026681,25984166917,341694193598
2019-12-04,LG3,Alumni,2,2,0,69254647,11666980,80921627
2019-12-04,LG3,Others(HKUST),5,47,29895,15937891547,760796182,16698687729
2019-12-04,LG3,Non-HKUST,13,25,49523,7969568945,1159120112,9128689057
2019-12-04,LG3,Total,490,1971,4107458,768994390207,73936802216,842931192423
2019-12-04,LG4,Staff,59,169,120175,10152048708,3145130619,13297179327
2019-12-04,LG4,TPG,57,428,1264825,140219046655,16388648982,156607695637
2019-12-04,LG4,RPG,77,156,279787,54244130693,3462131041,57706261734
2019-12-04,LG4,UG,219,1294,3163908,535259776541,143455818114,678715594655
2019-12-04,LG4,Alumni,2,22,46712,13109692920,220545439,13330238359
2019-12-04,LG4,Others(HKUST),4,44,180665,26499727287,4047547785,30547275072
2019-12-04,LG4,Non-HKUST,20,52,118050,17632717108,2536122971,20168840079
2019-12-04,LG4,Total,438,2165,5174122,797117139912,173255944951,970373084863
2019-12-04,All-Floors,Staff,262,2015,3254402,179780339895,25624807653,205405147548
2019-12-04,All-Floors,TPG,238,2940,7743055,930134489610,338920198778,1269054688388
2019-12-04,All-Floors,RPG,262,1563,3264744,419803042939,40142452809,459945495748
2019-12-04,All-Floors,UG,686,6495,14741686,2166181989382,352340434254,2518522423636
2019-12-04,All-Floors,Alumni,9,58,160659,46327322093,1413930110,47741252203
2019-12-04,All-Floors,Others(HKUST),13,280,1469658,84569489328,7890184063,92459673391
2019-12-04,All-Floors,Non-HKUST,69,424,1006834,91796121081,16819312608,108615433689
2019-12-04,All-Floors,Total,1539,13775,31641038,3918592794328,783151320275,4701744114603
2019-12-05,1,Staff,72,748,1267255,37926205889,3431180592,41357386481
2019-12-05,1,TPG,36,374,1000169,53667839047,13521850846,67189689893
2019-12-05,1,RPG,15,120,403561,9975445209,1110404583,11085849792
2019-12-05,1,UG,99,811,2213102,192227380577,22965195723,215192576300
2019-12-05,1,Alumni,3,14,26143,1735757080,89816442,1825573522
2019-12-05,1,Others(HKUST),5,32,321508,2642718203,262309817,2905028020
2019-12-05,1,Non-HKUST,12,62,187147,8988540574,1133550466,10122091040
2019-12-05,1,Total,242,2161,5418885,307163886579,42514308469,349678195048
2019-12-05,G,Staff,141,699,1048770,85702011634,20432931017,106134942651
2019-12-05,G,TPG,174,853,1458049,201369223564,14635440397,216004663961
2019-12-05,G,RPG,124,437,560003,80409298874,5614503477,86023802351
2019-12-05,G,UG,436,1612,2252319,315751457133,40534911138,356286368271
2019-12-05,G,Alumni,8,23,33682,6956712365,272674971,7229387336
2019-12-05,G,Others(HKUST),12,56,313013,11886181136,1050456767,12936637903
2019-12-05,G,Non-HKUST,36,114,152704,20480316391,2235459888,22715776279
2019-12-05,G,Total,931,3794,5818540,722555201097,84776377655,807331578752
2019-12-05,LG1,Staff,57,239,272910,16279615425,2072942117,18352557542
2019-12-05,LG1,TPG,104,1038,2310048,224417400385,24024827969,248442228354
2019-12-05,LG1,RPG,94,542,1221695,183018545854,10081407645,193099953499
2019-12-05,LG1,UG,341,2704,5632686,653633369797,127298517172,780931886969
2019-12-05,LG1,Alumni,3,3,3972,179551202,20958603,200509805
2019-12-05,LG1,Others(HKUST),8,93,377276,16454389165,1827164174,18281553339
2019-12-05,LG1,Non-HKUST,24,142,345079,52394164691,3374344591,55768509282
2019-12-05,LG1,Total,631,4761,10163666,1146377036519,168700162271,1315077198790
2019-12-05,LG3,Staff,101,327,417254,37073790455,2950043895,40023834350
2019-12-05,LG3,TPG,79,502,1206489,319935481225,21028538626,340964019851
2019-12-05,LG3,RPG,112,330,660639,170501127600,7287511655,177788639255
2019-12-05,LG3,UG,208,1020,1871975,514789982046,73304501064,588094483110
2019-12-05,LG3,Alumni,3,14,25696,1250858253,86757928,1337616181
2019-12-05,LG3,Others(HKUST),7,36,36348,9407928782,712550506,10120479288
2019-12-05,LG3,Non-HKUST,24,44,98395,17468025479,22762812578,40230838057
2019-12-05,LG3,Total,534,2273,4316796,1070427193840,128132716252,1198559910092
2019-12-05,LG4,Staff,63,210,121518,11897740378,1208086071,13105826449
2019-12-05,LG4,TPG,73,367,1090905,195960976939,25904103653,221865080592
2019-12-05,LG4,RPG,82,170,340514,47935223395,2926362718,50861586113
2019-12-05,LG4,UG,187,1108,2798008,438934651387,41703351913,480638003300
2019-12-05,LG4,Alumni,8,64,101899,55825491907,1305931210,57131423117
2019-12-05,LG4,Others(HKUST),8,58,186693,52336026851,7933520704,60269547555
2019-12-05,LG4,Non-HKUST,23,50,108354,6935521218,584203798,7519725016
2019-12-05,LG4,Total,444,2027,4747891,809825632075,81565560067,891391192142
2019-12-05,All-Floors,Staff,260,2223,3127707,188879363781,30095183692,218974547473
2019-12-05,All-Floors,TPG,225,3134,7065660,995350921160,99114761491,1094465682651
2019-12-05,All-Floors,RPG,279,1599,3186412,491839640932,27020190078,518859831010
2019-12-05,All-Floors,UG,661,7255,14768090,2115336840940,305806477010,2421143317950
2019-12-05,All-Floors,Alumni,13,118,191392,65948370807,1776139154,67724509961
2019-12-05,All-Floors,Others(HKUST),21,275,1234838,92727244137,11786001968,104513246105
2019-12-05,All-Floors,Non-HKUST,65,412,891679,106266568353,30090371321,136356939674
2019-12-05,All-Floors,Total,1524,15016,30465778,4056348950110,505689124714,4562038074824
2019-12-06,1,Staff,63,638,1241405,47626174629,5232186580,52858361209
2019-12-06,1,TPG,36,336,1027584,102230064689,6643958585,108874023274
2019-12-06,1,RPG,14,100,451922,11659039929,1102531944,12761571873
2019-12-06,1,UG,105,911,2850362,264336878327,31398162166,295735040493
2019-12-06,1,Alumni,2,14,64071,4602117479,219439275,4821556754
2019-12-06,1,Others(HKUST),4,25,281167,655912627,91129706,747042333
2019-12-06,1,Non-HKUST,13,79,199374,9018350761,777909389,9796260150
2019-12-06,1,Total,237,2103,6115885,440128538441,45465317645,485593856086
2019-12-06,G,Staff,138,563,1143238,57227561712,13509798017,70737359729
2019-12-06,G,TPG,191,865,2134687,345291391406,36582512031,381873903437
2019-12-06,G,RPG,103,320,412368,56113352032,6647785486,62761137518
2019-12-06,G,UG,410,1390,2061039,460597759758,43907365557,504505125315
2019-12-06,G,Alumni,3,14,22149,1921907460,170291644,2092199104
2019-12-06,G,Others(HKUST),10,32,303508,4586815392,445467770,5032283162
2019-12-06,G,Non-HKUST,42,146,273179,35378868745,11228439956,46607308701
2019-12-06,G,Total,897,3330,6350168,961117656505,112491660461,1073609316966
2019-12-06,LG1,Staff,72,293,415170,19408909626,2642647940,22051557566
2019-12-06,LG1,TPG,99,798,2351806,220172643334,21549011821,241721655155
2019-12-06,LG1,RPG,80,309,799913,59539384670,8384798085,67924182755
2019-12-06,LG1,UG,270,1957,5459277,543022774801,80525875335,623548650136
2019-12-06,LG1,Alumni,2,5,3765,468445566,22219940,490665506
2019-12-06,LG1,Others(HKUST),10,55,133638,6531963338,489738945,7021702283
2019-12-06,LG1,Non-HKUST,26,130,395039,32305639857,10458427513,42764067370
2019-12-06,LG1,Total,559,3547,9558608,881449761192,124072719579,1005522480771
2019-12-06,LG3,Staff,92,255,431865,12748484590,1217438380,13965922970
2019-12-06,LG3,TPG,85,480,1442560,159393721682,12046804848,171440526530
2019-12-06,LG3,RPG,110,337,681297,69942281063,4654249023,74596530086
2019-12-06,LG3,UG,175,800,1367537,480259174783,44437386303,524696561086
2019-12-06,LG3,Alumni,0,0,0,0,0,0
2019-12-06,LG3,Others(HKUST),7,28,15881,6150214432,377603392,6527817824
2019-12-06,LG3,Non-HKUST,22,38,80906,14491726852,739477803,15231204655
2019-12-06,LG3,Total,491,1938,4020046,742985603402,63472959749,806458563151
2019-12-06,LG4,Staff,64,128,46668,5228195295,3930087745,9158283040
2019-12-06,LG4,TPG,74,566,1611623,295648942360,39651620288,335300562648
2019-12-06,LG4,RPG,62,186,335021,59885530814,4053626179,63939156993
2019-12-06,LG4,UG,174,912,2956905,372138097255,40952920756,413091018011
2019-12-06,LG4,Alumni,5,28,57967,12195437166,323421515,12518858681
2019-12-06,LG4,Others(HKUST),7,26,202066,23912028575,3953794378,27865822953
2019-12-06,LG4,Non-HKUST,20,86,243661,62966254301,3272078905,66238333206
2019-12-06,LG4,Total,406,1932,5453911,831974485766,96137549766,928112035532
2019-12-06,All-Floors,Staff,264,1877,3278346,142239325852,26532158662,168771484514
2019-12-06,All-Floors,TPG,249,3045,8568260,1122736763471,116473907573,1239210671044
2019-12-06,All-Floors,RPG,250,1252,2680521,257139588508,24842990717,281982579225
2019-12-06,All-Floors,UG,603,5970,14695120,2120354684924,241221710117,2361576395041
2019-12-06,All-Floors,Alumni,9,61,147952,19187907671,735372374,19923280045
2019-12-06,All-Floors,Others(HKUST),21,166,936260,41836934364,5357734191,47194668555
2019-12-06,All-Floors,Non-HKUST,74,479,1192159,154160840516,26476333566,180637174082
2019-12-06,All-Floors,Total,1470,12850,31498618,3857656045306,441640207200,4299296252506
2019-12-07,1,Staff,8,52,329611,3198559196,235136943,3433696139
2019-12-07,1,TPG,29,206,767169,56477549109,5069908992,61547458101
2019-12-07,1,RPG,6,35,123476,6770308998,1246605950,8016914948
2019-12-07,1,UG,47,217,871223,72241481299,6931713904,79173195203
2019-12-07,1,Alumni,2,6,28792,18018260,5190448,23208708
2019-12-07,1,Others(HKUST),1,3,259197,219746235,28497936,248244171
2019-12-07,1,Non-HKUST,12,53,180392,11452070608,1252610324,12704680932
2019-12-07,1,Total,105,572,2559860,150377733705,14769664497,165147398202
2019-12-07,G,Staff,28,72,352427,21845760958,7744520024,29590280982
2019-12-07,G,TPG,135,497,959250,123094432286,10473178399,133567610685
2019-12-07,G,RPG,43,120,167687,25322209709,1939693679,27261903388
2019-12-07,G,UG,215,748,1122746,344165963102,91032407881,435198370983
2019-12-07,G,Alumni,6,16,20690,513679766,45321173,559000939
2019-12-07,G,Others(HKUST),4,13,173339,3228815578,344381910,3573197488
2019-12-07,G,Non-HKUST,23,92,200833,22123970902,3338914040,25462884942
2019-12-07,G,Total,454,1558,2996972,540294832301,114918417106,655213249407
2019-12-07,LG1,Staff,9,15,15117,2676760833,87086765,2763847598
2019-12-07,LG1,TPG,67,384,1095501,83284423288,10126715902,93411139190
2019-12-07,LG1,RPG,29,114,321260,27271005738,4273467970,31544473708
2019-12-07,LG1,UG,164,867,2535189,310880019915,80841718008,391721737923
2019-12-07,LG1,Alumni,2,3,1983,35791063,4621834,40412897
2019-12-07,LG1,Others(HKUST),4,53,113235,6476301923,1007581484,7483883407
2019-12-07,LG1,Non-HKUST,11,26,91237,8920857431,1663736270,10584593701
2019-12-07,LG1,Total,286,1462,4173522,439545160191,98004928233,537550088424
2019-12-07,LG3,Staff,27,84,207535,2399693878,1044547638,3444241516
2019-12-07,LG3,TPG,51,218,721863,78355602722,5798104524,84153707246
2019-12-07,LG3,RPG,59,116,195753,17401802157,1017202618,18419004775
2019-12-07,LG3,UG,114,369,692028,206280594852,14437954887,220718549739
2019-12-07,LG3,Alumni,5,19,47879,5516398203,275556753,5791954956
2019-12-07,LG3,Others(HKUST),3,21,0,620027144,28661256,648688400
2019-12-07,LG3,Non-HKUST,12,18,34359,3772329015,277888206,4050217221
2019-12-07,LG3,Total,271,845,1899417,314346447971,22879915882,337226363853
2019-12-07,LG4,Staff,12,26,66065,11079969989,1335679671,12415649660
2019-12-07,LG4,TPG,61,295,857680,136225741972,24749085201,160974827173
2019-12-07,LG4,RPG,35,84,155164,23057860319,1877025880,24934886199
2019-12-07,LG4,UG,112,486,1110618,169378204241,15840422041,185218626282
2019-12-07,LG4,Alumni,4,15,37068,2992742224,370380798,3363123022
2019-12-07,LG4,Others(HKUST),6,36,188108,24886762855,3952885271,28839648126
2019-12-07,LG4,Non-HKUST,9,30,39239,7478236081,461695633,7939931714
2019-12-07,LG4,Total,239,972,2453942,375099517681,48587174495,423686692176
2019-12-07,All-Floors,Staff,64,249,970755,41200744854,10446971041,51647715895
2019-12-07,All-Floors,TPG,196,1600,4401463,477437749377,56216993018,533654742395
2019-12-07,All-Floors,RPG,129,469,963340,99823186921,10353996097,110177183018
2019-12-07,All-Floors,UG,386,2687,6331804,1102946263409,209084216721,1312030480130
2019-12-07,All-Floors,Alumni,13,59,136412,9076629516,701071006,9777700522
2019-12-07,All-Floors,Others(HKUST),10,126,733879,35431653735,5362007857,40793661592
2019-12-07,All-Floors,Non-HKUST,42,219,546060,53747464037,6994844473,60742308510
2019-12-07,All-Floors,Total,840,5409,14083713,1819663691849,299160100213,2118823792062
2019-12-08,1,Staff,7,33,314486,3027564219,212526292,3240090511
2019-12-08,1,TPG,29,168,763188,52761585415,4585119986,57346705401
2019-12-08,1,RPG,4,23,59778,8259362876,346669607,8606032483
2019-12-08,1,UG,57,415,1176093,140277388391,31340839261,171618227652
2019-12-08,1,Alumni,2,7,28977,2744978945,188092090,2933071035
2019-12-08,1,Others(HKUST),3,9,271076,333919226,71454163,405373389
2019-12-08,1,Non-HKUST,9,40,99393,3144551639,611261334,3755812973
2019-12-08,1,Total,111,695,2712991,210549350711,37355962733,247905313444
2019-12-08,G,Staff,29,69,333392,13428827611,1131527013,14560354624
2019-12-08,G,TPG,111,380,732194,112271059335,11967679425,124238738760
2019-12-08,G,RPG,58,202,335604,30982987284,4880521642,35863508926
2019-12-08,G,UG,191,590,1073593,265272413226,19802070682,285074483908
2019-12-08,G,Alumni,11,23,28266,5263083457,775532715,6038616172
2019-12-08,G,Others(HKUST),1,2,172798,2606047867,259131099,2865178966
2019-12-08,G,Non-HKUST,28,107,204501,18177017937,1985282250,20162300187
2019-12-08,G,Total,429,1373,2880348,448001436717,40801744826,488803181543
2019-12-08,LG1,Staff,13,44,60860,2583438631,269965482,2853404113
2019-12-08,LG1,TPG,70,395,1322773,107347102737,14772360031,122119462768
2019-12-08,LG1,RPG,37,127,221777,11321884607,3491420451,14813305058
2019-12-08,LG1,UG,163,832,2845385,241068599799,27479366278,268547966077
2019-12-08,LG1,Alumni,4,11,16745,758389702,901867741,1660257443
2019-12-08,LG1,Others(HKUST),5,11,97389,2381528113,97872254,2479400367
2019-12-08,LG1,Non-HKUST,12,64,90385,43843708894,3136764492,46980473386
2019-12-08,LG1,Total,304,1484,4655314,409304652483,50149616729,459454269212
2019-12-08,LG3,Staff,32,83,222827,8494955954,710309391,9205265345
2019-12-08,LG3,TPG,61,253,809476,113098589339,10285395489,123383984828
2019-12-08,LG3,RPG,63,152,196595,49015973573,3220597280,52236570853
2019-12-08,LG3,UG,99,258,545116,196791263194,12341811301,209133074495
2019-12-08,LG3,Alumni,7,21,29155,9379680949,1375838697,10755519646
2019-12-08,LG3,Others(HKUST),3,10,22149,6318443090,270033998,6588477088
2019-12-08,LG3,Non-HKUST,15,25,85340,7216718664,308177389,7524896053
2019-12-08,LG3,Total,280,802,1910658,390315624763,28512163545,418827788308
2019-12-08,LG4,Staff,10,14,4142,1995354912,84448890,2079803802
2019-12-08,LG4,TPG,35,206,572317,84090170713,8008983031,92099153744
2019-12-08,LG4,RPG,35,78,131937,6663829927,613594761,7277424688
2019-12-08,LG4,UG,100,432,969168,562523919782,15030848480,577554768262
2019-12-08,LG4,Alumni,6,24,41243,9973045784,845362279,10818408063
2019-12-08,LG4,Others(HKUST),3,23,190444,50956621037,7897327684,58853948721
2019-12-08,LG4,Non-HKUST,14,25,62099,15100866958,300262264,15401129222
2019-12-08,LG4,Total,203,802,1971350,731303809113,32780827389,764084636502
2019-12-08,All-Floors,Staff,63,243,935707,29530141327,2408777068,31938918395
2019-12-08,All-Floors,TPG,177,1402,4199948,469568507539,49619537962,519188045501
2019-12-08,All-Floors,RPG,138,582,945691,106244038267,12552803741,118796842008
2019-12-08,All-Floors,UG,367,2527,6609355,1405933584392,105994936002,1511928520394
2019-12-08,All-Floors,Alumni,18,86,144386,28119178837,4086693522,32205872359
2019-12-08,All-Floors,Others(HKUST),11,55,753856,62596559333,8595819198,71192378531
2019-12-08,All-Floors,Non-HKUST,51,261,541718,87482864092,6341747729,93824611821
2019-12-08,All-Floors,Total,825,5156,14130661,2189474873787,189600315222,2379075189009
2019-12-09,1,Staff,81,768,1384891,46250933508,7512380625,53763314133
2019-12-09,1,TPG,63,573,1670831,73100398790,12463178718,85563577508
2019-12-09,1,RPG,27,223,678618,37352598282,2699774027,40052372309
2019-12-09,1,UG,135,1176,3154249,196833856204,22585699807,219419556011
2019-12-09,1,Alumni,1,1,0,11359828,1331825,12691653
2019-12-09,1,Others(HKUST),5,61,267278,1199173268,147552979,1346726247
2019-12-09,1,Non-HKUST,13,114,267998,7284439483,1837867382,9122306865
2019-12-09,1,Total,325,2916,7423865,362032759363,47247785363,409280544726
2019-12-09,G,Staff,156,689,1088416,35259509623,6575274905,41834784528
2019-12-09,G,TPG,246,1094,1834611,218056153155,22285561970,240341715125
2019-12-09,G,RPG,97,384,544378,84307136370,26103933575,110411069945
2019-12-09,G,UG,595,2148,2580552,335026115848,79312821281,414338937129
2019-12-09,G,Alumni,10,19,22398,2578395216,213685862,2792081078
2019-12-09,G,Others(HKUST),7,27,184605,3945050142,315909685,4260959827
2019-12-09,G,Non-HKUST,45,166,212699,35495107215,4930626714,40425733929
2019-12-09,G,Total,1156,4527,6467659,714667467569,139737813992,854405281561
2019-12-09,LG1,Staff,66,220,260578,20490724362,1480061219,21970785581
2019-12-09,LG1,TPG,134,1141,2762696,187966868645,20267744539,208234613184
2019-12-09,LG1,RPG,62,381,737761,84156767814,6836099681,90992867495
2019-12-09,LG1,UG,458,3762,9943007,781498648664,86352653089,867851301753
2019-12-09,LG1,Alumni,1,1,0,129740,58720,188460
2019-12-09,LG1,Others(HKUST),6,35,91890,631465523,63095128,694560651
2019-12-09,LG1,Non-HKUST,32,145,366520,29906173147,6926299253,36832472400
2019-12-09,LG1,Total,759,5685,14162452,1104650777895,121926011629,1226576789524
2019-12-09,LG3,Staff,117,339,347883,72116002180,5864255550,77980257730
2019-12-09,LG3,TPG,91,587,1393983,211944225329,12689366960,224633592289
2019-12-09,LG3,RPG,115,355,613890,86567108508,24830071136,111397179644
2019-12-09,LG3,UG,236,1388,2671018,985152558415,49712722808,1034865281223
2019-12-09,LG3,Alumni,10,61,140580,16705854714,3851177392,20557032106
2019-12-09,LG3,Others(HKUST),2,2,0,216858,153141,369999
2019-12-09,LG3,Non-HKUST,19,55,205375,23979396415,1446506360,25425902775
2019-12-09,LG3,Total,590,2787,5372729,1396465362419,98394253347,1494859615766
2019-12-09,LG4,Staff,56,135,113560,10752885900,1326417487,12079303387
2019-12-09,LG4,TPG,84,642,1594928,161844395319,15127840892,176972236211
2019-12-09,LG4,RPG,77,275,508049,62213188606,3598521156,65811709762
2019-12-09,LG4,UG,269,1756,4097703,814952942699,60926060963,875879003662
2019-12-09,LG4,Alumni,5,77,98903,31437038445,763930483,32200968928
2019-12-09,LG4,Others(HKUST),5,34,150638,46076711942,7733117657,53809829599
2019-12-09,LG4,Non-HKUST,21,65,174734,13780123138,744608214,14524731352
2019-12-09,LG4,Total,517,2984,6738515,1141057286049,90220496852,1231277782901
2019-12-09,All-Floors,Staff,289,2151,3195328,184870055573,22758389786,207628445359
2019-12-09,All-Floors,TPG,309,4037,9257049,852912041238,82833693079,935745734317
2019-12-09,All-Floors,RPG,247,1618,3082696,354596799580,64068399575,418665199155
2019-12-09,All-Floors,UG,853,10230,22446529,3113464121830,298889957948,3412354079778
2019-12-09,All-Floors,Alumni,13,159,261881,50732777943,4830184282,55562962225
2019-12-09,All-Floors,Others(HKUST),14,159,694411,51852617733,8259828590,60112446323
2019-12-09,All-Floors,Non-HKUST,75,545,1227326,110445239398,15885907923,126331147321
2019-12-09,All-Floors,Total,1800,18899,40165220,4718873653295,497526361183,5216400014478
2019-12-10,1,Staff,75,686,1480516,134296452235,9732615210,144029067445
2019-12-10,1,TPG,63,416,1917209,89566912046,7873672284,97440584330
2019-12-10,1,RPG,37,170,681239,27782373713,2098483763,29880857476
2019-12-10,1,UG,120,878,3318629,216721640274,30603479904,247325120178
2019-12-10,1,Alumni,3,6,20650,6094124272,208754943,6302879215
2019-12-10,1,Others(HKUST),6,51,319401,832705076,104301791,937006867
2019-12-10,1,Non-HKUST,15,59,267130,13485616773,1807770218,15293386991
2019-12-10,1,Total,319,2266,8004774,488779824389,52429078113,541208902502
2019-12-10,G,Staff,133,523,960926,63034196558,11680618489,74714815047
2019-12-10,G,TPG,240,1124,2080378,358463563438,30419873222,388883436660
2019-12-10,G,RPG,138,413,558258,87963391287,9835452845,97798844132
2019-12-10,G,UG,566,1859,2889191,545516611268,57013142918,602529754186
2019-12-10,G,Alumni,7,34,29697,5937123084,450350797,6387473881
2019-12-10,G,Others(HKUST),6,18,127741,997146613,77911352,1075057965
2019-12-10,G,Non-HKUST,41,141,249928,21212557072,53219463015,74432020087
2019-12-10,G,Total,1131,4112,6896119,1083124589320,162696812638,1245821401958
2019-12-10,LG1,Staff,72,238,274277,14058321151,1138759321,15197080472
2019-12-10,LG1,TPG,170,1230,3585584,337167479884,35011980655,372179460539
2019-12-10,LG1,RPG,87,391,924732,78067893133,7889730164,85957623297
2019-12-10,LG1,UG,467,3057,9185957,796805292741,134257274263,931062567004
2019-12-10,LG1,Alumni,3,4,11698,555143980,27176205,582320185
2019-12-10,LG1,Others(HKUST),8,38,315126,493790875,107281452,601072327
2019-12-10,LG1,Non-HKUST,28,140,357766,42180999423,39159351584,81340351007
2019-12-10,LG1,Total,835,5098,14655140,1269328921187,217591553644,1486920474831
2019-12-10,LG3,Staff,92,238,322997,44615708746,3126877725,47742586471
2019-12-10,LG3,TPG,104,526,1954210,253309382605,20246388482,273555771087
2019-12-10,LG3,RPG,129,449,839397,152606552821,13296097784,165902650605
2019-12-10,LG3,UG,249,954,1951161,889690679868,57171762889,946862442757
2019-12-10,LG3,Alumni,4,4,0,2868959773,146207231,3015167004
2019-12-10,LG3,Others(HKUST),5,6,3967,351476363,29557322,381033685
2019-12-10,LG3,Non-HKUST,24,73,218211,34192471531,2101522350,36293993881
2019-12-10,LG3,Total,607,2250,5289943,1377635231707,96118413783,1473753645490
2019-12-10,LG4,Staff,73,157,77801,35599247618,1307356077,36906603695
2019-12-10,LG4,TPG,94,623,2007575,205358827150,16456684415,221815511565
2019-12-10,LG4,RPG,102,263,622163,113888030226,7526636393,121414666619
2019-12-10,LG4,UG,316,1987,6018412,840833693082,68325743031,909159436113
2019-12-10,LG4,Alumni,7,86,179207,15409456209,1110552315,16520008524
2019-12-10,LG4,Others(HKUST),6,16,94848,1232160970,1459134251,2691295221
2019-12-10,LG4,Non-HKUST,17,30,62085,6948274961,577866014,7526140975
2019-12-10,LG4,Total,615,3162,9062091,1219269690216,96763972496,1316033662712
2019-12-10,All-Floors,Staff,280,1842,3116517,291603926308,26986226822,318590153130
2019-12-10,All-Floors,TPG,323,3919,11544956,1243866165123,110008599058,1353874764181
2019-12-10,All-Floors,RPG,329,1686,3625789,460308241180,40646400949,500954642129
2019-12-10,All-Floors,UG,904,8735,23363350,3289567917233,347371403005,3636939320238
2019-12-10,All-Floors,Alumni,15,134,241252,30864807318,1943041491,32807848809
2019-12-10,All-Floors,Others(HKUST),18,129,861083,3907279897,1778186168,5685466065
2019-12-10,All-Floors,Non-HKUST,77,443,1155120,118019919760,96865973181,214885892941
2019-12-10,All-Floors,Total,1946,16888,43908067,5438138256819,625599830674,6063738087493
2019-12-11,1,Staff,69,649,1407598,54351606118,9591307521,63942913639
2019-12-11,1,TPG,51,338,1486840,147899616955,12153175474,160052792429
2019-12-11,1,RPG,36,181,711743,53289953219,3251427604,56541380823
2019-12-11,1,UG,112,726,2636397,286046892988,23831743007,309878635995
2019-12-11,1,Alumni,2,7,55969,679275182,60988145,740263327
2019-12-11,1,Others(HKUST),4,52,373502,3900174845,174160447,4074335292
2019-12-11,1,Non-HKUST,20,90,295171,26343791241,15213527793,41557319034
2019-12-11,1,Total,294,2043,6967220,572511310548,64276329991,636787640539
2019-12-11,G,Staff,137,546,981614,37116119482,5988124802,43104244284
2019-12-11,G,TPG,231,893,1600842,348947683495,24029588991,372977272486
2019-12-11,G,RPG,135,466,755351,91461832063,8113830937,99575663000
2019-12-11,G,UG,501,1708,2507206,491299471170,43179968892,534479440062
2019-12-11,G,Alumni,5,19,20562,2421507192,234867656,2656374848
2019-12-11,G,Others(HKUST),9,41,242041,2224625764,242782566,2467408330
2019-12-11,G,Non-HKUST,57,207,442636,38763427484,2876610567,41640038051
2019-12-11,G,Total,1075,3880,6550252,1012234666650,84665774411,1096900441061
2019-12-11,LG1,Staff,55,220,282764,21422173615,2130931603,23553105218
2019-12-11,LG1,TPG,165,1359,4030492,431684566785,35357244474,467041811259
2019-12-11,LG1,RPG,89,323,753035,64059402763,8360978115,72420380878
2019-12-11,LG1,UG,403,2405,6756572,780967028210,100446500905,881413529115
2019-12-11,LG1,Alumni,1,1,0,3033908,814809,3848717
2019-12-11,LG1,Others(HKUST),5,92,451136,1343105770,245589320,1588695090
2019-12-11,LG1,Non-HKUST,33,146,373900,51234417823,26532577353,77766995176
2019-12-11,LG1,Total,751,4546,12647899,1350713728874,173074636579,1523788365453
2019-12-11,LG3,Staff,83,223,380768,73352869675,4802661433,78155531108
2019-12-11,LG3,TPG,83,498,1704025,346072318863,19700356479,365772675342
2019-12-11,LG3,RPG,118,443,845352,175627361776,12260299995,187887661771
2019-12-11,LG3,UG,237,1066,2436786,537690403426,33285077782,570975481208
2019-12-11,LG3,Alumni,1,6,34180,1279466396,59808240,1339274636
2019-12-11,LG3,Others(HKUST),6,34,1628,284230663,96013888,380244551
2019-12-11,LG3,Non-HKUST,17,55,109265,36887838077,1796637874,38684475951
2019-12-11,LG3,Total,545,2325,5512004,1171194488876,72000855691,1243195344567
2019-12-11,LG4,Staff,70,147,34959,4669698726,582027276,5251726002
2019-12-11,LG4,TPG,77,438,1692272,193643802351,15248511523,208892313874
2019-12-11,LG4,RPG,90,303,666280,87343564499,5890694645,93234259144
2019-12-11,LG4,UG,280,1801,4526175,892729305749,61732208657,954461514406
2019-12-11,LG4,Alumni,5,94,110401,14798620059,1344621724,16143241783
2019-12-11,LG4,Others(HKUST),8,56,164935,3778261730,469651674,4247913404
2019-12-11,LG4,Non-HKUST,19,82,166978,16382172044,1397507831,17779679875
2019-12-11,LG4,Total,549,2921,7362000,1213345425158,86665223330,1300010648488
2019-12-11,All-Floors,Staff,270,1785,3087703,190912467616,23095052635,214007520251
2019-12-11,All-Floors,TPG,309,3526,10514471,1468247988449,106488876941,1574736865390
2019-12-11,All-Floors,RPG,300,1716,3731761,471782114320,37877231296,509659345616
2019-12-11,All-Floors,UG,810,7706,18863136,2988733101543,262475499243,3251208600786
2019-12-11,All-Floors,Alumni,9,127,221112,19181902737,1701100574,20883003311
2019-12-11,All-Floors,Others(HKUST),16,275,1233242,11530398772,1228197895,12758596667
2019-12-11,All-Floors,Non-HKUST,89,580,1387950,169611646669,47816861418,217428508087
2019-12-11,All-Floors,Total,1803,15715,39039375,5319999620106,480682820002,5800682440108
2019-12-12,1,Staff,67,652,1386966,64546793757,7940121132,72486914889
2019-12-12,1,TPG,56,396,1552603,98572666251,9568734351,108141400602
2019-12-12,1,RPG,22,160,634010,37918396043,2017104090,39935500133
2019-12-12,1,UG,93,599,2279164,254007415174,19134053484,273141468658
2019-12-12,1,Alumni,3,12,63059,12405548660,636126271,13041674931
2019-12-12,1,Others(HKUST),5,49,406868,2753963649,206412064,2960375713
2019-12-12,1,Non-HKUST,17,66,233301,19978293077,1055246845,21033539922
2019-12-12,1,Total,263,1934,6555971,490183076611,40557798237,530740874848
2019-12-12,G,Staff,139,499,965052,66457192078,7945959792,74403151870
2019-12-12,G,TPG,263,1199,1981370,357867535250,38937023443,396804558693
2019-12-12,G,RPG,113,382,607514,81953807095,5179392142,87133199237
2019-12-12,G,UG,425,1508,2461540,395672474314,40772430949,436444905263
2019-12-12,G,Alumni,9,22,47200,40722334870,1348303865,42070638735
2019-12-12,G,Others(HKUST),8,31,283663,2612235376,222879813,2835115189
2019-12-12,G,Non-HKUST,39,116,219930,26395345460,1797367110,28192712570
2019-12-12,G,Total,996,3757,6566269,971680924443,96203357114,1067884281557
2019-12-12,LG1,Staff,61,208,285986,12687765589,3439510563,16127276152
2019-12-12,LG1,TPG,183,1664,4879231,756341009310,52799805372,809140814682
2019-12-12,LG1,RPG,69,316,814497,68747604314,11810831311,80558435625
2019-12-12,LG1,UG,307,2011,5831294,678975458938,77381858013,756357316951
2019-12-12,LG1,Alumni,5,17,16918,43140460327,1462707831,44603168158
2019-12-12,LG1,Others(HKUST),7,87,477435,2837482558,370940713,3208423271
2019-12-12,LG1,Non-HKUST,39,184,572377,67463951349,36548427443,104012378792
2019-12-12,LG1,Total,671,4487,12877738,1630193732385,183814081246,1814007813631
2019-12-12,LG3,Staff,90,234,245348,17132261860,1200105909,18332367769
2019-12-12,LG3,TPG,113,560,1831329,226491374766,21976715206,248468089972
2019-12-12,LG3,RPG,98,269,669354,68211512636,3778265453,71989778089
2019-12-12,LG3,UG,174,711,1496854,367634322572,24010880479,391645203051
2019-12-12,LG3,Alumni,5,26,35027,63321639445,2680031167,66001670612
2019-12-12,LG3,Others(HKUST),8,45,18415,1300545892,246936458,1547482350
2019-12-12,LG3,Non-HKUST,22,57,139046,14671867220,783842722,15455709942
2019-12-12,LG3,Total,510,1902,4435373,758763524391,54676777394,813440301785
2019-12-12,LG4,Staff,72,155,50549,11149088689,1029590269,12178678958
2019-12-12,LG4,TPG,101,557,2082747,163259738546,21010203623,184269942169
2019-12-12,LG4,RPG,105,272,473682,51580188347,4267872979,55848061326
2019-12-12,LG4,UG,250,1511,3773700,712875641102,80648028136,793523669238
2019-12-12,LG4,Alumni,6,65,100118,14735829804,514061752,15249891556
2019-12-12,LG4,Others(HKUST),6,32,181995,2699837375,299999030,2999836405
2019-12-12,LG4,Non-HKUST,17,78,165619,17997625482,987177672,18984803154
2019-12-12,LG4,Total,557,2670,6828410,974297949345,108756933461,1083054882806
2019-12-12,All-Floors,Staff,280,1748,2933901,171973101973,21555287665,193528389638
2019-12-12,All-Floors,TPG,349,4376,12327280,1602532324123,144292481995,1746824806118
2019-12-12,All-Floors,RPG,288,1399,3199057,308411508435,27053465975,335464974410
2019-12-12,All-Floors,UG,683,6340,15842552,2409165312100,241947251061,2651112563161
2019-12-12,All-Floors,Alumni,17,142,262322,174325813106,6641230886,180967043992
2019-12-12,All-Floors,Others(HKUST),18,244,1368376,12204064850,1347168078,13551232928
2019-12-12,All-Floors,Non-HKUST,82,501,1330273,146507082588,41172061792,187679144380
2019-12-12,All-Floors,Total,1717,14750,37263761,4825119207175,484008947452,5309128154627
2019-12-13,1,Staff,64,599,1337662,36377377672,7725786518,44103164190
2019-12-13,1,TPG,57,447,1640313,87013704425,12100324631,99114029056
2019-12-13,1,RPG,31,169,706907,29579140865,7136837628,36715978493
2019-12-13,1,UG,94,745,2294312,163068903154,21176749583,184245652737
2019-12-13,1,Alumni,1,7,24834,1143722028,9446436720,10590158748
2019-12-13,1,Others(HKUST),5,40,354582,1032857040,99801629,1132658669
2019-12-13,1,Non-HKUST,14,65,224712,13346315607,704013668,14050329275
2019-12-13,1,Total,266,2072,6583322,331562020791,58389950377,389951971168
2019-12-13,G,Staff,141,471,803592,48094217175,6683994548,54778211723
2019-12-13,G,TPG,253,946,1561617,254031403352,41678785953,295710189305
2019-12-13,G,RPG,101,331,504825,52096133445,7568786910,59664920355
2019-12-13,G,UG,448,1523,2336350,373861174221,37352056153,411213230374
2019-12-13,G,Alumni,10,22,23016,5279115287,265112286,5544227573
2019-12-13,G,Others(HKUST),10,44,289975,3676347424,279906038,3956253462
2019-12-13,G,Non-HKUST,43,187,349863,51411712765,3668801598,55080514363
2019-12-13,G,Total,1006,3524,5869238,788450103669,97497443486,885947547155
2019-12-13,LG1,Staff,67,219,255294,18769172349,9926050401,28695222750
2019-12-13,LG1,TPG,169,1346,3775679,323349291735,45918765856,369268057591
2019-12-13,LG1,RPG,69,294,841618,61285012652,18982086391,80267099043
2019-12-13,LG1,UG,390,2468,7330209,599028965960,100959611969,699988577929
2019-12-13,LG1,Alumni,3,60,23397,199560765327,6265779305,205826544632
2019-12-13,LG1,Others(HKUST),6,104,497721,10021835641,890221412,10912057053
2019-12-13,LG1,Non-HKUST,30,149,462191,40383575430,2570935661,42954511091
2019-12-13,LG1,Total,734,4640,13186109,1252398619094,185513450995,1437912070089
2019-12-13,LG3,Staff,94,248,292814,32470319529,5628851497,38099171026
2019-12-13,LG3,TPG,107,587,1830313,420649646493,104129949173,524779595666
2019-12-13,LG3,RPG,126,413,715968,123779229526,13672088767,137451318293
2019-12-13,LG3,UG,230,1135,2500586,419305426994,29629702867,448935129861
2019-12-13,LG3,Alumni,8,79,94642,223607134029,8640879696,232248013725
2019-12-13,LG3,Others(HKUST),6,34,180,604547785,64797428,669345213
2019-12-13,LG3,Non-HKUST,27,104,215661,110108546790,3094126176,113202672966
2019-12-13,LG3,Total,598,2600,5650164,1330524851146,164860395604,1495385246750
2019-12-13,LG4,Staff,87,226,197742,10321865976,3772806350,14094672326
2019-12-13,LG4,TPG,100,656,2020276,324033500983,69540607509,393574108492
2019-12-13,LG4,RPG,80,192,433906,49686228919,2884757018,52570985937
2019-12-13,LG4,UG,229,1393,3213003,504331095349,85538734909,589869830258
2019-12-13,LG4,Alumni,6,78,112382,124252710246,4829663543,129082373789
2019-12-13,LG4,Others(HKUST),7,46,198142,5426652599,284701975,5711354574
2019-12-13,LG4,Non-HKUST,21,74,170084,31056189765,1526236890,32582426655
2019-12-13,LG4,Total,530,2665,6345535,1049108243837,168377508194,1217485752031
2019-12-13,All-Floors,Staff,279,1763,2887104,146032952701,33737489314,179770442015
2019-12-13,All-Floors,TPG,316,3982,10828198,1409077546988,273368433122,1682445980110
2019-12-13,All-Floors,RPG,283,1399,3203224,316425745407,50244556714,366670302121
2019-12-13,All-Floors,UG,732,7264,17674460,2059595565678,274656855481,2334252421159
2019-12-13,All-Floors,Alumni,16,246,278271,553843446917,29447871550,583291318467
2019-12-13,All-Floors,Others(HKUST),21,268,1340600,20762240489,1619428482,22381668971
2019-12-13,All-Floors,Non-HKUST,83,579,1422511,246306340357,11564113993,257870454350
2019-12-13,All-Floors,Total,1730,15501,37634368,4752043838537,674638748656,5426682587193
2019-12-14,1,Staff,14,72,362160,5629886716,843094231,6472980947
2019-12-14,1,TPG,40,278,1129373,75293286227,5430743347,80724029574
2019-12-14,1,RPG,20,50,191597,16879768262,1615814213,18495582475
2019-12-14,1,UG,39,185,715025,62957599894,10229094706,73186694600
2019-12-14,1,Alumni,1,6,18353,698389755,2808649153,3507038908
2019-12-14,1,Others(HKUST),1,27,332818,708533639,51669111,760202750
2019-12-14,1,Non-HKUST,12,65,190423,17074346174,925748138,18000094312
2019-12-14,1,Total,127,683,2939749,179241810667,21904812899,201146623566
2019-12-14,G,Staff,34,134,251099,12446356731,2014845523,14461202254
2019-12-14,G,TPG,169,569,1179741,157367763649,20542540044,177910303693
2019-12-14,G,RPG,60,169,219440,27124293438,1864069772,28988363210
2019-12-14,G,UG,174,569,1072308,124818504515,20065475901,144883980416
2019-12-14,G,Alumni,13,35,39953,7510080303,313053385,7823133688
2019-12-14,G,Others(HKUST),3,4,259197,964717131,81632219,1046349350
2019-12-14,G,Non-HKUST,19,32,95447,9705117194,10059871258,19764988452
2019-12-14,G,Total,472,1512,3117185,339936832961,54941488102,394878321063
2019-12-14,LG1,Staff,23,66,67488,9094247323,410526061,9504773384
2019-12-14,LG1,TPG,100,742,2014029,142271169456,20949131443,163220300899
2019-12-14,LG1,RPG,30,86,177452,14198448838,1252261420,15450710258
2019-12-14,LG1,UG,162,866,2686851,337494368868,31048358126,368542726994
2019-12-14,LG1,Alumni,8,19,19075,815755905,621449428,1437205333
2019-12-14,LG1,Others(HKUST),4,21,439565,1065766450,103517415,1169283865
2019-12-14,LG1,Non-HKUST,15,42,152940,25310051494,25970410676,51280462170
2019-12-14,LG1,Total,342,1842,5557400,530249808334,80355654569,610605462903
2019-12-14,LG3,Staff,31,86,191163,16333590160,664535328,16998125488
2019-12-14,LG3,TPG,63,256,813249,128396338523,17756821566,146153160089
2019-12-14,LG3,RPG,49,97,221926,25294448214,1867801992,27162250206
2019-12-14,LG3,UG,75,218,496112,136023893152,16494493410,152518386562
2019-12-14,LG3,Alumni,9,15,8451,770465778,92985298,863451076
2019-12-14,LG3,Others(HKUST),4,5,180,22543168,2039294,24582462
2019-12-14,LG3,Non-HKUST,4,14,24872,3737089265,205901740,3942991005
2019-12-14,LG3,Total,235,691,1755953,310578368260,37084578628,347662946888
2019-12-14,LG4,Staff,16,54,22865,5795904874,701632617,6497537491
2019-12-14,LG4,TPG,63,302,1000097,235906345604,13844012042,249750357646
2019-12-14,LG4,RPG,45,86,188244,19827017137,1312338194,21139355331
2019-12-14,LG4,UG,106,564,1175411,339494726821,35139894288,374634621109
2019-12-14,LG4,Alumni,9,25,63692,7587122245,326543191,7913665436
2019-12-14,LG4,Others(HKUST),5,22,210824,8518869515,555707950,9074577465
2019-12-14,LG4,Non-HKUST,6,14,33650,6269172807,254709113,6523881920
2019-12-14,LG4,Total,250,1067,2694783,623399159003,52134837395,675533996398
2019-12-14,All-Floors,Staff,78,412,894775,49299985804,4634633760,53934619564
2019-12-14,All-Floors,TPG,243,2147,6136489,739234903459,78523248442,817758151901
2019-12-14,All-Floors,RPG,151,488,998659,103323975889,7912285591,111236261480
2019-12-14,All-Floors,UG,355,2402,6145707,1000789093250,112977316431,1113766409681
2019-12-14,All-Floors,Alumni,23,100,149524,17381813986,4162680455,21544494441
2019-12-14,All-Floors,Others(HKUST),10,79,1242584,11280429903,794565989,12074995892
2019-12-14,All-Floors,Non-HKUST,42,167,497332,62095776934,37416640925,99512417859
2019-12-14,All-Floors,Total,902,5795,16065070,1983405979225,246421371593,2229827350818
2019-12-15,1,Staff,9,71,344005,2635366398,351168536,2986534934
2019-12-15,1,TPG,34,192,841597,32945391002,4056389282,37001780284
2019-12-15,1,RPG,15,34,175318,5685273953,724883155,6410157108
2019-12-15,1,UG,40,212,892408,66243669921,4626710855,70870380776
2019-12-15,1,Alumni,0,0,0,0,0,0
2019-12-15,1,Others(HKUST),2,30,333183,955088938,66820542,1021909480
2019-12-15,1,Non-HKUST,9,26,121471,5619876396,365849627,5985726023
2019-12-15,1,Total,109,565,2707982,114084666608,10191821997,124276488605
2019-12-15,G,Staff,26,77,229874,9925339760,832349064,10757688824
2019-12-15,G,TPG,135,497,955027,106633679504,9199544488,115833223992
2019-12-15,G,RPG,59,144,165076,28681982447,1447582166,30129564613
2019-12-15,G,UG,142,420,731524,117545193763,10091802150,127636995913
2019-12-15,G,Alumni,8,17,12782,4871741100,2326992395,7198733495
2019-12-15,G,Others(HKUST),3,8,259735,1150544185,99970872,1250515057
2019-12-15,G,Non-HKUST,20,43,83518,14393127955,1229784774,15622912729
2019-12-15,G,Total,393,1206,2437536,283201608714,25228025909,308429634623
2019-12-15,LG1,Staff,24,61,107830,4001449006,698496964,4699945970
2019-12-15,LG1,TPG,81,532,1652025,97067604507,11901009417,108968613924
2019-12-15,LG1,RPG,38,164,517886,34215584166,3556039452,37771623618
2019-12-15,LG1,UG,111,523,1490304,146346696147,14382400990,160729097137
2019-12-15,LG1,Alumni,3,4,360,2249124,1019120,3268244
2019-12-15,LG1,Others(HKUST),4,53,450535,4371823379,387484219,4759307598
2019-12-15,LG1,Non-HKUST,15,56,169198,31279390870,2590808394,33870199264
2019-12-15,LG1,Total,276,1393,4388138,317284797199,33517258556,350802055755
2019-12-15,LG3,Staff,21,46,128352,8163993189,679592305,8843585494
2019-12-15,LG3,TPG,53,232,759669,87198517028,8108511354,95307028382
2019-12-15,LG3,RPG,68,154,198202,32925155657,8053363963,40978519620
2019-12-15,LG3,UG,72,161,406123,63107008154,3292968794,66399976948
2019-12-15,LG3,Alumni,9,19,37633,8205750406,6632020744,14837771150
2019-12-15,LG3,Others(HKUST),3,15,180,1073967253,55929867,1129897120
2019-12-15,LG3,Non-HKUST,8,20,56722,10199208584,2209517028,12408725612
2019-12-15,LG3,Total,234,647,1586881,210873600271,29031904055,239905504326
2019-12-15,LG4,Staff,10,26,16205,3830251507,895345426,4725596933
2019-12-15,LG4,TPG,53,412,1150785,170469577513,20603934082,191073511595
2019-12-15,LG4,RPG,54,111,190453,29932171369,2048829793,31981001162
2019-12-15,LG4,UG,82,410,1009352,127521629360,16555977625,144077606985
2019-12-15,LG4,Alumni,7,29,103659,4674347117,211647617,4885994734
2019-12-15,LG4,Others(HKUST),3,17,176213,1218758193,94796596,1313554789
2019-12-15,LG4,Non-HKUST,6,35,99556,10855569692,546186280,11401755972
2019-12-15,LG4,Total,215,1040,2746223,348502304751,40956717419,389459022170
2019-12-15,All-Floors,Staff,62,281,826266,28556399860,3456952295,32013352155
2019-12-15,All-Floors,TPG,197,1865,5359103,494314769554,53869388623,548184158177
2019-12-15,All-Floors,RPG,166,607,1246935,131440167592,15830698529,147270866121
2019-12-15,All-Floors,UG,294,1726,4529711,520764197345,48949860414,569714057759
2019-12-15,All-Floors,Alumni,19,69,154434,17754087747,9171679876,26925767623
2019-12-15,All-Floors,Others(HKUST),8,123,1219846,8770181948,705002096,9475184044
2019-12-15,All-Floors,Non-HKUST,38,180,530465,72347173497,6942146103,79289319600
2019-12-15,All-Floors,Total,784,4851,13866760,1273946977543,138925727936,1412872705479
2019-12-16,1,Staff,57,509,1267186,87690155945,41694804149,129384960094
2019-12-16,1,TPG,53,565,1852350,94684564351,14347740130,109032304481
2019-12-16,1,RPG,25,155,598456,13004339092,1414342975,14418682067
2019-12-16,1,UG,90,695,2419751,216188114928,21350379465,237538494393
2019-12-16,1,Alumni,1,7,27915,2972501083,501911452,3474412535
2019-12-16,1,Others(HKUST),4,52,378255,3053503879,235467393,3288971272
2019-12-16,1,Non-HKUST,12,90,255360,14258511905,907234977,15165746882
2019-12-16,1,Total,242,2073,6799273,431851691183,80451880541,512303571724
2019-12-16,G,Staff,136,544,904065,66478358744,8889178087,75367536831
2019-12-16,G,TPG,296,1271,2035857,406999729136,70043437178,477043166314
2019-12-16,G,RPG,114,378,684211,63632590234,8169609779,71802200013
2019-12-16,G,UG,427,1267,1504834,282233922564,47107720716,329341643280
2019-12-16,G,Alumni,7,20,9197,1798195774,261047407,2059243181
2019-12-16,G,Others(HKUST),6,18,280995,2166797579,154793817,2321591396
2019-12-16,G,Non-HKUST,40,105,126907,13481495774,1362614139,14844109913
2019-12-16,G,Total,1026,3603,5546066,836791089805,135988401123,972779490928
2019-12-16,LG1,Staff,55,192,212434,18096715366,1357988283,19454703649
2019-12-16,LG1,TPG,191,1764,5072513,560514188675,75366982476,635881171151
2019-12-16,LG1,RPG,66,372,954622,73875495138,10115048071,83990543209
2019-12-16,LG1,UG,336,2161,6494640,605869591011,118352470152,724222061163
2019-12-16,LG1,Alumni,2,6,3764,423871733,112364124,536235857
2019-12-16,LG1,Others(HKUST),6,27,457054,1310831575,223560872,1534392447
2019-12-16,LG1,Non-HKUST,29,154,425909,32546380307,2680812636,35227192943
2019-12-16,LG1,Total,685,4676,13620936,1292637073805,208209226614,1500846300419
2019-12-16,LG3,Staff,95,279,304486,20632721286,1752747584,22385468870
2019-12-16,LG3,TPG,127,807,2499607,337475930065,40476703783,377952633848
2019-12-16,LG3,RPG,114,334,554590,71346209595,5972466719,77318676314
2019-12-16,LG3,UG,184,808,1885076,370410821092,37256238741,407667059833
2019-12-16,LG3,Alumni,4,26,56875,2821221290,731606786,3552828076
2019-12-16,LG3,Others(HKUST),10,27,2164,471415302,18911528,490326830
2019-12-16,LG3,Non-HKUST,24,83,138350,18122912867,1274908401,19397821268
2019-12-16,LG3,Total,558,2364,5441148,821281231497,87483583542,908764815039
2019-12-16,LG4,Staff,75,371,114961,24685683433,5365515046,30051198479
2019-12-16,LG4,TPG,115,950,2815213,322722750723,41161050895,363883801618
2019-12-16,LG4,RPG,87,276,644043,60763647052,3526975882,64290622934
2019-12-16,LG4,UG,237,1498,3335318,492882121714,92852226877,585734348591
2019-12-16,LG4,Alumni,6,47,95856,9347488076,1552532580,10900020656
2019-12-16,LG4,Others(HKUST),7,33,231675,3570506985,394444247,3964951232
2019-12-16,LG4,Non-HKUST,18,86,213487,23397582495,1559714556,24957297051
2019-12-16,LG4,Total,545,3261,7450553,937369780478,146412460083,1083782240561
2019-12-16,All-Floors,Staff,253,1895,2803132,217583634774,59060233149,276643867923
2019-12-16,All-Floors,TPG,360,5357,14275540,1722397162950,241395914462,1963793077412
2019-12-16,All-Floors,RPG,274,1515,3435922,282622281111,29198443426,311820724537
2019-12-16,All-Floors,UG,689,6429,15639619,1967584571309,316919035951,2284503607260
2019-12-16,All-Floors,Alumni,11,106,193607,17363277956,3159462349,20522740305
2019-12-16,All-Floors,Others(HKUST),20,157,1350143,10573055320,1027177857,11600233177
2019-12-16,All-Floors,Non-HKUST,72,518,1160013,101806883348,7785284709,109592168057
2019-12-16,All-Floors,Total,1679,15977,38857976,4319930866768,658545551903,4978476418671
2019-12-17,1,Staff,62,516,1378200,42871429622,9040805867,51912235489
2019-12-17,1,TPG,62,564,2005650,146235085166,14025810703,160260895869
2019-12-17,1,RPG,35,198,706456,29266458883,3282138312,32548597195
2019-12-17,1,UG,99,960,2858999,247693421327,39316419387,287009840714
2019-12-17,1,Alumni,2,8,59579,5084826220,193829893,5278656113
2019-12-17,1,Others(HKUST),4,61,356130,2351120502,200110512,2551231014
2019-12-17,1,Non-HKUST,13,112,322201,17244144171,2369361169,19613505340
2019-12-17,1,Total,277,2419,7687215,490746485891,68428475843,559174961734
2019-12-17,G,Staff,125,553,907375,57668899006,6030493939,63699392945
2019-12-17,G,TPG,280,1211,1980376,315720860940,52172534152,367893395092
2019-12-17,G,RPG,124,525,915727,118641149244,23515270954,142156420198
2019-12-17,G,UG,416,1247,1530845,317596487242,38103330613,355699817855
2019-12-17,G,Alumni,12,20,14531,6424396988,321857488,6746254476
2019-12-17,G,Others(HKUST),5,15,268949,1709555795,146833327,1856389122
2019-12-17,G,Non-HKUST,37,105,125024,18182958448,12381518460,30564476908
2019-12-17,G,Total,999,3676,5742827,835944307663,132671838933,968616146596
2019-12-17,LG1,Staff,55,193,228610,19034801509,1329274606,20364076115
2019-12-17,LG1,TPG,187,1583,4398231,422552141230,84556642116,507108783346
2019-12-17,LG1,RPG,57,270,631079,106829587727,20586923873,127416511600
2019-12-17,LG1,UG,343,2191,6161653,723323278939,85503711051,808826989990
2019-12-17,LG1,Alumni,2,6,10799,965568524,173950238,1139518762
2019-12-17,LG1,Others(HKUST),5,42,471616,4498674374,599281071,5097955445
2019-12-17,LG1,Non-HKUST,22,116,286450,23797590597,25917357599,49714948196
2019-12-17,LG1,Total,671,4401,12188438,1301001642900,218667140554,1519668783454
2019-12-17,LG3,Staff,91,275,363480,36471955236,8885146891,45357102127
2019-12-17,LG3,TPG,97,674,1981293,363587009933,49607528924,413194538857
2019-12-17,LG3,RPG,92,338,560545,100517834361,5527533162,106045367523
2019-12-17,LG3,UG,222,1201,2686101,499930372582,56443704089,556374076671
2019-12-17,LG3,Alumni,2,20,56238,2269629089,549492318,2819121407
2019-12-17,LG3,Others(HKUST),3,6,13141,4780748940,144173347,4924922287
2019-12-17,LG3,Non-HKUST,17,102,233723,31050686915,2513194187,33563881102
2019-12-17,LG3,Total,524,2616,5894521,1038608237056,123670772918,1162279009974
2019-12-17,LG4,Staff,60,278,110197,21471606040,2844975251,24316581291
2019-12-17,LG4,TPG,112,795,2507133,278269469668,38145337662,316414807330
2019-12-17,LG4,RPG,87,231,580069,45940499969,8572346708,54512846677
2019-12-17,LG4,UG,193,1120,2839906,413000560719,48729441089,461730001808
2019-12-17,LG4,Alumni,5,21,67661,23837114051,983016882,24820130933
2019-12-17,LG4,Others(HKUST),7,19,184128,6782514468,247624512,7030138980
2019-12-17,LG4,Non-HKUST,17,103,271830,26488125813,7911591377,34399717190
2019-12-17,LG4,Total,481,2567,6560924,815789890728,107434333481,923224224209
2019-12-17,All-Floors,Staff,248,1815,2987862,177518691413,28130696554,205649387967
2019-12-17,All-Floors,TPG,345,4827,12872683,1526364566937,238507853557,1764872420494
2019-12-17,All-Floors,RPG,261,1562,3393876,401195530184,61484213009,462679743193
2019-12-17,All-Floors,UG,685,6719,16077504,2201544120809,268096606229,2469640727038
2019-12-17,All-Floors,Alumni,14,75,208808,38581534872,2222146819,40803681691
2019-12-17,All-Floors,Others(HKUST),14,143,1293964,20122614079,1338022769,21460636848
2019-12-17,All-Floors,Non-HKUST,64,538,1239228,116763505944,51093022792,167856528736
2019-12-17,All-Floors,Total,1631,15679,38073925,4482090564238,650872561729,5132963125967
2019-12-18,1,Staff,63,472,1035368,45151753759,5283872367,50435626126
2019-12-18,1,TPG,63,558,2049172,136384048525,13092724034,149476772559
2019-12-18,1,RPG,21,134,539282,31261434277,2005853255,33267287532
2019-12-18,1,UG,75,408,1185861,115955151983,10909905038,126865057021
2019-12-18,1,Alumni,2,9,60804,4666248577,135426694,4801675271
2019-12-18,1,Others(HKUST),5,43,382991,1984815739,180584302,2165400041
2019-12-18,1,Non-HKUST,12,103,250411,10031417137,1661742774,11693159911
2019-12-18,1,Total,241,1727,5503889,345434869997,33270108464,378704978461
2019-12-18,G,Staff,132,533,1167210,88863567878,7164478024,96028045902
2019-12-18,G,TPG,248,953,1457135,261628538245,21871306116,283499844361
2019-12-18,G,RPG,157,505,844606,73176180517,10619971575,83796152092
2019-12-18,G,UG,390,1137,1585882,255393975184,24979068900,280373044084
2019-12-18,G,Alumni,9,32,92220,5697015255,2358257892,8055273147
2019-12-18,G,Others(HKUST),7,28,285138,1843072058,167835380,2010907438
2019-12-18,G,Non-HKUST,44,137,186382,20391097689,7241593131,27632690820
2019-12-18,G,Total,987,3325,5618573,706993446826,74402511018,781395957844
2019-12-18,LG1,Staff,64,200,211651,21459806334,1586893205,23046699539
2019-12-18,LG1,TPG,180,1580,4362692,653364272390,42260357264,695624629654
2019-12-18,LG1,RPG,69,368,863114,62780819123,4219395807,67000214930
2019-12-18,LG1,UG,378,2096,6970331,382596866405,70358080321,452954946726
2019-12-18,LG1,Alumni,2,14,19452,517242278,52319730,569562008
2019-12-18,LG1,Others(HKUST),6,91,480619,4377468637,341910728,4719379365
2019-12-18,LG1,Non-HKUST,31,196,407784,42912604634,8940734936,51853339570
2019-12-18,LG1,Total,730,4545,13315643,1168009079801,127759691991,1295768771792
2019-12-18,LG3,Staff,112,265,293951,18816509971,1870171152,20686681123
2019-12-18,LG3,TPG,104,573,1713404,318638689797,21427838274,340066528071
2019-12-18,LG3,RPG,116,330,794532,89344633974,6614391509,95959025483
2019-12-18,LG3,UG,176,705,1381278,326839425711,21346458998,348185884709
2019-12-18,LG3,Alumni,3,28,68689,13688988664,7914683446,21603672110
2019-12-18,LG3,Others(HKUST),9,35,9703,471887718,44045556,515933274
2019-12-18,LG3,Non-HKUST,22,64,150111,14383728259,3496564447,17880292706
2019-12-18,LG3,Total,542,2000,4411668,782183864094,62714153382,844898017476
2019-12-18,LG4,Staff,82,287,178003,27117274818,2856355845,29973630663
2019-12-18,LG4,TPG,110,842,2481254,374064279440,47453837750,421518117190
2019-12-18,LG4,RPG,83,259,581925,60395214907,8948814290,69344029197
2019-12-18,LG4,UG,211,1095,2306288,370985944820,34924273639,405910218459
2019-12-18,LG4,Alumni,4,17,46857,6922228911,230574955,7152803866
2019-12-18,LG4,Others(HKUST),7,44,222289,3442764211,407880280,3850644491
2019-12-18,LG4,Non-HKUST,18,60,116966,12983084403,695791845,13678876248
2019-12-18,LG4,Total,515,2604,5933582,855910791510,95517528604,951428320114
2019-12-18,All-Floors,Staff,292,1757,2886183,201408912760,18761770593,220170683353
2019-12-18,All-Floors,TPG,337,4506,12063657,1744079828397,146106063438,1890185891835
2019-12-18,All-Floors,RPG,291,1596,3623459,316958282798,32408426436,349366709234
2019-12-18,All-Floors,UG,697,5441,13429640,1451771364103,162517786896,1614289150999
2019-12-18,All-Floors,Alumni,15,100,288022,31491723685,10691262717,42182986402
2019-12-18,All-Floors,Others(HKUST),20,241,1380740,12120008363,1142256246,13262264609
2019-12-18,All-Floors,Non-HKUST,71,560,1111654,100701932122,22036427133,122738359255
2019-12-18,All-Floors,Total,1723,14201,34783355,3858532052228,393663993459,4252196045687
2019-12-19,1,Staff,65,643,1323574,99633282653,409070314469,508703597122
2019-12-19,1,TPG,54,428,1569140,179992670509,12600854026,192593524535
2019-12-19,1,RPG,32,247,668590,39610923504,7092141890,46703065394
2019-12-19,1,UG,54,438,1076099,77870068678,14969234484,92839303162
2019-12-19,1,Alumni,2,14,58833,12706950275,2243006097,14949956372
2019-12-19,1,Others(HKUST),5,47,405568,3242929603,1243447276,4486376879
2019-12-19,1,Non-HKUST,8,57,143880,14278142026,1154372831,15432514857
2019-12-19,1,Total,220,1874,5245684,427334967248,448373371073,875708338321
2019-12-19,G,Staff,130,595,1145474,69147868746,88275352946,157423221692
2019-12-19,G,TPG,220,930,1712030,316924619082,38529749580,355454368662
2019-12-19,G,RPG,119,316,521099,69559609129,9963791445,79523400574
2019-12-19,G,UG,250,885,1274826,159921663473,15319543411,175241206884
2019-12-19,G,Alumni,8,38,98957,16163640478,999413638,17163054116
2019-12-19,G,Others(HKUST),8,20,294163,4787106752,805010024,5592116776
2019-12-19,G,Non-HKUST,25,72,74036,6296833027,1033126304,7329959331
2019-12-19,G,Total,760,2856,5120585,642801340687,154925987348,797727328035
2019-12-19,LG1,Staff,64,204,197356,26219675605,6097623431,32317299036
2019-12-19,LG1,TPG,155,1102,3372450,382944527928,37882534487,420827062415
2019-12-19,LG1,RPG,66,302,829506,52979884342,8340827150,61320711492
2019-12-19,LG1,UG,204,1271,3535568,380533692121,33259375196,413793067317
2019-12-19,LG1,Alumni,3,6,23213,215405620,30204726,245610346
2019-12-19,LG1,Others(HKUST),7,37,448757,2834119110,296602694,3130721804
2019-12-19,LG1,Non-HKUST,22,121,291746,19917413463,2736006455,22653419918
2019-12-19,LG1,Total,521,3043,8698596,865644718189,88643174139,954287892328
2019-12-19,LG3,Staff,78,197,196166,13250532550,5169643053,18420175603
2019-12-19,LG3,TPG,104,619,1660217,362730526647,54656071672,417386598319
2019-12-19,LG3,RPG,109,293,590067,52536574961,6727852457,59264427418
2019-12-19,LG3,UG,120,441,1004127,164945301675,9503423925,174448725600
2019-12-19,LG3,Alumni,2,46,75578,18295435874,940681107,19236116981
2019-12-19,LG3,Others(HKUST),5,7,0,145114992,45469099,190584091
2019-12-19,LG3,Non-HKUST,14,61,97947,20755909928,1287095276,22043005204
2019-12-19,LG3,Total,432,1664,3624102,632659396627,78330236589,710989633216
2019-12-19,LG4,Staff,73,222,166915,20300215705,1941661455,22241877160
2019-12-19,LG4,TPG,100,773,2350779,436560077666,69744871896,506304949562
2019-12-19,LG4,RPG,89,232,402322,48387650829,7093788062,55481438891
2019-12-19,LG4,UG,116,479,730376,253931918030,12201142818,266133060848
2019-12-19,LG4,Alumni,6,29,57094,7072044567,316681746,7388726313
2019-12-19,LG4,Others(HKUST),9,23,197277,1761372432,171106398,1932478830
2019-12-19,LG4,Non-HKUST,20,72,142875,11147678068,7062366051,18210044119
2019-12-19,LG4,Total,413,1830,4047638,779160957297,98531618426,877692575723
2019-12-19,All-Floors,Staff,249,1861,3029485,228551575259,510554595354,739106170613
2019-12-19,All-Floors,TPG,300,3852,10664616,1679152421832,213414081661,1892566503493
2019-12-19,All-Floors,RPG,273,1390,3011584,263074642765,39218401004,302293043769
2019-12-19,All-Floors,UG,442,3514,7620996,1037202643977,85252719834,1122455363811
2019-12-19,All-Floors,Alumni,14,133,313675,54453476814,4529987314,58983464128
2019-12-19,All-Floors,Others(HKUST),20,134,1345765,12770642889,2561635491,15332278380
2019-12-19,All-Floors,Non-HKUST,55,383,750484,72395976512,13272966917,85668943429
2019-12-19,All-Floors,Total,1353,11267,26736605,3347601380048,868804387575,4216405767623
2019-12-20,1,Staff,57,480,901758,49295540915,6296717460,55592258375
2019-12-20,1,TPG,38,311,614470,83902254908,4436323939,88338578847
2019-12-20,1,RPG,15,35,66845,17432685366,1061780501,18494465867
2019-12-20,1,UG,29,141,217637,36460457678,2450454489,38910912167
2019-12-20,1,Alumni,1,1,0,111056567,3776754,114833321
2019-12-20,1,Others(HKUST),4,47,249003,3771635024,295547823,4067182847
2019-12-20,1,Non-HKUST,4,23,66044,2328323270,164795687,2493118957
2019-12-20,1,Total,148,1038,2115757,193301953728,14709396653,208011350381
2019-12-20,G,Staff,120,549,908337,81400252077,8102073280,89502325357
2019-12-20,G,TPG,177,754,1298647,215202453104,30148587937,245351041041
2019-12-20,G,RPG,85,258,267417,35927333003,10192921631,46120254634
2019-12-20,G,UG,159,552,772264,112129870031,16960029280,129089899311
2019-12-20,G,Alumni,10,33,15308,6015394715,2916257324,8931652039
2019-12-20,G,Others(HKUST),9,46,331994,12125744474,713991137,12839735611
2019-12-20,G,Non-HKUST,25,71,114082,11515559406,764332875,12279892281
2019-12-20,G,Total,585,2263,3708049,474316606810,69798193464,544114800274
2019-12-20,LG1,Staff,68,273,391417,41935482861,3599776164,45535259025
2019-12-20,LG1,TPG,116,904,2715888,252373452595,20690937577,273064390172
2019-12-20,LG1,RPG,53,230,461875,29764722603,5381071663,35145794266
2019-12-20,LG1,UG,108,584,1856742,220343880514,25527169348,245871049862
2019-12-20,LG1,Alumni,7,33,68609,5976380175,3019070180,8995450355
2019-12-20,LG1,Others(HKUST),7,111,577709,39541538365,2198209397,41739747762
2019-12-20,LG1,Non-HKUST,17,83,214267,13042169441,777771062,13819940503
2019-12-20,LG1,Total,376,2218,6286507,602977626554,61194005391,664171631945
2019-12-20,LG3,Staff,68,272,270999,103052435470,4496267551,107548703021
2019-12-20,LG3,TPG,61,305,992456,428848008496,18643408087,447491416583
2019-12-20,LG3,RPG,100,205,294946,41329963402,2789030705,44118994107
2019-12-20,LG3,UG,107,346,524727,112632951405,6390785059,119023736464
2019-12-20,LG3,Alumni,6,44,94841,42669723059,27769218724,70438941783
2019-12-20,LG3,Others(HKUST),7,35,1086,5492022536,356435084,5848457620
2019-12-20,LG3,Non-HKUST,11,49,102041,23568252475,1170030970,24738283445
2019-12-20,LG3,Total,360,1256,2281096,757593356843,61615176180,819208533023
2019-12-20,LG4,Staff,65,221,132510,31306278813,1765594928,33071873741
2019-12-20,LG4,TPG,61,468,1138605,296211102300,21778478556,317989580856
2019-12-20,LG4,RPG,88,247,483765,93097110673,15887502808,108984613481
2019-12-20,LG4,UG,92,236,469767,60150801773,3853740102,64004541875
2019-12-20,LG4,Alumni,6,12,26622,1393895487,102273898,1496169385
2019-12-20,LG4,Others(HKUST),6,44,177654,9766048560,1239650129,11005698689
2019-12-20,LG4,Non-HKUST,18,48,116270,10463873304,461476300,10925349604
2019-12-20,LG4,Total,336,1276,2545193,502389110910,45088716721,547477827631
2019-12-20,All-Floors,Staff,221,1795,2605021,306989990136,24260429383,331250419519
2019-12-20,All-Floors,TPG,224,2742,6760066,1276537271403,95697736096,1372235007499
2019-12-20,All-Floors,RPG,234,975,1574848,217551815047,35312307308,252864122355
2019-12-20,All-Floors,UG,319,1859,3841137,541717961401,55182178278,596900139679
2019-12-20,All-Floors,Alumni,18,123,205380,56166450003,33810596880,89977046883
2019-12-20,All-Floors,Others(HKUST),19,283,1337446,70696988959,4803833570,75500822529
2019-12-20,All-Floors,Non-HKUST,49,274,612704,60918177896,3338406894,64256584790
2019-12-20,All-Floors,Total,1084,8051,16936602,2530578654845,252405488409,2782984143254
2019-12-21,1,Staff,10,19,175317,6493054692,619581903,7112636595
2019-12-21,1,TPG,14,64,293910,6740551067,803666504,7544217571
2019-12-21,1,RPG,6,16,43202,4701427329,355285085,5056712414
2019-12-21,1,UG,11,27,55623,16500701648,1055258157,17555959805
2019-12-21,1,Alumni,0,0,0,0,0,0
2019-12-21,1,Others(HKUST),2,4,172978,1308562702,120040829,1428603531
2019-12-21,1,Non-HKUST,2,2,18360,990615118,24121696,1014736814
2019-12-21,1,Total,45,132,759390,36734912556,2977954174,39712866730
2019-12-21,G,Staff,26,141,232718,14751075196,3004994268,17756069464
2019-12-21,G,TPG,84,191,262186,51437152643,11347480644,62784633287
2019-12-21,G,RPG,42,101,210035,23435907314,1190259773,24626167087
2019-12-21,G,UG,93,259,336903,56531196404,11105724537,67636920941
2019-12-21,G,Alumni,12,24,21234,2046278864,274847728,2321126592
2019-12-21,G,Others(HKUST),3,13,259378,2569883623,321177551,2891061174
2019-12-21,G,Non-HKUST,14,52,72002,8609785924,1231168064,9840953988
2019-12-21,G,Total,274,781,1394456,159381279968,28475652565,187856932533
2019-12-21,LG1,Staff,19,63,184869,9192158894,446290823,9638449717
2019-12-21,LG1,TPG,67,304,1087032,192448186260,13751438644,206199624904
2019-12-21,LG1,RPG,25,66,141840,7310026239,663489805,7973516044
2019-12-21,LG1,UG,77,282,814865,80154416654,4331217803,84485634457
2019-12-21,LG1,Alumni,6,29,51668,17189003568,558384228,17747387796
2019-12-21,LG1,Others(HKUST),4,52,611999,1570815834,501415052,2072230886
2019-12-21,LG1,Non-HKUST,6,33,50416,6693975069,391970985,7085946054
2019-12-21,LG1,Total,204,829,2942689,314558582518,20644207340,335202789858
2019-12-21,LG3,Staff,27,67,209506,22597021056,2626811497,25223832553
2019-12-21,LG3,TPG,51,213,595403,54210499309,9116371596,63326870905
2019-12-21,LG3,RPG,62,136,155146,39856203461,2142621183,41998824644
2019-12-21,LG3,UG,65,158,256276,49892491382,15364442019,65256933401
2019-12-21,LG3,Alumni,8,17,15114,4994948946,452217294,5447166240
2019-12-21,LG3,Others(HKUST),5,16,0,228255873,184896126,413151999
2019-12-21,LG3,Non-HKUST,7,45,43558,3731014840,196407656,3927422496
2019-12-21,LG3,Total,225,652,1275003,175510434867,30083767371,205594202238
2019-12-21,LG4,Staff,25,102,96503,15708300000,976331562,16684631562
2019-12-21,LG4,TPG,41,249,643593,102481075205,13134046587,115615121792
2019-12-21,LG4,RPG,44,85,161255,9674986913,1214709194,10889696107
2019-12-21,LG4,UG,61,186,411232,257186407320,8331435553,265517842873
2019-12-21,LG4,Alumni,10,25,70551,7953370657,638787158,8592157815
2019-12-21,LG4,Others(HKUST),5,28,179998,883474828,272050641,1155525469
2019-12-21,LG4,Non-HKUST,7,25,73781,32588980068,3341891460,35930871528
2019-12-21,LG4,Total,193,700,1636913,426476594991,27909252155,454385847146
2019-12-21,All-Floors,Staff,66,392,898913,68741609838,7674010053,76415619891
2019-12-21,All-Floors,TPG,135,1021,2882124,407317464484,48153003975,455470468459
2019-12-21,All-Floors,RPG,137,404,711478,84978551256,5566365040,90544916296
2019-12-21,All-Floors,UG,211,912,1874899,460265213408,40188078069,500453291477
2019-12-21,All-Floors,Alumni,19,95,158567,32183602035,1924236408,34107838443
2019-12-21,All-Floors,Others(HKUST),11,113,1224353,6560992860,1399580199,7960573059
2019-12-21,All-Floors,Non-HKUST,23,157,258117,52614371019,5185559861,57799930880
2019-12-21,All-Floors,Total,602,3094,8008451,1112661804900,110090833605,1222752638505
2019-12-22,1,Staff,4,12,187746,6004189073,417201663,6421390736
2019-12-22,1,TPG,7,47,104049,43999110690,1824297330,45823408020
2019-12-22,1,RPG,7,16,36189,1928385978,138048326,2066434304
2019-12-22,1,UG,6,33,59244,8235644991,318221552,8553866543
2019-12-22,1,Alumni,0,0,0,0,0,0
2019-12-22,1,Others(HKUST),2,6,172438,5808085014,215007886,6023092900
2019-12-22,1,Non-HKUST,1,1,0,876586,2654250,3530836
2019-12-22,1,Total,27,115,559666,65976292332,2915431007,68891723339
2019-12-22,G,Staff,22,101,278290,28426274854,2087805988,30514080842
2019-12-22,G,TPG,40,114,147465,28711717845,2592018393,31303736238
2019-12-22,G,RPG,35,58,76155,7070874677,1902446498,8973321175
2019-12-22,G,UG,43,116,200913,46413360004,4065126755,50478486759
2019-12-22,G,Alumni,6,14,4682,134501119,19238855,153739974
2019-12-22,G,Others(HKUST),5,16,270361,2905909183,240284476,3146193659
2019-12-22,G,Non-HKUST,6,18,45739,9683097427,332443276,10015540703
2019-12-22,G,Total,157,437,1023605,123345735109,11239364241,134585099350
2019-12-22,LG1,Staff,10,44,122594,2641768378,171244922,2813013300
2019-12-22,LG1,TPG,29,122,230970,30355336855,2029550750,32384887605
2019-12-22,LG1,RPG,18,39,73094,2423829221,148616370,2572445591
2019-12-22,LG1,UG,24,97,277621,31888254257,6617830286,38506084543
2019-12-22,LG1,Alumni,5,15,27546,905798022,84040895,989838917
2019-12-22,LG1,Others(HKUST),5,61,604433,3336126298,611671886,3947798184
2019-12-22,LG1,Non-HKUST,3,13,25564,2756195375,143796620,2899991995
2019-12-22,LG1,Total,94,391,1361822,74307308406,9806751729,84114060135
2019-12-22,LG3,Staff,27,58,149060,8060113659,339510092,8399623751
2019-12-22,LG3,TPG,24,88,177867,24213565521,2152024011,26365589532
2019-12-22,LG3,RPG,56,90,128901,11171531547,6500973697,17672505244
2019-12-22,LG3,UG,55,72,48425,7604617902,367322444,7971940346
2019-12-22,LG3,Alumni,5,7,4855,996242463,28326393,1024568856
2019-12-22,LG3,Others(HKUST),3,20,180,521190962,38279565,559470527
2019-12-22,LG3,Non-HKUST,4,5,7199,516461305,48766427,565227732
2019-12-22,LG3,Total,174,340,516487,53083723359,9475202629,62558925988
2019-12-22,LG4,Staff,18,27,180,1276431249,71816065,1348247314
2019-12-22,LG4,TPG,12,44,96672,9319761111,810335768,10130096879
2019-12-22,LG4,RPG,47,79,121875,7462227972,1950258531,9412486503
2019-12-22,LG4,UG,33,88,79036,11894034784,3129057563,15023092347
2019-12-22,LG4,Alumni,7,12,34383,2476772695,125742525,2602515220
2019-12-22,LG4,Others(HKUST),2,18,172977,1851097644,205021577,2056119221
2019-12-22,LG4,Non-HKUST,4,4,1260,8114281,858586,8972867
2019-12-22,LG4,Total,123,272,506383,34288439736,6293090615,40581530351
2019-12-22,All-Floors,Staff,62,242,737870,46408777213,3087578730,49496355943
2019-12-22,All-Floors,TPG,58,415,757023,136599492022,9408226252,146007718274
2019-12-22,All-Floors,RPG,129,282,436214,30056849395,10640343422,40697192817
2019-12-22,All-Floors,UG,121,406,665239,106035911938,14497558600,120533470538
2019-12-22,All-Floors,Alumni,15,48,71466,4513314299,257348668,4770662967
2019-12-22,All-Floors,Others(HKUST),10,121,1220389,14422409101,1310265390,15732674491
2019-12-22,All-Floors,Non-HKUST,13,41,79762,12964744974,528519159,13493264133
2019-12-22,All-Floors,Total,408,1555,3967963,351001498942,39729840221,390731339163
2019-12-23,1,Staff,48,430,710598,60979326686,4666551003,65645877689
2019-12-23,1,TPG,13,65,230605,23761295625,2973992237,26735287862
2019-12-23,1,RPG,20,79,200273,19269610376,1203981090,20473591466
2019-12-23,1,UG,27,121,282330,25906594831,6918261165,32824855996
2019-12-23,1,Alumni,1,1,0,70576637,7311519,77888156
2019-12-23,1,Others(HKUST),4,38,193687,5652957098,236104898,5889061996
2019-12-23,1,Non-HKUST,1,5,14624,1067550403,60821177,1128371580
2019-12-23,1,Total,114,739,1632117,136707911656,16067023089,152774934745
2019-12-23,G,Staff,109,435,662812,49874972878,12979737092,62854709970
2019-12-23,G,TPG,87,352,610489,125638442809,10877195210,136515638019
2019-12-23,G,RPG,89,319,425343,49137084920,13186266770,62323351690
2019-12-23,G,UG,118,364,441858,94480448458,10750328975,105230777433
2019-12-23,G,Alumni,12,45,105426,7370938156,825683998,8196622154
2019-12-23,G,Others(HKUST),10,36,252215,14524226526,429833076,14954059602
2019-12-23,G,Non-HKUST,10,34,42238,4575395706,247303607,4822699313
2019-12-23,G,Total,435,1585,2540381,345601509453,49296348728,394897858181
2019-12-23,LG1,Staff,51,251,505278,25591835809,19590164620,45182000429
2019-12-23,LG1,TPG,57,376,1248505,99723208428,12942882910,112666091338
2019-12-23,LG1,RPG,44,166,387404,35560506329,14666807846,50227314175
2019-12-23,LG1,UG,82,344,745675,79789961251,10329798543,90119759794
2019-12-23,LG1,Alumni,6,20,44421,5491791426,391771907,5883563333
2019-12-23,LG1,Others(HKUST),9,78,642297,7880442296,958260808,8838703104
2019-12-23,LG1,Non-HKUST,6,36,81025,3310240931,262200861,3572441792
2019-12-23,LG1,Total,255,1271,3654605,257347986470,59141887495,316489873965
2019-12-23,LG3,Staff,88,249,313141,33021156825,1597374103,34618530928
2019-12-23,LG3,TPG,36,156,487720,89705548890,7282263919,96987812809
2019-12-23,LG3,RPG,117,330,666691,110716110630,9708030781,120424141411
2019-12-23,LG3,UG,89,358,525835,221275728855,13085257455,234360986310
2019-12-23,LG3,Alumni,7,21,24480,2816868822,195997092,3012865914
2019-12-23,LG3,Others(HKUST),8,24,896,2676051304,191952226,2868003530
2019-12-23,LG3,Non-HKUST,18,35,96269,8648646312,345057552,8993703864
2019-12-23,LG3,Total,363,1173,2115032,468860111638,32405933128,501266044766
2019-12-23,LG4,Staff,71,159,55656,9041214638,919731876,9960946514
2019-12-23,LG4,TPG,26,230,531026,202782737679,33694763054,236477500733
2019-12-23,LG4,RPG,63,189,256712,29405906177,2191663230,31597569407
2019-12-23,LG4,UG,65,191,285915,31800076286,5838207581,37638283867
2019-12-23,LG4,Alumni,6,44,139370,12723615889,1313914437,14037530326
2019-12-23,LG4,Others(HKUST),8,43,193137,6581802484,432511267,7014313751
2019-12-23,LG4,Non-HKUST,10,13,13824,272270096,18945431,291215527
2019-12-23,LG4,Total,249,869,1475640,292607623249,44409736876,337017360125
2019-12-23,All-Floors,Staff,246,1524,2247485,178508506836,39753558694,218262065530
2019-12-23,All-Floors,TPG,111,1179,3108345,541611233431,67771097330,609382330761
2019-12-23,All-Floors,RPG,229,1083,1936423,244089218432,40956749717,285045968149
2019-12-23,All-Floors,UG,237,1378,2281613,453252809681,46921853719,500174663400
2019-12-23,All-Floors,Alumni,19,131,313697,28473790930,2734678953,31208469883
2019-12-23,All-Floors,Others(HKUST),19,219,1282232,37315479708,2248662275,39564141983
2019-12-23,All-Floors,Non-HKUST,33,123,247980,17874103448,934328628,18808432076
2019-12-23,All-Floors,Total,894,5637,11417775,1501125142466,201320929316,1702446071782
2019-12-24,1,Staff,37,179,371713,26293646873,2220154605,28513801478
2019-12-24,1,TPG,5,13,10620,1352921280,43993033,1396914313
2019-12-24,1,RPG,12,38,33858,1475260630,101784801,1577045431
2019-12-24,1,UG,13,43,72446,10590065652,629201375,11219267027
2019-12-24,1,Alumni,1,1,0,22444469,1836058,24280527
2019-12-24,1,Others(HKUST),5,16,186498,4765560702,180271998,4945832700
2019-12-24,1,Non-HKUST,1,1,0,19316982,1495668,20812650
2019-12-24,1,Total,74,291,675135,44519216588,3178737538,47697954126
2019-12-24,G,Staff,62,211,458089,21176946967,4991479762,26168426729
2019-12-24,G,TPG,33,84,128145,19239045099,879350804,20118395903
2019-12-24,G,RPG,41,113,141549,11218926049,11480295729,22699221778
2019-12-24,G,UG,32,81,91672,9775008868,558978154,10333987022
2019-12-24,G,Alumni,4,10,2521,862980596,38171797,901152393
2019-12-24,G,Others(HKUST),7,14,218846,3110425002,253356219,3363781221
2019-12-24,G,Non-HKUST,7,21,13325,15848049439,252553346,16100602785
2019-12-24,G,Total,186,534,1054147,81231382020,18454185811,99685567831
2019-12-24,LG1,Staff,37,164,273410,14151096040,1308579735,15459675775
2019-12-24,LG1,TPG,15,77,133521,11045323430,596157150,11641480580
2019-12-24,LG1,RPG,19,37,64682,4698545284,390426486,5088971770
2019-12-24,LG1,UG,20,56,120142,3856194464,304759129,4160953593
2019-12-24,LG1,Alumni,1,2,9548,134088726,7306463,141395189
2019-12-24,LG1,Others(HKUST),8,74,617426,4341434463,679646612,5021081075
2019-12-24,LG1,Non-HKUST,5,18,42880,959290236,85889718,1045179954
2019-12-24,LG1,Total,105,428,1261609,39185972643,3372765293,42558737936
2019-12-24,LG3,Staff,57,136,221061,3837851868,609327463,4447179331
2019-12-24,LG3,TPG,19,50,130303,27433723871,1354192784,28787916655
2019-12-24,LG3,RPG,75,89,50088,3905484043,331832631,4237316674
2019-12-24,LG3,UG,56,101,27378,6587381801,517014166,7104395967
2019-12-24,LG3,Alumni,3,7,2884,420988090,16587368,437575458
2019-12-24,LG3,Others(HKUST),5,23,720,818314935,121715010,940029945
2019-12-24,LG3,Non-HKUST,8,14,37123,4280402452,217536049,4497938501
2019-12-24,LG3,Total,223,420,469557,47284147060,3168205471,50452352531
2019-12-24,LG4,Staff,33,102,27944,3163491579,761755524,3925247103
2019-12-24,LG4,TPG,12,35,41604,3022511078,579223373,3601734451
2019-12-24,LG4,RPG,47,68,76025,8013178313,1289256916,9302435229
2019-12-24,LG4,UG,44,87,44665,3213859016,235907121,3449766137
2019-12-24,LG4,Alumni,3,19,10805,5928629104,341857790,6270486894
2019-12-24,LG4,Others(HKUST),8,39,189721,2686725942,426871604,3113597546
2019-12-24,LG4,Non-HKUST,7,7,0,236672357,16143968,252816325
2019-12-24,LG4,Total,154,357,390764,26265067389,3651016296,29916083685
2019-12-24,All-Floors,Staff,150,792,1352217,68623033327,9891297089,78514330416
2019-12-24,All-Floors,TPG,52,259,444193,62093524758,3452917144,65546441902
2019-12-24,All-Floors,RPG,160,345,366202,29311394319,13593596563,42904990882
2019-12-24,All-Floors,UG,122,368,356303,34022509801,2245859945,36268369746
2019-12-24,All-Floors,Alumni,7,39,25758,7369130985,405759476,7774890461
2019-12-24,All-Floors,Others(HKUST),16,166,1213211,15722461044,1661861443,17384322487
2019-12-24,All-Floors,Non-HKUST,22,61,93328,21343731466,573618749,21917350215
2019-12-24,All-Floors,Total,529,2030,3851212,238485785700,31824910409,270310696109
2019-12-25,1,Staff,1,1,86399,1517370711,44918704,1562289415
2019-12-25,1,TPG,0,0,0,0,0,0
2019-12-25,1,RPG,5,5,0,26361778,5907731,32269509
2019-12-25,1,UG,3,3,720,267669721,19969892,287639613
2019-12-25,1,Alumni,0,0,0,0,0,0
2019-12-25,1,Others(HKUST),1,2,172798,4442846370,128974010,4571820380
2019-12-25,1,Non-HKUST,0,0,0,0,0,0
2019-12-25,1,Total,10,11,259917,6254248580,199770337,6454018917
2019-12-25,G,Staff,6,8,172798,5680455585,1006644577,6687100162
2019-12-25,G,TPG,1,1,0,132662911,14274552,146937463
2019-12-25,G,RPG,3,3,720,6763436,2911175,9674611
2019-12-25,G,UG,1,1,0,202954,105531,308485
2019-12-25,G,Alumni,1,1,0,5138,1761,6899
2019-12-25,G,Others(HKUST),2,4,222497,3810086697,292734195,4102820892
2019-12-25,G,Non-HKUST,1,1,541,6108228,558931,6667159
2019-12-25,G,Total,15,19,396556,9636284949,1317230722,10953515671
2019-12-25,LG1,Staff,4,4,92172,5503383763,408588394,5911972157
2019-12-25,LG1,TPG,2,2,720,975449434,51720738,1027170172
2019-12-25,LG1,RPG,8,9,3778,288232704,32510994,320743698
2019-12-25,LG1,UG,12,13,4318,103651571,6830842,110482413
2019-12-25,LG1,Alumni,0,0,0,0,0,0
2019-12-25,LG1,Others(HKUST),3,31,591290,1677537846,302894403,1980432249
2019-12-25,LG1,Non-HKUST,0,0,0,0,0,0
2019-12-25,LG1,Total,29,59,692278,8548255318,802545371,9350800689
2019-12-25,LG3,Staff,15,23,167025,859462151,68341378,927803529
2019-12-25,LG3,TPG,3,3,0,115533405,5798820,121332225
2019-12-25,LG3,RPG,23,23,899,1798563921,103308553,1901872474
2019-12-25,LG3,UG,28,31,3600,1837143241,103078504,1940221745
2019-12-25,LG3,Alumni,0,0,0,0,0,0
2019-12-25,LG3,Others(HKUST),1,1,0,2929028,697172,3626200
2019-12-25,LG3,Non-HKUST,1,2,0,1473754,493977,1967731
2019-12-25,LG3,Total,71,83,171524,4615105500,281718404,4896823904
2019-12-25,LG4,Staff,6,8,0,76495409,1659606,78155015
2019-12-25,LG4,TPG,4,6,1440,81510601,27067896,108578497
2019-12-25,LG4,RPG,24,27,540,636734727,122305154,759039881
2019-12-25,LG4,UG,23,43,7739,3261953829,391764400,3653718229
2019-12-25,LG4,Alumni,1,1,0,2958849,486238,3445087
2019-12-25,LG4,Others(HKUST),3,11,173339,1269938178,186826181,1456764359
2019-12-25,LG4,Non-HKUST,2,2,0,18797122,2037546,20834668
2019-12-25,LG4,Total,63,98,183058,5348388715,732147021,6080535736
2019-12-25,All-Floors,Staff,26,44,518394,13637167619,1530152659,15167320278
2019-12-25,All-Floors,TPG,10,12,2160,1305156351,98862006,1404018357
2019-12-25,All-Floors,RPG,62,67,5937,2756656566,266943607,3023600173
2019-12-25,All-Floors,UG,62,91,16377,5470621316,521749169,5992370485
2019-12-25,All-Floors,Alumni,2,2,0,2963987,487999,3451986
2019-12-25,All-Floors,Others(HKUST),7,49,1159924,11203338119,912125961,12115464080
2019-12-25,All-Floors,Non-HKUST,4,5,541,26379104,3090454,29469558
2019-12-25,All-Floors,Total,173,270,1703333,34402283062,3333411855,37735694917
2019-12-26,1,Staff,1,1,86399,1517370711,44918704,1562289415
2019-12-26,1,TPG,0,0,0,0,0,0
2019-12-26,1,RPG,4,4,1441,15608936,2614937,18223873
2019-12-26,1,UG,3,3,0,28063490,11720028,39783518
2019-12-26,1,Alumni,0,0,0,0,0,0
2019-12-26,1,Others(HKUST),3,4,172798,4454468221,129794081,4584262302
2019-12-26,1,Non-HKUST,0,0,0,0,0,0
2019-12-26,1,Total,11,12,260638,6015511358,189047750,6204559108
2019-12-26,G,Staff,6,8,121692,5553772196,821042688,6374814884
2019-12-26,G,TPG,0,0,0,0,0,0
2019-12-26,G,RPG,4,4,0,7807750,825186,8632936
2019-12-26,G,UG,0,0,0,0,0,0
2019-12-26,G,Alumni,1,1,360,37397176,625368,38022544
2019-12-26,G,Others(HKUST),2,2,172798,1504648370,142499584,1647147954
2019-12-26,G,Non-HKUST,1,1,0,11169,0,11169
2019-12-26,G,Total,14,16,294850,7103636661,964992826,8068629487
2019-12-26,LG1,Staff,6,8,87478,5292197295,397567776,5689765071
2019-12-26,LG1,TPG,1,1,719,369836,178605,548441
2019-12-26,LG1,RPG,6,6,1621,326842644,12778483,339621127
2019-12-26,LG1,UG,6,6,2340,123874290,45031532,168905822
2019-12-26,LG1,Alumni,0,0,0,0,0,0
2019-12-26,LG1,Others(HKUST),5,32,594169,1641510612,318648784,1960159396
2019-12-26,LG1,Non-HKUST,2,4,3423,2112984,714143,2827127
2019-12-26,LG1,Total,26,57,689750,7386907661,774919323,8161826984
2019-12-26,LG3,Staff,15,23,173337,1700497673,52710925,1753208598
2019-12-26,LG3,TPG,3,3,0,466488,317862,784350
2019-12-26,LG3,RPG,43,45,1622,251102480,23145253,274247733
2019-12-26,LG3,UG,36,43,1800,3457113939,111652982,3568766921
2019-12-26,LG3,Alumni,0,0,0,0,0,0
2019-12-26,LG3,Others(HKUST),2,3,0,11843457,962739,12806196
2019-12-26,LG3,Non-HKUST,5,10,2697,425746225,36721390,462467615
2019-12-26,LG3,Total,104,127,179456,5846770262,225511151,6072281413
2019-12-26,LG4,Staff,8,8,0,20318411,4599776,24918187
2019-12-26,LG4,TPG,3,3,0,11589494,1423643,13013137
2019-12-26,LG4,RPG,20,21,540,1733100431,53215778,1786316209
2019-12-26,LG4,UG,29,38,1259,2968219096,106527080,3074746176
2019-12-26,LG4,Alumni,1,1,0,5147392,809898,5957290
2019-12-26,LG4,Others(HKUST),2,11,181613,1124454472,145691994,1270146466
2019-12-26,LG4,Non-HKUST,2,3,541,46075089,39180400,85255489
2019-12-26,LG4,Total,65,85,183953,5908904385,351448569,6260352954
2019-12-26,All-Floors,Staff,33,48,468906,14084156286,1320839869,15404996155
2019-12-26,All-Floors,TPG,6,7,719,12425818,1920110,14345928
2019-12-26,All-Floors,RPG,75,80,5224,2334462241,92579637,2427041878
2019-12-26,All-Floors,UG,68,90,5399,6577270815,274931622,6852202437
2019-12-26,All-Floors,Alumni,2,2,360,42544568,1435266,43979834
2019-12-26,All-Floors,Others(HKUST),10,52,1121378,8736925132,737597182,9474522314
2019-12-26,All-Floors,Non-HKUST,9,18,6661,473945467,76615933,550561400
2019-12-26,All-Floors,Total,203,297,1608647,32261730327,2505919619,34767649946
2019-12-27,1,Staff,41,258,611087,13753136112,1273033067,15026169179
2019-12-27,1,TPG,8,17,63179,4498946255,307768726,4806714981
2019-12-27,1,RPG,12,28,54447,2417966303,103804657,2521770960
2019-12-27,1,UG,13,53,113797,24170370060,872192599,25042562659
2019-12-27,1,Alumni,1,2,0,308712297,20592111,329304408
2019-12-27,1,Others(HKUST),3,21,173587,4692162887,168969745,4861132632
2019-12-27,1,Non-HKUST,2,2,179,16385511,2324191,18709702
2019-12-27,1,Total,80,381,1016276,49857679425,2748685096,52606364521
2019-12-27,G,Staff,112,387,677904,49313567819,3390394728,52703962547
2019-12-27,G,TPG,66,215,358729,84820880218,20272335520,105093215738
2019-12-27,G,RPG,74,225,365643,30902990179,3440310357,34343300536
2019-12-27,G,UG,92,264,372361,33100839023,4668238619,37769077642
2019-12-27,G,Alumni,8,30,47352,6387903836,554839266,6942743102
2019-12-27,G,Others(HKUST),8,20,216593,3897061738,275947824,4173009562
2019-12-27,G,Non-HKUST,16,36,32209,4431899853,431681110,4863580963
2019-12-27,G,Total,376,1177,2070791,212855142666,33033747424,245888890090
2019-12-27,LG1,Staff,55,296,506671,32032150409,3520318230,35552468639
2019-12-27,LG1,TPG,40,205,772970,100577924274,6607762390,107185686664
2019-12-27,LG1,RPG,33,105,206779,11287427759,1730691807,13018119566
2019-12-27,LG1,UG,69,295,691892,70015392289,13815261103,83830653392
2019-12-27,LG1,Alumni,1,2,13491,736639001,37728742,774367743
2019-12-27,LG1,Others(HKUST),8,54,548085,1996834398,343997091,2340831489
2019-12-27,LG1,Non-HKUST,10,39,47192,4597036569,720628682,5317665251
2019-12-27,LG1,Total,216,996,2787080,221243404699,26776388045,248019792744
2019-12-27,LG3,Staff,76,204,310556,35777870015,2547580020,38325450035
2019-12-27,LG3,TPG,27,168,454903,128253879546,6733799571,134987679117
2019-12-27,LG3,RPG,67,146,387977,42054829858,3924703450,45979533308
2019-12-27,LG3,UG,95,264,310307,39967030959,2492876628,42459907587
2019-12-27,LG3,Alumni,5,12,40171,1696598694,393922711,2090521405
2019-12-27,LG3,Others(HKUST),9,19,18366,1095694286,70029882,1165724168
2019-12-27,LG3,Non-HKUST,11,38,106790,45847340246,1536639017,47383979263
2019-12-27,LG3,Total,290,851,1629070,294693243604,17699551279,312392794883
2019-12-27,LG4,Staff,60,166,74529,13374227082,3801389887,17175616969
2019-12-27,LG4,TPG,27,137,346300,67622622322,9603540520,77226162842
2019-12-27,LG4,RPG,64,160,321844,21578073082,6106629214,27684702296
2019-12-27,LG4,UG,57,137,215970,34323742896,2165155760,36488898656
2019-12-27,LG4,Alumni,4,31,85546,12153241091,343788110,12497029201
2019-12-27,LG4,Others(HKUST),6,26,175733,3464129750,1419612594,4883742344
2019-12-27,LG4,Non-HKUST,5,6,8638,148600615,42905156,191505771
2019-12-27,LG4,Total,223,663,1228560,152664636838,23483021241,176147658079
2019-12-27,All-Floors,Staff,197,1311,2180747,144250951437,14532715932,158783667369
2019-12-27,All-Floors,TPG,84,742,1996081,385774252615,43525206727,429299459342
2019-12-27,All-Floors,RPG,181,664,1336690,108241287181,15306139485,123547426666
2019-12-27,All-Floors,UG,218,1013,1704327,201577375227,24013724709,225591099936
2019-12-27,All-Floors,Alumni,14,77,186560,21283094919,1350870940,22633965859
2019-12-27,All-Floors,Others(HKUST),16,140,1132364,15145883059,2278557136,17424440195
2019-12-27,All-Floors,Non-HKUST,27,121,195008,55041262794,2734178156,57775440950
2019-12-27,All-Floors,Total,737,4068,8731777,931314107232,103741393085,1035055500317
2019-12-28,1,Staff,4,14,94502,693430884,43876238,737307122
2019-12-28,1,TPG,6,20,46799,2284175949,356550179,2640726128
2019-12-28,1,RPG,12,13,4140,93078702,71738717,164817419
2019-12-28,1,UG,9,14,52552,8090248875,865235808,8955484683
2019-12-28,1,Alumni,1,1,180,66462563,3829644,70292207
2019-12-28,1,Others(HKUST),1,1,86399,11680657,9569798,21250455
2019-12-28,1,Non-HKUST,3,9,27360,254964537,35691574,290656111
2019-12-28,1,Total,36,72,311932,11494042167,1386491958,12880534125
2019-12-28,G,Staff,31,108,155143,9853146309,2713794306,12566940615
2019-12-28,G,TPG,36,102,172626,44091195208,3438513102,47529708310
2019-12-28,G,RPG,27,73,95930,16885671605,8343126401,25228798006
2019-12-28,G,UG,56,131,237433,32628229576,7107046890,39735276466
2019-12-28,G,Alumni,8,25,33659,6166053632,325274354,6491327986
2019-12-28,G,Others(HKUST),6,8,172981,615050001,56255904,671305905
2019-12-28,G,Non-HKUST,7,41,48962,2816146055,341161843,3157307898
2019-12-28,G,Total,171,488,916734,113055492386,22325172800,135380665186
2019-12-28,LG1,Staff,23,65,266762,4141776162,2093389323,6235165485
2019-12-28,LG1,TPG,22,128,325472,48042514512,5436673221,53479187733
2019-12-28,LG1,RPG,13,45,107469,6380427051,518816532,6899243583
2019-12-28,LG1,UG,40,147,365388,19895342609,2778188325,22673530934
2019-12-28,LG1,Alumni,3,17,39423,936143253,120551669,1056694922
2019-12-28,LG1,Others(HKUST),3,38,254697,257418426,38058350,295476776
2019-12-28,LG1,Non-HKUST,5,10,11524,913813203,65717791,979530994
2019-12-28,LG1,Total,109,450,1370735,80567435216,11051395211,91618830427
2019-12-28,LG3,Staff,21,68,236890,18332549741,1875551881,20208101622
2019-12-28,LG3,TPG,16,92,294475,24385160937,3013748473,27398909410
2019-12-28,LG3,RPG,37,103,210947,33502800264,2493118405,35995918669
2019-12-28,LG3,UG,49,118,203571,30714119263,1424063252,32138182515
2019-12-28,LG3,Alumni,7,15,21054,1705670065,92556744,1798226809
2019-12-28,LG3,Others(HKUST),6,9,3059,9480216,736781,10216997
2019-12-28,LG3,Non-HKUST,6,17,34199,3079745125,147832124,3227577249
2019-12-28,LG3,Total,142,422,1004195,111729525611,9047607660,120777133271
2019-12-28,LG4,Staff,14,33,45542,7308204312,1160284294,8468488606
2019-12-28,LG4,TPG,13,67,142924,24939488126,2778959980,27718448106
2019-12-28,LG4,RPG,17,74,146695,9723762273,683415697,10407177970
2019-12-28,LG4,UG,30,63,94676,20689868882,1266772060,21956640942
2019-12-28,LG4,Alumni,6,17,37255,6175137962,239395575,6414533537
2019-12-28,LG4,Others(HKUST),4,23,238866,4412694529,207886708,4620581237
2019-12-28,LG4,Non-HKUST,4,12,26819,3877811029,4839466054,8717277083
2019-12-28,LG4,Total,88,289,732777,77126967113,11176180368,88303147481
2019-12-28,All-Floors,Staff,59,288,798839,40329107408,7886896042,48216003450
2019-12-28,All-Floors,TPG,52,409,982296,143742534732,15024444955,158766979687
2019-12-28,All-Floors,RPG,76,308,565181,66585739895,12110215752,78695955647
2019-12-28,All-Floors,UG,136,473,953620,112017809205,13441306335,125459115540
2019-12-28,All-Floors,Alumni,18,75,131571,15049467475,781607986,15831075461
2019-12-28,All-Floors,Others(HKUST),12,79,756002,5306323829,312507541,5618831370
2019-12-28,All-Floors,Non-HKUST,15,89,148864,10942479949,5429869386,16372349335
2019-12-28,All-Floors,Total,368,1721,4336373,393973462493,54986847997,448960310490
2019-12-29,1,Staff,8,12,90540,1186447327,112250893,1298698220
2019-12-29,1,TPG,2,4,21242,861043708,48098672,909142380
2019-12-29,1,RPG,4,12,20163,613087917,1063226922,1676314839
2019-12-29,1,UG,3,16,61934,4474427502,275973231,4750400733
2019-12-29,1,Alumni,0,0,0,0,0,0
2019-12-29,1,Others(HKUST),2,4,96483,86906932,15038741,101945673
2019-12-29,1,Non-HKUST,0,0,0,0,0,0
2019-12-29,1,Total,19,48,290362,7221913386,1514588459,8736501845
2019-12-29,G,Staff,27,99,157154,19150429509,2102892660,21253322169
2019-12-29,G,TPG,21,75,124039,43026421049,2169237947,45195658996
2019-12-29,G,RPG,23,63,97390,17133846255,2738619119,19872465374
2019-12-29,G,UG,62,125,202525,26583964086,3382224725,29966188811
2019-12-29,G,Alumni,4,12,32947,6723416681,335937167,7059353848
2019-12-29,G,Others(HKUST),4,9,183958,2529196921,136936200,2666133121
2019-12-29,G,Non-HKUST,6,7,3599,582063467,1368468556,1950532023
2019-12-29,G,Total,147,390,801612,115729337968,12234316374,127963654342
2019-12-29,LG1,Staff,13,30,208442,1153601553,228802771,1382404324
2019-12-29,LG1,TPG,10,29,99017,29845214626,836647224,30681861850
2019-12-29,LG1,RPG,11,21,52213,1938899691,1474424618,3413324309
2019-12-29,LG1,UG,47,120,272767,38449496949,3871109183,42320606132
2019-12-29,LG1,Alumni,1,1,1079,214695608,11170068,225865676
2019-12-29,LG1,Others(HKUST),3,25,248219,44141446,17005301,61146747
2019-12-29,LG1,Non-HKUST,4,16,46632,8002600663,1506346501,9508947164
2019-12-29,LG1,Total,89,242,928369,79648650536,7945505666,87594156202
2019-12-29,LG3,Staff,16,49,153192,7365340701,2895248453,10260589154
2019-12-29,LG3,TPG,12,60,151747,24304944203,1728334526,26033278729
2019-12-29,LG3,RPG,36,71,91447,8139153236,2054848447,10194001683
2019-12-29,LG3,UG,57,254,331455,241193373872,8560835247,249754209119
2019-12-29,LG3,Alumni,7,24,45012,4977979658,607782217,5585761875
2019-12-29,LG3,Others(HKUST),4,10,899,118675951,14878108,133554059
2019-12-29,LG3,Non-HKUST,3,8,29522,1018416662,198388509,1216805171
2019-12-29,LG3,Total,135,476,803274,287117884283,16060315507,303178199790
2019-12-29,LG4,Staff,8,20,4859,1535043451,553457283,2088500734
2019-12-29,LG4,TPG,8,27,63005,32055264669,1545334706,33600599375
2019-12-29,LG4,RPG,13,31,53477,3284714962,215761955,3500476917
2019-12-29,LG4,UG,28,45,30786,9579522180,511736638,10091258818
2019-12-29,LG4,Alumni,3,4,13500,3891256464,104603202,3995859666
2019-12-29,LG4,Others(HKUST),4,20,179999,4350805423,842775884,5193581307
2019-12-29,LG4,Non-HKUST,0,0,0,0,0,0
2019-12-29,LG4,Total,64,147,345626,54696607149,3773669668,58470276817
2019-12-29,All-Floors,Staff,43,210,614187,30390862541,5892652060,36283514601
2019-12-29,All-Floors,TPG,38,195,459050,130092888255,6327653075,136420541330
2019-12-29,All-Floors,RPG,68,198,314690,31109702061,7546881061,38656583122
2019-12-29,All-Floors,UG,138,560,899467,320280784589,16601879024,336882663613
2019-12-29,All-Floors,Alumni,11,41,92538,15807348411,1059492654,16866841065
2019-12-29,All-Floors,Others(HKUST),10,68,709558,7129726673,1026634234,8156360907
2019-12-29,All-Floors,Non-HKUST,8,31,79753,9603080792,3073203566,12676284358
2019-12-29,All-Floors,Total,316,1303,3169243,544414393322,41528395674,585942788996
2019-12-30,1,Staff,58,479,769001,79333564464,170190940479,249524504943
2019-12-30,1,TPG,9,44,187156,18798700834,1356198757,20154899591
2019-12-30,1,RPG,10,25,76314,1848656169,103817310,1952473479
2019-12-30,1,UG,30,195,365311,101677848373,15692349907,117370198280
2019-12-30,1,Alumni,0,0,0,0,0,0
2019-12-30,1,Others(HKUST),4,25,160733,537876786,88724041,626600827
2019-12-30,1,Non-HKUST,3,5,54873,1418353845,131238302,1549592147
2019-12-30,1,Total,114,773,1613388,203615000471,187563268796,391178269267
2019-12-30,G,Staff,140,533,748503,53772053776,15798512261,69570566037
2019-12-30,G,TPG,59,265,528283,112807702602,15853122312,128660824914
2019-12-30,G,RPG,71,166,278632,17754023582,1503220876,19257244458
2019-12-30,G,UG,111,296,480342,74021812771,7233981262,81255794033
2019-12-30,G,Alumni,7,27,41057,1178033684,123749401,1301783085
2019-12-30,G,Others(HKUST),8,34,191895,1436287947,110899643,1547187590
2019-12-30,G,Non-HKUST,19,74,128474,17137209792,1310376406,18447586198
2019-12-30,G,Total,415,1395,2397186,278107124154,41933862161,320040986315
2019-12-30,LG1,Staff,68,255,465222,15224912155,2003244139,17228156294
2019-12-30,LG1,TPG,28,215,572596,58602167114,16504860484,75107027598
2019-12-30,LG1,RPG,42,119,323234,27618892480,1895980363,29514872843
2019-12-30,LG1,UG,87,348,900278,78251535761,12806173595,91057709356
2019-12-30,LG1,Alumni,3,7,4681,1419934833,52656896,1472591729
2019-12-30,LG1,Others(HKUST),6,66,209356,2595685324,243844388,2839529712
2019-12-30,LG1,Non-HKUST,12,91,162585,35765895787,1530681273,37296577060
2019-12-30,LG1,Total,246,1101,2637952,219479023454,35037441138,254516464592
2019-12-30,LG3,Staff,74,208,245716,25642795780,1418036707,27060832487
2019-12-30,LG3,TPG,20,96,416769,43437128784,3394642733,46831771517
2019-12-30,LG3,RPG,88,262,342191,116490160864,4716940016,121207100880
2019-12-30,LG3,UG,75,271,375288,83262354241,9790414868,93052769109
2019-12-30,LG3,Alumni,5,8,16923,494720097,27611265,522331362
2019-12-30,LG3,Others(HKUST),7,27,721,307248228,81106565,388354793
2019-12-30,LG3,Non-HKUST,10,23,53091,10314031847,885438361,11199470208
2019-12-30,LG3,Total,279,895,1450699,279948439841,20314190515,300262630356
2019-12-30,LG4,Staff,53,156,30617,6429977140,576509609,7006486749
2019-12-30,LG4,TPG,20,115,246253,82447213975,5653579141,88100793116
2019-12-30,LG4,RPG,70,113,156445,34836199422,1189306365,36025505787
2019-12-30,LG4,UG,58,147,227498,39328194525,4471471337,43799665862
2019-12-30,LG4,Alumni,7,46,90168,12209816877,371571529,12581388406
2019-12-30,LG4,Others(HKUST),6,41,175679,2489658241,354066483,2843724724
2019-12-30,LG4,Non-HKUST,10,22,22512,2791388818,138314755,2929703573
2019-12-30,LG4,Total,224,640,949172,180532448998,12754819219,193287268217
2019-12-30,All-Floors,Staff,244,1631,2259059,180403303315,189987243195,370390546510
2019-12-30,All-Floors,TPG,82,735,1951057,316092913309,42762403427,358855316736
2019-12-30,All-Floors,RPG,211,685,1176816,198547932517,9409264930,207957197447
2019-12-30,All-Floors,UG,245,1257,2348717,376541745671,49994390969,426536136640
2019-12-30,All-Floors,Alumni,13,88,152829,15302505491,575589091,15878094582
2019-12-30,All-Floors,Others(HKUST),16,193,738384,7366756526,878641120,8245397646
2019-12-30,All-Floors,Non-HKUST,38,215,421535,67426880089,3996049097,71422929186
2019-12-30,All-Floors,Total,849,4804,9048397,1161682036918,297603581829,1459285618747
2019-12-31,1,Staff,42,224,424191,8933932451,1002184309,9936116760
2019-12-31,1,TPG,2,10,22344,370730979,36770265,407501244
2019-12-31,1,RPG,3,3,180,227093,157540,384633
2019-12-31,1,UG,13,68,73853,9462666924,647209740,10109876664
2019-12-31,1,Alumni,0,0,0,0,0,0
2019-12-31,1,Others(HKUST),4,13,187209,694054641,47096668,741151309
2019-12-31,1,Non-HKUST,0,0,0,0,0,0
2019-12-31,1,Total,64,318,707777,19461612088,1733418522,21195030610
2019-12-31,G,Staff,74,270,485384,14684349680,8117445728,22801795408
2019-12-31,G,TPG,22,61,69165,10636879557,659955017,11296834574
2019-12-31,G,RPG,34,83,121914,9147630043,503527444,9651157487
2019-12-31,G,UG,34,97,98706,10949372561,620302830,11569675391
2019-12-31,G,Alumni,4,5,542,1228534294,38662163,1267196457
2019-12-31,G,Others(HKUST),8,21,191530,1717687090,113061582,1830748672
2019-12-31,G,Non-HKUST,7,25,29185,1781855480,1219841351,3001696831
2019-12-31,G,Total,183,562,996426,50146308705,11272796115,61419104820
2019-12-31,LG1,Staff,49,144,371310,9976700675,633904394,10610605069
2019-12-31,LG1,TPG,8,18,58543,2899454185,587355114,3486809299
2019-12-31,LG1,RPG,17,36,33322,2887374481,659173827,3546548308
2019-12-31,LG1,UG,33,105,119782,11145033986,993661273,12138695259
2019-12-31,LG1,Alumni,2,5,7564,1371724074,726844924,2098568998
2019-12-31,LG1,Others(HKUST),6,57,212429,4967705702,198493646,5166199348
2019-12-31,LG1,Non-HKUST,7,12,46111,2604734295,344364537,2949098832
2019-12-31,LG1,Total,122,377,849061,35852727398,4143797715,39996525113
2019-12-31,LG3,Staff,49,132,185261,8376797789,4619109235,12995907024
2019-12-31,LG3,TPG,9,23,49539,7257913841,357205041,7615118882
2019-12-31,LG3,RPG,62,117,92969,16796650640,1910315965,18706966605
2019-12-31,LG3,UG,47,95,46669,14903510845,2139688617,17043199462
2019-12-31,LG3,Alumni,2,9,9551,3423014624,236656016,3659670640
2019-12-31,LG3,Others(HKUST),5,22,23775,3298344773,108249570,3406594343
2019-12-31,LG3,Non-HKUST,5,7,5942,967750116,37523204,1005273320
2019-12-31,LG3,Total,179,405,413706,55023982628,9408747648,64432730276
2019-12-31,LG4,Staff,40,122,25399,4203863754,661634275,4865498029
2019-12-31,LG4,TPG,11,33,69552,3570822897,1640847426,5211670323
2019-12-31,LG4,RPG,35,56,82670,4158672050,476663413,4635335463
2019-12-31,LG4,UG,33,58,42861,3171853894,235728370,3407582264
2019-12-31,LG4,Alumni,2,17,26654,7440286404,199158335,7639444739
2019-12-31,LG4,Others(HKUST),8,31,191884,2967273490,226038906,3193312396
2019-12-31,LG4,Non-HKUST,4,7,9726,83952683,53654731,137607414
2019-12-31,LG4,Total,133,324,448746,25596725172,3493725456,29090450628
2019-12-31,All-Floors,Staff,162,892,1491545,46175644349,15034277941,61209922290
2019-12-31,All-Floors,TPG,36,145,269143,24735801459,3282132863,28017934322
2019-12-31,All-Floors,RPG,127,295,331055,32990554307,3549838189,36540392496
2019-12-31,All-Floors,UG,119,423,381871,49632438210,4636590830,54269029040
2019-12-31,All-Floors,Alumni,6,36,44311,13463559396,1201321438,14664880834
2019-12-31,All-Floors,Others(HKUST),16,144,806827,13645065696,692940372,14338006068
2019-12-31,All-Floors,Non-HKUST,17,51,90964,5438292574,1655383823,7093676397
2019-12-31,All-Floors,Total,483,1986,3415716,186081355991,30052485456,216133841447
