Date,Floor,User-Group,User-Count,WiFi-Conn,Duration-Sec,Traffic-In-Byte,Traffic-Out-Byte,Traffic-Both-Byte
2020-04-01,1,Alumni,0,0,0,0,0,0
2020-04-01,1,Non-HKUST,0,0,0,0,0,0
2020-04-01,1,Others(HKUST),0,0,0,0,0,0
2020-04-01,1,RPG,8,8,4142,577775152,309495518,887270670
2020-04-01,1,Staff,23,269,700424,26507740077,12712757899,39220497976
2020-04-01,1,TPG,0,0,0,0,0,0
2020-04-01,1,Total,32,278,704566,27085515229,13022253417,40107768646
2020-04-01,1,UG,1,1,0,0,0,0
2020-04-01,All-Floors,Alumni,1,1,0,10399088,1199941,11599029
2020-04-01,All-Floors,Non-HKUST,6,8,1441,2683808246,159606194,2843414440
2020-04-01,All-Floors,Others(HKUST),9,52,1394402,32808004176,5013833023,37821837199
2020-04-01,All-Floors,RPG,71,76,7193,1811700900,428662324,2240363224
2020-04-01,All-Floors,Staff,89,594,1127411,82429589364,20569894555,102999483919
2020-04-01,All-Floors,TPG,13,17,1798,1097598880,78881605,1176480485
2020-04-01,All-Floors,Total,239,829,2619186,132483142407,28096633998,160579776405
2020-04-01,All-Floors,UG,50,81,86941,11642041753,1844556356,13486598109
2020-04-01,G,Alumni,0,0,0,0,0,0
2020-04-01,G,Non-HKUST,0,0,0,0,0,0
2020-04-01,G,Others(HKUST),2,5,345226,9548471704,1215012466,10763484170
2020-04-01,G,RPG,3,3,0,45204190,9617375,54821565
2020-04-01,G,Staff,17,139,386490,21865525328,4189216371,26054741699
2020-04-01,G,TPG,0,0,0,0,0,0
2020-04-01,G,Total,22,147,731716,31459201222,5413846212,36873047434
2020-04-01,G,UG,0,0,0,0,0,0
2020-04-01,LG1,Alumni,0,0,0,0,0,0
2020-04-01,LG1,Non-HKUST,1,1,720,2435299,74355,2509654
2020-04-01,LG1,Others(HKUST),3,15,776481,14289143680,2453531946,16742675626
2020-04-01,LG1,RPG,4,4,1791,12050577,718148,12768725
2020-04-01,LG1,Staff,13,31,25027,1093612684,660271103,1753883787
2020-04-01,LG1,TPG,0,0,0,0,0,0
2020-04-01,LG1,Total,27,57,806898,15553949950,3126235890,18680185840
2020-04-01,LG1,UG,6,6,2879,156707710,11640338,168348048
2020-04-01,LG3,Alumni,1,1,0,10399088,1199941,11599029
2020-04-01,LG3,Non-HKUST,5,5,721,1371896827,78278488,1450175315
2020-04-01,LG3,Others(HKUST),3,5,0,68924018,2599756,71523774
2020-04-01,LG3,RPG,36,37,721,702201322,56943757,759145079
2020-04-01,LG3,Staff,54,96,5577,12519910811,1475526500,13995437311
2020-04-01,LG3,TPG,7,10,1798,926122636,53989923,980112559
2020-04-01,LG3,Total,131,194,50764,21823698853,3078183569,24901882422
2020-04-01,LG3,UG,25,40,41947,6224244151,1409645204,7633889355
2020-04-01,LG4,Alumni,0,0,0,0,0,0
2020-04-01,LG4,Non-HKUST,2,2,0,1309476120,81253351,1390729471
2020-04-01,LG4,Others(HKUST),6,27,272695,8901464774,1342688855,10244153629
2020-04-01,LG4,RPG,24,24,539,474469659,51887526,526357185
2020-04-01,LG4,Staff,26,59,9893,20442800464,1532122682,21974923146
2020-04-01,LG4,TPG,6,7,0,171476244,24891682,196367926
2020-04-01,LG4,Total,84,153,325242,36560777153,3456114910,40016892063
2020-04-01,LG4,UG,20,34,42115,5261089892,423270814,5684360706
2020-04-02,1,Alumni,0,0,0,0,0,0
2020-04-02,1,Non-HKUST,0,0,0,0,0,0
2020-04-02,1,Others(HKUST),1,9,25396,393978608,75461706,469440314
2020-04-02,1,RPG,3,3,1260,203837,125299,329136
2020-04-02,1,Staff,19,198,711888,79243894321,3778650924,83022545245
2020-04-02,1,TPG,0,0,0,0,0,0
2020-04-02,1,Total,25,212,739264,79664750091,3856584011,83521334102
2020-04-02,1,UG,2,2,720,26673325,2346082,29019407
2020-04-02,All-Floors,Alumni,1,2,0,148064838,5018241,153083079
2020-04-02,All-Floors,Non-HKUST,3,4,180,35165962,5849713,41015675
2020-04-02,All-Floors,Others(HKUST),10,67,1589927,43509788061,5988613716,49498401777
2020-04-02,All-Floors,RPG,71,82,5229,2040541066,359262828,2399803894
2020-04-02,All-Floors,Staff,83,503,1316903,183601468570,12637612681,196239081251
2020-04-02,All-Floors,TPG,7,16,37418,3210060672,586607354,3796668026
2020-04-02,All-Floors,Total,232,791,3061597,271714601750,21797101798,293511703548
2020-04-02,All-Floors,UG,57,117,111940,39169512581,2214137265,41383649846
2020-04-02,G,Alumni,0,0,0,0,0,0
2020-04-02,G,Non-HKUST,1,1,180,5080483,533973,5614456
2020-04-02,G,Others(HKUST),3,5,345596,7813167954,967115319,8780283273
2020-04-02,G,RPG,4,4,539,61896361,3611780,65508141
2020-04-02,G,Staff,23,152,492184,71581556878,5149586556,76731143434
2020-04-02,G,TPG,0,0,0,0,0,0
2020-04-02,G,Total,32,163,838499,79461929512,6120920246,85582849758
2020-04-02,G,UG,1,1,0,227836,72618,300454
2020-04-02,LG1,Alumni,0,0,0,0,0,0
2020-04-02,LG1,Non-HKUST,0,0,0,0,0,0
2020-04-02,LG1,Others(HKUST),2,13,863623,13556120840,2282888104,15839008944
2020-04-02,LG1,RPG,4,4,728,12816446,1506603,14323049
2020-04-02,LG1,Staff,8,12,6302,1526110648,48807498,1574918146
2020-04-02,LG1,TPG,0,0,0,0,0,0
2020-04-02,LG1,Total,21,36,873351,15266067374,2344030141,17610097515
2020-04-02,LG1,UG,7,7,2698,171019440,10827936,181847376
2020-04-02,LG3,Alumni,0,0,0,0,0,0
2020-04-02,LG3,Non-HKUST,1,1,0,0,465029,465029
2020-04-02,LG3,Others(HKUST),5,9,1261,72645583,10800682,83446265
2020-04-02,LG3,RPG,34,35,1082,1179190105,82092064,1261282169
2020-04-02,LG3,Staff,45,99,102926,27700375522,2803055316,30503430838
2020-04-02,LG3,TPG,5,8,37418,2894328744,531733180,3426061924
2020-04-02,LG3,Total,112,188,183546,61482356648,4421942393,65904299041
2020-04-02,LG3,UG,22,36,40859,29635816694,993796122,30629612816
2020-04-02,LG4,Alumni,1,2,0,148064838,5018241,153083079
2020-04-02,LG4,Non-HKUST,2,2,0,30085479,4850711,34936190
2020-04-02,LG4,Others(HKUST),5,31,354051,21673875076,2652347905,24326222981
2020-04-02,LG4,RPG,33,36,1620,786434317,271927082,1058361399
2020-04-02,LG4,Staff,26,42,3603,3549531201,857512387,4407043588
2020-04-02,LG4,TPG,5,8,0,315731928,54874174,370606102
2020-04-02,LG4,Total,100,192,426937,35839498125,5053625007,40893123132
2020-04-02,LG4,UG,28,71,67663,9335775286,1207094507,10542869793
2020-04-03,1,Alumni,0,0,0,0,0,0
2020-04-03,1,Non-HKUST,0,0,0,0,0,0
2020-04-03,1,Others(HKUST),1,1,361,3821354,371921,4193275
2020-04-03,1,RPG,5,5,719,17980770,4859899,22840669
2020-04-03,1,Staff,24,288,888352,31361830335,6124949439,37486779774
2020-04-03,1,TPG,0,0,0,0,0,0
2020-04-03,1,Total,32,296,889612,33222447379,6204397031,39426844410
2020-04-03,1,UG,2,2,180,1838814920,74215772,1913030692
2020-04-03,All-Floors,Alumni,2,2,0,4440270,1314633,5754903
2020-04-03,All-Floors,Non-HKUST,2,2,0,11125938,3837533,14963471
2020-04-03,All-Floors,Others(HKUST),8,39,1574450,35149722187,5019122075,40168844262
2020-04-03,All-Floors,RPG,82,87,27347,4168568558,333127128,4501695686
2020-04-03,All-Floors,Staff,86,740,1529950,61869269836,12094348698,73963618534
2020-04-03,All-Floors,TPG,8,8,0,137385939,7385235,144771174
2020-04-03,All-Floors,Total,250,992,3214574,127372862783,18877109175,146249971958
2020-04-03,All-Floors,UG,62,114,82827,26032350055,1417973873,27450323928
2020-04-03,G,Alumni,0,0,0,0,0,0
2020-04-03,G,Non-HKUST,0,0,0,0,0,0
2020-04-03,G,Others(HKUST),4,8,354061,8052267555,994527296,9046794851
2020-04-03,G,RPG,2,3,4861,2792988,983568,3776556
2020-04-03,G,Staff,26,187,510541,22419034649,4124850619,26543885268
2020-04-03,G,TPG,0,0,0,0,0,0
2020-04-03,G,Total,33,199,869463,30557395082,5124746967,35682142049
2020-04-03,G,UG,1,1,0,83299890,4385484,87685374
2020-04-03,LG1,Alumni,0,0,0,0,0,0
2020-04-03,LG1,Non-HKUST,0,0,0,0,0,0
2020-04-03,LG1,Others(HKUST),3,14,865430,12414022916,2103188694,14517211610
2020-04-03,LG1,RPG,7,7,2519,10377078,3447018,13824096
2020-04-03,LG1,Staff,8,33,32765,202521819,35488336,238010155
2020-04-03,LG1,TPG,0,0,0,0,0,0
2020-04-03,LG1,Total,28,64,903416,12755045234,2180647071,14935692305
2020-04-03,LG1,UG,10,10,2702,128123421,38523023,166646444
2020-04-03,LG3,Alumni,2,2,0,4440270,1314633,5754903
2020-04-03,LG3,Non-HKUST,1,1,0,11092841,3817169,14910010
2020-04-03,LG3,Others(HKUST),1,1,0,3789237,344818,4134055
2020-04-03,LG3,RPG,33,33,4137,1327847956,161135752,1488983708
2020-04-03,LG3,Staff,46,164,88028,5408756807,1205791653,6614548460
2020-04-03,LG3,TPG,2,2,0,650505,254282,904787
2020-04-03,LG3,Total,114,247,120079,17324701324,1891845055,19216546379
2020-04-03,LG3,UG,29,44,27914,10568123708,519186748,11087310456
2020-04-03,LG4,Alumni,0,0,0,0,0,0
2020-04-03,LG4,Non-HKUST,1,1,0,33097,20364,53461
2020-04-03,LG4,Others(HKUST),3,15,354598,14675821125,1920689346,16596510471
2020-04-03,LG4,RPG,36,39,15111,2809569766,162700891,2972270657
2020-04-03,LG4,Staff,35,68,10264,2477126226,603268651,3080394877
2020-04-03,LG4,TPG,6,6,0,136735434,7130953,143866387
2020-04-03,LG4,Total,110,186,432004,33513273764,3475473051,36988746815
2020-04-03,LG4,UG,29,57,52031,13413988116,781662846,14195650962
2020-04-04,1,Alumni,0,0,0,0,0,0
2020-04-04,1,Non-HKUST,0,0,0,0,0,0
2020-04-04,1,Others(HKUST),0,0,0,0,0,0
2020-04-04,1,RPG,1,1,0,351521,208925,560446
2020-04-04,1,Staff,6,39,607332,6932305545,274210629,7206516174
2020-04-04,1,TPG,1,1,0,25850,24296,50146
2020-04-04,1,Total,9,42,607512,6932721283,274462627,7207183910
2020-04-04,1,UG,1,1,180,38367,18777,57144
2020-04-04,All-Floors,Alumni,0,0,0,0,0,0
2020-04-04,All-Floors,Non-HKUST,2,2,0,8724029,2597370,11321399
2020-04-04,All-Floors,Others(HKUST),6,27,1557509,35426504058,5122933359,40549437417
2020-04-04,All-Floors,RPG,55,59,7021,2101492361,190409784,2291902145
2020-04-04,All-Floors,Staff,28,95,1004252,21678666662,2258610389,23937277051
2020-04-04,All-Floors,TPG,16,25,33317,5311870678,534059002,5845929680
2020-04-04,All-Floors,Total,169,323,2637208,105645148975,13076478598,118721627573
2020-04-04,All-Floors,UG,62,115,35109,41117891187,4967868694,46085759881
2020-04-04,G,Alumni,0,0,0,0,0,0
2020-04-04,G,Non-HKUST,0,0,0,0,0,0
2020-04-04,G,Others(HKUST),2,4,345596,8370366622,1014072270,9384438892
2020-04-04,G,RPG,1,1,0,108675365,4179647,112855012
2020-04-04,G,Staff,5,7,345596,14266221074,1927874792,16194095866
2020-04-04,G,TPG,1,1,0,2556723492,112376424,2669099916
2020-04-04,G,Total,10,14,691192,25315904763,3060197748,28376102511
2020-04-04,G,UG,1,1,0,13918210,1694615,15612825
2020-04-04,LG1,Alumni,0,0,0,0,0,0
2020-04-04,LG1,Non-HKUST,0,0,0,0,0,0
2020-04-04,LG1,Others(HKUST),1,10,863990,12593512844,2128577652,14722090496
2020-04-04,LG1,RPG,3,3,1080,62865,63709,126574
2020-04-04,LG1,Staff,3,3,1983,12990212,577421,13567633
2020-04-04,LG1,TPG,0,0,0,0,0,0
2020-04-04,LG1,Total,8,17,867413,12606565921,2129218782,14735784703
2020-04-04,LG1,UG,1,1,360,0,0,0
2020-04-04,LG3,Alumni,0,0,0,0,0,0
2020-04-04,LG3,Non-HKUST,0,0,0,0,0,0
2020-04-04,LG3,Others(HKUST),1,4,6475,382859486,13546506,396405992
2020-04-04,LG3,RPG,25,25,5941,1655863425,144320560,1800183985
2020-04-04,LG3,Staff,11,36,49341,342527239,47270626,389797865
2020-04-04,LG3,TPG,10,16,33317,2262045874,372863800,2634909674
2020-04-04,LG3,Total,75,118,97776,17841176074,2014967951,19856144025
2020-04-04,LG3,UG,28,37,2702,13197880050,1436966459,14634846509
2020-04-04,LG4,Alumni,0,0,0,0,0,0
2020-04-04,LG4,Non-HKUST,2,2,0,8724029,2597370,11321399
2020-04-04,LG4,Others(HKUST),3,9,341448,14079765106,1966736931,16046502037
2020-04-04,LG4,RPG,29,29,0,336539185,41636943,378176128
2020-04-04,LG4,Staff,7,10,0,124622592,8676921,133299513
2020-04-04,LG4,TPG,5,7,0,493075462,48794482,541869944
2020-04-04,LG4,Total,81,132,373315,42948780934,5597631490,48546412424
2020-04-04,LG4,UG,35,75,31867,27906054560,3529188843,31435243403
2020-04-05,1,Alumni,0,0,0,0,0,0
2020-04-05,1,Non-HKUST,0,0,0,0,0,0
2020-04-05,1,Others(HKUST),0,0,0,0,0,0
2020-04-05,1,RPG,4,4,1440,2239461,994574,3234035
2020-04-05,1,Staff,8,60,545403,8986175293,323604975,9309780268
2020-04-05,1,TPG,1,2,721,39395289,5214212,44609501
2020-04-05,1,Total,15,68,547564,9027832474,329831354,9357663828
2020-04-05,1,UG,2,2,0,22431,17593,40024
2020-04-05,All-Floors,Alumni,2,2,0,112830405,7986675,120817080
2020-04-05,All-Floors,Non-HKUST,2,3,0,11729618,4698151,16427769
2020-04-05,All-Floors,Others(HKUST),7,40,1387245,34563842874,4998099356,39561942230
2020-04-05,All-Floors,RPG,38,42,7380,232309112,36771079,269080191
2020-04-05,All-Floors,Staff,25,112,815585,21117137431,1909594506,23026731937
2020-04-05,All-Floors,TPG,9,11,1431,223254651,63185902,286440553
2020-04-05,All-Floors,Total,134,291,2234859,61576868224,7334317185,68911185409
2020-04-05,All-Floors,UG,51,81,23218,5315764133,313981516,5629745649
2020-04-05,G,Alumni,0,0,0,0,0,0
2020-04-05,G,Non-HKUST,0,0,0,0,0,0
2020-04-05,G,Others(HKUST),2,3,259197,6255939273,794486299,7050425572
2020-04-05,G,RPG,0,0,0,0,0,0
2020-04-05,G,Staff,4,27,263159,12045637655,1573774077,13619411732
2020-04-05,G,TPG,0,0,0,0,0,0
2020-04-05,G,Total,8,32,522356,18301846719,2368504389,20670351108
2020-04-05,G,UG,2,2,0,269791,244013,513804
2020-04-05,LG1,Alumni,0,0,0,0,0,0
2020-04-05,LG1,Non-HKUST,0,0,0,0,0,0
2020-04-05,LG1,Others(HKUST),2,10,777591,11637190257,1942645578,13579835835
2020-04-05,LG1,RPG,1,1,720,4701791,547828,5249619
2020-04-05,LG1,Staff,4,6,2341,2065507,1046869,3112376
2020-04-05,LG1,TPG,2,3,710,2017172,223692,2240864
2020-04-05,LG1,Total,11,22,782081,11669813903,1947793338,13617607241
2020-04-05,LG1,UG,2,2,719,23839176,3329371,27168547
2020-04-05,LG3,Alumni,1,1,0,112666866,7892859,120559725
2020-04-05,LG3,Non-HKUST,2,3,0,11729618,4698151,16427769
2020-04-05,LG3,Others(HKUST),1,2,0,303716,112383,416099
2020-04-05,LG3,RPG,14,14,2160,96998096,16701797,113699893
2020-04-05,LG3,Staff,5,11,4682,53591333,6203903,59795236
2020-04-05,LG3,TPG,2,2,0,93741398,2904682,96646080
2020-04-05,LG3,Total,44,58,23221,2408935063,121728599,2530663662
2020-04-05,LG3,UG,19,25,16379,2039904036,83214824,2123118860
2020-04-05,LG4,Alumni,1,1,0,163539,93816,257355
2020-04-05,LG4,Non-HKUST,0,0,0,0,0,0
2020-04-05,LG4,Others(HKUST),4,25,350457,16670409628,2260855096,18931264724
2020-04-05,LG4,RPG,22,23,3060,128369764,18526880,146896644
2020-04-05,LG4,Staff,8,8,0,29667643,4964682,34632325
2020-04-05,LG4,TPG,4,4,0,88100792,54843316,142944108
2020-04-05,LG4,Total,69,111,359637,20168440065,2566459505,22734899570
2020-04-05,LG4,UG,30,50,6120,3251728699,227175715,3478904414
2020-04-06,1,Alumni,0,0,0,0,0,0
2020-04-06,1,Non-HKUST,0,0,0,0,0,0
2020-04-06,1,Others(HKUST),1,1,180,8229315,609287,8838602
2020-04-06,1,RPG,1,1,0,234862,206522,441384
2020-04-06,1,Staff,24,238,949926,42776652030,3402550589,46179202619
2020-04-06,1,TPG,0,0,0,0,0,0
2020-04-06,1,Total,26,240,950106,42785116207,3403366398,46188482605
2020-04-06,1,UG,0,0,0,0,0,0
2020-04-06,All-Floors,Alumni,0,0,0,0,0,0
2020-04-06,All-Floors,Non-HKUST,3,5,1978,39615478,27167571,66783049
2020-04-06,All-Floors,Others(HKUST),8,47,1186510,35651713900,5022536620,40674250520
2020-04-06,All-Floors,RPG,66,75,5577,4105881568,147131090,4253012658
2020-04-06,All-Floors,Staff,88,588,1509237,72951927579,7396629510,80348557089
2020-04-06,All-Floors,TPG,10,13,3609,429022463,165805748,594828211
2020-04-06,All-Floors,Total,228,861,2819705,192669720340,37306771011,229976491351
2020-04-06,All-Floors,UG,53,133,112794,79491559352,24547500472,104039059824
2020-04-06,G,Alumni,0,0,0,0,0,0
2020-04-06,G,Non-HKUST,0,0,0,0,0,0
2020-04-06,G,Others(HKUST),3,10,264771,9101908096,1004570682,10106478778
2020-04-06,G,RPG,0,0,0,0,0,0
2020-04-06,G,Staff,27,156,499356,23796975900,3182409183,26979385083
2020-04-06,G,TPG,0,0,0,0,0,0
2020-04-06,G,Total,31,167,764127,32898927286,4187008592,37085935878
2020-04-06,G,UG,1,1,0,43290,28727,72017
2020-04-06,LG1,Alumni,0,0,0,0,0,0
2020-04-06,LG1,Non-HKUST,0,0,0,0,0,0
2020-04-06,LG1,Others(HKUST),2,10,605145,10275714125,1741718393,12017432518
2020-04-06,LG1,RPG,1,1,360,57822,57357,115179
2020-04-06,LG1,Staff,13,36,39065,903270959,158934784,1062205743
2020-04-06,LG1,TPG,1,1,9,4900,3582,8482
2020-04-06,LG1,Total,25,56,646737,11324655946,1918855562,13243511508
2020-04-06,LG1,UG,8,8,2158,145608140,18141446,163749586
2020-04-06,LG3,Alumni,0,0,0,0,0,0
2020-04-06,LG3,Non-HKUST,2,2,1978,8847812,2889460,11737272
2020-04-06,LG3,Others(HKUST),4,6,0,72502654,3278587,75781241
2020-04-06,LG3,RPG,34,35,5217,3271766242,108388015,3380154257
2020-04-06,LG3,Staff,53,106,12064,3402251269,368282118,3770533387
2020-04-06,LG3,TPG,6,8,3600,382389341,160780492,543169833
2020-04-06,LG3,Total,130,213,49989,42283189973,12248444858,54531634831
2020-04-06,LG3,UG,31,56,27130,35145432655,11604826186,46750258841
2020-04-06,LG4,Alumni,0,0,0,0,0,0
2020-04-06,LG4,Non-HKUST,3,3,0,30767666,24278111,55045777
2020-04-06,LG4,Others(HKUST),3,20,316414,16193359710,2272359671,18465719381
2020-04-06,LG4,RPG,34,38,0,833822642,38479196,872301838
2020-04-06,LG4,Staff,25,52,8826,2072777421,284452836,2357230257
2020-04-06,LG4,TPG,3,4,0,46628222,5021674,51649896
2020-04-06,LG4,Total,89,185,408746,63377830928,15549095601,78926926529
2020-04-06,LG4,UG,21,68,83506,44200475267,12924504113,57124979380
2020-04-07,1,Alumni,0,0,0,0,0,0
2020-04-07,1,Non-HKUST,0,0,0,0,0,0
2020-04-07,1,Others(HKUST),4,15,23955,491316810,35592735,526909545
2020-04-07,1,RPG,5,5,0,1824602,247958,2072560
2020-04-07,1,Staff,22,156,861359,49961853199,5286813340,55248666539
2020-04-07,1,TPG,0,0,0,0,0,0
2020-04-07,1,Total,31,176,885314,50454994611,5322654033,55777648644
2020-04-07,1,UG,0,0,0,0,0,0
2020-04-07,All-Floors,Alumni,1,1,0,0,0,0
2020-04-07,All-Floors,Non-HKUST,3,4,0,79529874,12899370,92429244
2020-04-07,All-Floors,Others(HKUST),14,63,1374610,36616805157,5554576012,42171381169
2020-04-07,All-Floors,RPG,68,82,7202,3139660901,379190384,3518851285
2020-04-07,All-Floors,Staff,79,556,1438366,83826365352,12723536508,96549901860
2020-04-07,All-Floors,TPG,8,11,0,1124467095,59768886,1184235981
2020-04-07,All-Floors,Total,227,831,2877612,141094184564,19833955615,160928140179
2020-04-07,All-Floors,UG,54,114,57434,16307356185,1103984455,17411340640
2020-04-07,G,Alumni,0,0,0,0,0,0
2020-04-07,G,Non-HKUST,0,0,0,0,0,0
2020-04-07,G,Others(HKUST),5,12,352793,10826573612,1419148644,12245722256
2020-04-07,G,RPG,2,2,0,1620520,504735,2125255
2020-04-07,G,Staff,29,228,521006,24444889327,4552402482,28997291809
2020-04-07,G,TPG,0,0,0,0,0,0
2020-04-07,G,Total,37,243,873799,35273206428,5972148734,41245355162
2020-04-07,G,UG,1,1,0,122969,92873,215842
2020-04-07,LG1,Alumni,0,0,0,0,0,0
2020-04-07,LG1,Non-HKUST,0,0,0,0,0,0
2020-04-07,LG1,Others(HKUST),3,14,776845,15581032432,2638996859,18220029291
2020-04-07,LG1,RPG,4,4,0,139450,39103,178553
2020-04-07,LG1,Staff,8,32,44471,2203067651,1194191122,3397258773
2020-04-07,LG1,TPG,0,0,0,0,0,0
2020-04-07,LG1,Total,22,57,822756,18347559473,3857481466,22205040939
2020-04-07,LG1,UG,7,7,1440,563319940,24254382,587574322
2020-04-07,LG3,Alumni,1,1,0,0,0,0
2020-04-07,LG3,Non-HKUST,3,3,0,10643102,6448688,17091790
2020-04-07,LG3,Others(HKUST),5,5,180,890732,566178,1456910
2020-04-07,LG3,RPG,24,28,1440,1927984862,233766448,2161751310
2020-04-07,LG3,Staff,45,76,3060,4302697445,1328473188,5631170633
2020-04-07,LG3,TPG,4,5,0,705281051,39842962,745124013
2020-04-07,LG3,Total,101,153,14774,12703358985,1907216853,14610575838
2020-04-07,LG3,UG,19,35,10094,5755861793,298119389,6053981182
2020-04-07,LG4,Alumni,0,0,0,0,0,0
2020-04-07,LG4,Non-HKUST,1,1,0,68886772,6450682,75337454
2020-04-07,LG4,Others(HKUST),6,17,220837,9716991571,1460271596,11177263167
2020-04-07,LG4,RPG,37,43,5762,1208091467,144632140,1352723607
2020-04-07,LG4,Staff,27,64,8470,2913857730,361656376,3275514106
2020-04-07,LG4,TPG,5,6,0,419186044,19925924,439111968
2020-04-07,LG4,Total,107,202,280969,24315065067,2774454529,27089519596
2020-04-07,LG4,UG,31,71,45900,9988051483,781517811,10769569294
2020-04-08,1,Alumni,0,0,0,0,0,0
2020-04-08,1,Non-HKUST,0,0,0,0,0,0
2020-04-08,1,Others(HKUST),1,1,181,4277330,380101,4657431
2020-04-08,1,RPG,10,10,2699,2737198,7538084,10275282
2020-04-08,1,Staff,24,223,892717,49608655778,5441951775,55050607553
2020-04-08,1,TPG,0,0,0,0,0,0
2020-04-08,1,Total,38,237,895956,50086397529,5528449270,55614846799
2020-04-08,1,UG,3,3,359,470727223,78579310,549306533
2020-04-08,All-Floors,Alumni,2,6,1261,11533724,1883035,13416759
2020-04-08,All-Floors,Non-HKUST,4,5,0,81588174,28233609,109821783
2020-04-08,All-Floors,Others(HKUST),10,57,1532308,49856514961,7292148761,57148663722
2020-04-08,All-Floors,RPG,81,86,16914,2164239359,195463932,2359703291
2020-04-08,All-Floors,Staff,94,548,1471846,80203048633,10014336608,90217385241
2020-04-08,All-Floors,TPG,10,13,21409,2252160787,287575229,2539736016
2020-04-08,All-Floors,Total,268,837,3098817,169459523466,19572734657,189032258123
2020-04-08,All-Floors,UG,67,122,55079,34890437828,1753093483,36643531311
2020-04-08,G,Alumni,1,1,179,128910,156624,285534
2020-04-08,G,Non-HKUST,0,0,0,0,0,0
2020-04-08,G,Others(HKUST),6,13,348118,8952923267,1084388813,10037312080
2020-04-08,G,RPG,1,1,0,17086709,6509711,23596420
2020-04-08,G,Staff,30,183,527803,26747364840,3653672546,30401037386
2020-04-08,G,TPG,0,0,0,0,0,0
2020-04-08,G,Total,41,201,876100,35765462492,4750295220,40515757712
2020-04-08,G,UG,3,3,0,47958766,5567526,53526292
2020-04-08,LG1,Alumni,0,0,0,0,0,0
2020-04-08,LG1,Non-HKUST,0,0,0,0,0,0
2020-04-08,LG1,Others(HKUST),3,15,863984,14782025343,2460106013,17242131356
2020-04-08,LG1,RPG,3,3,719,209358,150635,359993
2020-04-08,LG1,Staff,13,26,46640,466878855,102618804,569497659
2020-04-08,LG1,TPG,0,0,0,0,0,0
2020-04-08,LG1,Total,36,63,921242,15699773217,2588992510,18288765727
2020-04-08,LG1,UG,17,19,9899,450659661,26117058,476776719
2020-04-08,LG3,Alumni,1,2,181,5826823,971582,6798405
2020-04-08,LG3,Non-HKUST,1,1,0,898488,826531,1725019
2020-04-08,LG3,Others(HKUST),3,9,541,78920423,44744565,123664988
2020-04-08,LG3,RPG,37,38,13496,1435305320,140680959,1575986279
2020-04-08,LG3,Staff,51,76,1261,2896993807,655615880,3552609687
2020-04-08,LG3,TPG,3,4,21409,2137108900,251680456,2388789356
2020-04-08,LG3,Total,117,160,42465,16031910501,1442222252,17474132753
2020-04-08,LG3,UG,21,30,5577,9476856740,347702279,9824559019
2020-04-08,LG4,Alumni,2,3,901,5577991,754829,6332820
2020-04-08,LG4,Non-HKUST,4,4,0,80689686,27407078,108096764
2020-04-08,LG4,Others(HKUST),5,19,319484,26038368598,3702529269,29740897867
2020-04-08,LG4,RPG,33,34,0,708900774,40584543,749485317
2020-04-08,LG4,Staff,31,40,3425,483155353,160477603,643632956
2020-04-08,LG4,TPG,7,9,0,115051887,35894773,150946660
2020-04-08,LG4,Total,109,176,363054,51875979727,5262775405,57138755132
2020-04-08,LG4,UG,27,67,39244,24444235438,1295127310,25739362748
2020-04-09,1,Alumni,0,0,0,0,0,0
2020-04-09,1,Non-HKUST,1,1,0,66901,30593,97494
2020-04-09,1,Others(HKUST),1,2,541,17500707,893467,18394174
2020-04-09,1,RPG,9,9,899,99239797,12643060,111882857
2020-04-09,1,Staff,29,218,1045839,94494028251,4621936512,99115964763
2020-04-09,1,TPG,2,2,180,1486872,17256,1504128
2020-04-09,1,Total,42,232,1047459,94612322528,4635520888,99247843416
2020-04-09,1,UG,0,0,0,0,0,0
2020-04-09,All-Floors,Alumni,2,3,0,140459157,11637468,152096625
2020-04-09,All-Floors,Non-HKUST,4,4,0,58213651,4546417,62760068
2020-04-09,All-Floors,Others(HKUST),8,48,1583611,35989343414,5361177705,41350521119
2020-04-09,All-Floors,RPG,69,78,5039,2607071355,268736606,2875807961
2020-04-09,All-Floors,Staff,97,581,1713393,127271580656,15230168886,142501749542
2020-04-09,All-Floors,TPG,16,30,9355,4163641723,1243963470,5407605193
2020-04-09,All-Floors,Total,273,894,3401401,194129159086,23856781131,217985940217
2020-04-09,All-Floors,UG,77,150,90003,23898849130,1736550579,25635399709
2020-04-09,G,Alumni,0,0,0,0,0,0
2020-04-09,G,Non-HKUST,0,0,0,0,0,0
2020-04-09,G,Others(HKUST),3,8,357662,9023803938,1097030414,10120834352
2020-04-09,G,RPG,3,3,721,29679173,6889882,36569055
2020-04-09,G,Staff,28,129,511095,22428228167,4254966135,26683194302
2020-04-09,G,TPG,2,3,0,706405890,24458709,730864599
2020-04-09,G,Total,36,143,869478,32188117168,5383345140,37571462308
2020-04-09,G,UG,0,0,0,0,0,0
2020-04-09,LG1,Alumni,0,0,0,0,0,0
2020-04-09,LG1,Non-HKUST,1,1,0,663195,137433,800628
2020-04-09,LG1,Others(HKUST),2,12,864350,13550676360,2262770374,15813446734
2020-04-09,LG1,RPG,5,5,1620,47438990,4167002,51605992
2020-04-09,LG1,Staff,14,33,74375,958624093,126814677,1085438770
2020-04-09,LG1,TPG,1,1,720,8849,6326,15175
2020-04-09,LG1,Total,34,63,942864,14703773538,2409651604,17113425142
2020-04-09,LG1,UG,11,11,1799,146362051,15755792,162117843
2020-04-09,LG3,Alumni,1,1,0,131424792,10559349,141984141
2020-04-09,LG3,Non-HKUST,1,1,0,7704099,523161,8227260
2020-04-09,LG3,Others(HKUST),2,5,0,1211950,558251,1770201
2020-04-09,LG3,RPG,26,29,1260,1788549721,188516948,1977066669
2020-04-09,LG3,Staff,57,143,69296,5821260505,2814362180,8635622685
2020-04-09,LG3,TPG,8,14,3959,1645280303,603272496,2248552799
2020-04-09,LG3,Total,127,247,128161,19131341778,4765471130,23896812908
2020-04-09,LG3,UG,32,54,53646,9735910408,1147678745,10883589153
2020-04-09,LG4,Alumni,1,2,0,9034365,1078119,10112484
2020-04-09,LG4,Non-HKUST,1,1,0,49779456,3855230,53634686
2020-04-09,LG4,Others(HKUST),5,21,361058,13396150459,1999925199,15396075658
2020-04-09,LG4,RPG,30,32,539,642163674,56519714,698683388
2020-04-09,LG4,Staff,25,58,12788,3569439640,3412089382,6981529022
2020-04-09,LG4,TPG,7,10,4496,1810459809,616208683,2426668492
2020-04-09,LG4,Total,108,209,413439,33493604074,6662792369,40156396443
2020-04-09,LG4,UG,39,85,34558,14016576671,573116042,14589692713
2020-04-10,1,Alumni,0,0,0,0,0,0
2020-04-10,1,Non-HKUST,0,0,0,0,0,0
2020-04-10,1,Others(HKUST),0,0,0,0,0,0
2020-04-10,1,RPG,3,3,0,761466,250458,1011924
2020-04-10,1,Staff,6,27,634843,33368134909,1300781243,34668916152
2020-04-10,1,TPG,2,2,720,123808785,23418793,147227578
2020-04-10,1,Total,11,32,635563,33492705160,1324450494,34817155654
2020-04-10,1,UG,0,0,0,0,0,0
2020-04-10,All-Floors,Alumni,1,1,0,1695993858,61968304,1757962162
2020-04-10,All-Floors,Non-HKUST,3,3,0,10046186,6115394,16161580
2020-04-10,All-Floors,Others(HKUST),7,31,1579309,36002774483,5365293569,41368068052
2020-04-10,All-Floors,RPG,82,87,1261,2191576022,136201888,2327777910
2020-04-10,All-Floors,Staff,45,109,1053155,50391073510,3878361033,54269434543
2020-04-10,All-Floors,TPG,15,27,2517,16224755234,333036480,16557791714
2020-04-10,All-Floors,Total,232,394,2659999,127601299265,11406345252,139007644517
2020-04-10,All-Floors,UG,79,136,23757,21085079972,1625368584,22710448556
2020-04-10,G,Alumni,0,0,0,0,0,0
2020-04-10,G,Non-HKUST,1,1,0,114922,1946493,2061415
2020-04-10,G,Others(HKUST),2,4,345596,9119893314,1110718960,10230612274
2020-04-10,G,RPG,3,3,0,312460,159971,472431
2020-04-10,G,Staff,5,13,346677,15223217217,2393454543,17616671760
2020-04-10,G,TPG,1,1,0,39849314,3981049,43830363
2020-04-10,G,Total,14,24,692273,24535991507,3518990254,28054981761
2020-04-10,G,UG,2,2,0,152604280,8729238,161333518
2020-04-10,LG1,Alumni,0,0,0,0,0,0
2020-04-10,LG1,Non-HKUST,0,0,0,0,0,0
2020-04-10,LG1,Others(HKUST),2,11,864890,13695760754,2288141916,15983902670
2020-04-10,LG1,RPG,3,3,181,26700736,2844658,29545394
2020-04-10,LG1,Staff,8,8,1620,101365968,19071717,120437685
2020-04-10,LG1,TPG,2,2,179,194424,141012,335436
2020-04-10,LG1,Total,23,32,868490,13898852189,2318805304,16217657493
2020-04-10,LG1,UG,8,8,1620,74830307,8606001,83436308
2020-04-10,LG3,Alumni,0,0,0,0,0,0
2020-04-10,LG3,Non-HKUST,1,1,0,5318197,4083930,9402127
2020-04-10,LG3,Others(HKUST),1,3,0,475450,220844,696294
2020-04-10,LG3,RPG,38,39,899,1155299305,69255005,1224554310
2020-04-10,LG3,Staff,17,42,69835,1489720439,148223065,1637943504
2020-04-10,LG3,TPG,5,8,1618,15508729131,193627966,15702357097
2020-04-10,LG3,Total,96,133,76849,22466451881,786893225,23253345106
2020-04-10,LG3,UG,34,40,4497,4306909359,371482415,4678391774
2020-04-10,LG4,Alumni,1,1,0,1695993858,61968304,1757962162
2020-04-10,LG4,Non-HKUST,1,1,0,4613067,84971,4698038
2020-04-10,LG4,Others(HKUST),4,13,368823,13186644965,1966211849,15152856814
2020-04-10,LG4,RPG,38,39,181,1008502055,63691796,1072193851
2020-04-10,LG4,Staff,16,19,180,208634977,16830465,225465442
2020-04-10,LG4,TPG,8,14,0,552173580,111867660,664041240
2020-04-10,LG4,Total,112,173,386824,33207298528,3457205975,36664504503
2020-04-10,LG4,UG,44,86,17640,16550736026,1236550930,17787286956
2020-04-11,1,Alumni,0,0,0,0,0,0
2020-04-11,1,Non-HKUST,1,1,719,475179,172773,647952
2020-04-11,1,Others(HKUST),0,0,0,0,0,0
2020-04-11,1,RPG,2,2,0,4844456,652866,5497322
2020-04-11,1,Staff,9,51,541072,36784695232,1403886857,38188582089
2020-04-11,1,TPG,0,0,0,0,0,0
2020-04-11,1,Total,13,55,542511,36790069180,1404794655,38194863835
2020-04-11,1,UG,1,1,720,54313,82159,136472
2020-04-11,All-Floors,Alumni,2,2,180,7540761,3084177,10624938
2020-04-11,All-Floors,Non-HKUST,1,1,719,475179,172773,647952
2020-04-11,All-Floors,Others(HKUST),6,27,1391205,32525318561,4765796786,37291115347
2020-04-11,All-Floors,RPG,59,69,3062,2880033749,145449805,3025483554
2020-04-11,All-Floors,Staff,33,144,882532,50119817131,3457150601,53576967732
2020-04-11,All-Floors,TPG,9,10,362,329885979,22053536,351939515
2020-04-11,All-Floors,Total,172,343,2334767,101798169739,9029304164,110827473903
2020-04-11,All-Floors,UG,62,90,56707,15935098379,635596486,16570694865
2020-04-11,G,Alumni,0,0,0,0,0,0
2020-04-11,G,Non-HKUST,0,0,0,0,0,0
2020-04-11,G,Others(HKUST),2,3,259197,6667912343,858526080,7526438423
2020-04-11,G,RPG,5,5,899,104161893,6464801,110626694
2020-04-11,G,Staff,6,22,265498,13059130149,2021877184,15081007333
2020-04-11,G,TPG,0,0,0,0,0,0
2020-04-11,G,Total,15,32,525594,19831365900,2886967290,22718333190
2020-04-11,G,UG,2,2,0,161515,99225,260740
2020-04-11,LG1,Alumni,0,0,0,0,0,0
2020-04-11,LG1,Non-HKUST,0,0,0,0,0,0
2020-04-11,LG1,Others(HKUST),3,11,778131,12595282759,2085661871,14680944630
2020-04-11,LG1,RPG,0,0,0,0,0,0
2020-04-11,LG1,Staff,6,8,2880,52885240,10384595,63269835
2020-04-11,LG1,TPG,2,2,182,7119974,5176164,12296138
2020-04-11,LG1,Total,18,30,782633,14169999136,2138756247,16308755383
2020-04-11,LG1,UG,7,9,1440,1514711163,37533617,1552244780
2020-04-11,LG3,Alumni,1,1,180,7522672,3080709,10603381
2020-04-11,LG3,Non-HKUST,0,0,0,0,0,0
2020-04-11,LG3,Others(HKUST),2,4,0,12643924,1052922,13696846
2020-04-11,LG3,RPG,29,32,1620,2061485050,80410151,2141895201
2020-04-11,LG3,Staff,13,58,73082,222266515,20627756,242894271
2020-04-11,LG3,TPG,4,4,180,296398879,12420175,308819054
2020-04-11,LG3,Total,71,126,90359,4005866809,186650097,4192516906
2020-04-11,LG3,UG,22,27,15297,1405549769,69058384,1474608153
2020-04-11,LG4,Alumni,1,1,0,18089,3468,21557
2020-04-11,LG4,Non-HKUST,0,0,0,0,0,0
2020-04-11,LG4,Others(HKUST),2,9,353877,13249479535,1820555913,15070035448
2020-04-11,LG4,RPG,27,30,543,709542350,57921987,767464337
2020-04-11,LG4,Staff,5,5,0,839995,374209,1214204
2020-04-11,LG4,TPG,4,4,0,26367126,4457197,30824323
2020-04-11,LG4,Total,73,100,393670,27000868714,2412135875,29413004589
2020-04-11,LG4,UG,34,51,39250,13014621619,528823101,13543444720
2020-04-12,1,Alumni,0,0,0,0,0,0
2020-04-12,1,Non-HKUST,0,0,0,0,0,0
2020-04-12,1,Others(HKUST),0,0,0,0,0,0
2020-04-12,1,RPG,3,3,0,1679226262,9164118,1688390380
2020-04-12,1,Staff,8,38,613078,33535171541,1332873188,34868044729
2020-04-12,1,TPG,0,0,0,0,0,0
2020-04-12,1,Total,14,44,613438,35214716700,1342131635,36556848335
2020-04-12,1,UG,3,3,360,318897,94329,413226
2020-04-12,All-Floors,Alumni,0,0,0,0,0,0
2020-04-12,All-Floors,Non-HKUST,1,2,0,13583946,2851371,16435317
2020-04-12,All-Floors,Others(HKUST),5,36,1289096,34783333294,4861609710,39644943004
2020-04-12,All-Floors,RPG,57,64,2160,3421342268,647484528,4068826796
2020-04-12,All-Floors,Staff,36,108,1027080,53143883287,4423950660,57567833947
2020-04-12,All-Floors,TPG,13,17,540,429035305,27497987,456533292
2020-04-12,All-Floors,Total,178,358,2382062,106359089057,11911554630,118270643687
2020-04-12,All-Floors,UG,66,131,63186,14567910957,1948160374,16516071331
2020-04-12,G,Alumni,0,0,0,0,0,0
2020-04-12,G,Non-HKUST,0,0,0,0,0,0
2020-04-12,G,Others(HKUST),2,4,258830,9855926156,1109055427,10964981583
2020-04-12,G,RPG,1,1,0,10630304,1259309,11889613
2020-04-12,G,Staff,8,16,347390,18505808278,3049141404,21554949682
2020-04-12,G,TPG,0,0,0,0,0,0
2020-04-12,G,Total,12,22,606220,28374777386,4159888238,32534665624
2020-04-12,G,UG,1,1,0,2412648,432098,2844746
2020-04-12,LG1,Alumni,0,0,0,0,0,0
2020-04-12,LG1,Non-HKUST,0,0,0,0,0,0
2020-04-12,LG1,Others(HKUST),2,9,604424,11115066890,1867037154,12982104044
2020-04-12,LG1,RPG,5,5,1800,17370833,3001312,20372145
2020-04-12,LG1,Staff,4,4,720,587064,514861,1101925
2020-04-12,LG1,TPG,1,1,540,317859,179119,496978
2020-04-12,LG1,Total,19,27,612523,11324788431,1953572686,13278361117
2020-04-12,LG1,UG,7,8,5039,191445785,82840240,274286025
2020-04-12,LG3,Alumni,0,0,0,0,0,0
2020-04-12,LG3,Non-HKUST,1,2,0,13583946,2851371,16435317
2020-04-12,LG3,Others(HKUST),2,7,6478,268407174,5499126,273906300
2020-04-12,LG3,RPG,30,31,360,1129421521,87374700,1216796221
2020-04-12,LG3,Staff,13,43,65892,967309961,36807970,1004117931
2020-04-12,LG3,TPG,4,6,0,129368324,14043720,143412044
2020-04-12,LG3,Total,74,125,110534,4855483122,357508112,5212991234
2020-04-12,LG3,UG,24,36,37804,2347392196,210931225,2558323421
2020-04-12,LG4,Alumni,0,0,0,0,0,0
2020-04-12,LG4,Non-HKUST,0,0,0,0,0,0
2020-04-12,LG4,Others(HKUST),3,16,419364,13543933074,1880018003,15423951077
2020-04-12,LG4,RPG,22,24,0,584693348,546685089,1131378437
2020-04-12,LG4,Staff,7,7,0,135006443,4613237,139619680
2020-04-12,LG4,TPG,8,10,0,299349122,13275148,312624270
2020-04-12,LG4,Total,77,140,439347,26589323418,4098453959,30687777377
2020-04-12,LG4,UG,37,83,19983,12026341431,1653862482,13680203913
2020-04-13,1,Alumni,0,0,0,0,0,0
2020-04-13,1,Non-HKUST,0,0,0,0,0,0
2020-04-13,1,Others(HKUST),0,0,0,0,0,0
2020-04-13,1,RPG,4,4,1080,440805113,9808566,450613679
2020-04-13,1,Staff,6,33,589291,33471896432,1292250413,34764146845
2020-04-13,1,TPG,4,5,1079,72247971,3684429,75932400
2020-04-13,1,Total,17,45,592170,33993852758,1307223427,35301076185
2020-04-13,1,UG,3,3,720,8903242,1480019,10383261
2020-04-13,All-Floors,Alumni,2,3,180,103241731,11020477,114262208
2020-04-13,All-Floors,Non-HKUST,1,1,0,243507,127745,371252
2020-04-13,All-Floors,Others(HKUST),6,31,1329256,36445577090,5331331677,41776908767
2020-04-13,All-Floors,RPG,72,81,5938,2431076520,153085110,2584161630
2020-04-13,All-Floors,Staff,36,105,925171,45366790032,3176724132,48543514164
2020-04-13,All-Floors,TPG,10,12,1799,1018726977,42715511,1061442488
2020-04-13,All-Floors,Total,174,340,2335615,134058939882,10493657683,144552597565
2020-04-13,All-Floors,UG,47,107,73271,48693284025,1778653031,50471937056
2020-04-13,G,Alumni,0,0,0,0,0,0
2020-04-13,G,Non-HKUST,0,0,0,0,0,0
2020-04-13,G,Others(HKUST),2,5,345227,11829888811,1461699411,13291588222
2020-04-13,G,RPG,2,2,900,84123467,15370926,99494393
2020-04-13,G,Staff,8,12,282782,10924232768,1804951753,12729184521
2020-04-13,G,TPG,0,0,0,0,0,0
2020-04-13,G,Total,15,23,629269,22876498707,3287828099,26164326806
2020-04-13,G,UG,3,4,360,38253661,5806009,44059670
2020-04-13,LG1,Alumni,0,0,0,0,0,0
2020-04-13,LG1,Non-HKUST,0,0,0,0,0,0
2020-04-13,LG1,Others(HKUST),2,13,776484,16846827196,2828707883,19675535079
2020-04-13,LG1,RPG,5,5,1260,12484233,733750,13217983
2020-04-13,LG1,Staff,4,4,900,142081986,3984181,146066167
2020-04-13,LG1,TPG,0,0,0,0,0,0
2020-04-13,LG1,Total,18,30,782786,17362390608,2853368994,20215759602
2020-04-13,LG1,UG,7,8,4142,360997193,19943180,380940373
2020-04-13,LG3,Alumni,0,0,0,0,0,0
2020-04-13,LG3,Non-HKUST,1,1,0,243507,127745,371252
2020-04-13,LG3,Others(HKUST),2,6,5759,576821484,35248169,612069653
2020-04-13,LG3,RPG,35,36,2518,1067190894,80678636,1147869530
2020-04-13,LG3,Staff,11,47,52018,814624645,73333143,887957788
2020-04-13,LG3,TPG,5,5,0,946194238,38856619,985050857
2020-04-13,LG3,Total,76,127,89998,29217971666,832049688,30050021354
2020-04-13,LG3,UG,22,32,29703,25812896898,603805376,26416702274
2020-04-13,LG4,Alumni,2,3,180,103241731,11020477,114262208
2020-04-13,LG4,Non-HKUST,0,0,0,0,0,0
2020-04-13,LG4,Others(HKUST),3,7,201786,7192039599,1005676214,8197715813
2020-04-13,LG4,RPG,33,34,180,826472813,46493232,872966045
2020-04-13,LG4,Staff,9,9,180,13954201,2204642,16158843
2020-04-13,LG4,TPG,2,2,720,284768,174463,459231
2020-04-13,LG4,Total,70,115,241392,30608226143,2213187475,32821413618
2020-04-13,LG4,UG,21,60,38346,22472233031,1147618447,23619851478
2020-04-14,1,Alumni,0,0,0,0,0,0
2020-04-14,1,Non-HKUST,0,0,0,0,0,0
2020-04-14,1,Others(HKUST),2,3,180,5256221,744048,6000269
2020-04-14,1,RPG,2,2,0,63935352,3443095,67378447
2020-04-14,1,Staff,38,371,1080679,53954275089,5057625389,59011900478
2020-04-14,1,TPG,0,0,0,0,0,0
2020-04-14,1,Total,44,378,1081039,54023787414,5062053156,59085840570
2020-04-14,1,UG,2,2,180,320752,240624,561376
2020-04-14,All-Floors,Alumni,1,2,0,544131193,17757941764,18302072957
2020-04-14,All-Floors,Non-HKUST,2,2,0,188156504,8616622,196773126
2020-04-14,All-Floors,Others(HKUST),11,53,1572805,45979621182,6608744827,52588366009
2020-04-14,All-Floors,RPG,78,89,2878,3091887253,178328465,3270215718
2020-04-14,All-Floors,Staff,123,973,1796499,100968334393,13928855949,114897190342
2020-04-14,All-Floors,TPG,12,22,3962,6425831662,1268980247,7694811909
2020-04-14,All-Floors,Total,288,1273,3457866,261059236021,60218550820,321277786841
2020-04-14,All-Floors,UG,61,132,81722,103861273834,20467082946,124328356780
2020-04-14,G,Alumni,0,0,0,0,0,0
2020-04-14,G,Non-HKUST,0,0,0,0,0,0
2020-04-14,G,Others(HKUST),3,10,358562,9912491266,1182070983,11094562249
2020-04-14,G,RPG,2,2,0,114967318,8884958,123852276
2020-04-14,G,Staff,38,256,629575,36089603158,7128170288,43217773446
2020-04-14,G,TPG,0,0,0,0,0,0
2020-04-14,G,Total,43,268,988137,46117061742,8319126229,54436187971
2020-04-14,G,UG,0,0,0,0,0,0
2020-04-14,LG1,Alumni,0,0,0,0,0,0
2020-04-14,LG1,Non-HKUST,0,0,0,0,0,0
2020-04-14,LG1,Others(HKUST),5,17,865062,16034375036,2638517183,18672892219
2020-04-14,LG1,RPG,3,3,1257,1355163,1043624,2398787
2020-04-14,LG1,Staff,17,115,71483,2367786711,599410214,2967196925
2020-04-14,LG1,TPG,0,0,0,0,0,0
2020-04-14,LG1,Total,32,143,941041,21060357539,3324889007,24385246546
2020-04-14,LG1,UG,7,8,3239,2656840629,85917986,2742758615
2020-04-14,LG3,Alumni,0,0,0,0,0,0
2020-04-14,LG3,Non-HKUST,2,2,0,188156504,8616622,196773126
2020-04-14,LG3,Others(HKUST),2,2,181,5175352,819204,5994556
2020-04-14,LG3,RPG,37,39,1621,1332931688,73520091,1406451779
2020-04-14,LG3,Staff,75,177,6123,6800493660,995454998,7795948658
2020-04-14,LG3,TPG,9,15,3962,6007710459,1244589841,7252300300
2020-04-14,LG3,Total,148,269,19445,48136315638,10252170064,58388485702
2020-04-14,LG3,UG,23,34,7558,33801847975,7929169308,41731017283
2020-04-14,LG4,Alumni,1,2,0,544131193,17757941764,18302072957
2020-04-14,LG4,Non-HKUST,0,0,0,0,0,0
2020-04-14,LG4,Others(HKUST),5,21,348820,20022323307,2786593409,22808916716
2020-04-14,LG4,RPG,39,43,0,1578697732,91436697,1670134429
2020-04-14,LG4,Staff,36,54,8639,1756175775,148195060,1904370835
2020-04-14,LG4,TPG,5,7,0,418121203,24390406,442511609
2020-04-14,LG4,Total,119,215,428204,91721713688,33260312364,124982026052
2020-04-14,LG4,UG,33,88,70745,67402264478,12451755028,79854019506
2020-04-15,1,Alumni,0,0,0,0,0,0
2020-04-15,1,Non-HKUST,0,0,0,0,0,0
2020-04-15,1,Others(HKUST),3,20,38181,3725331286,68516479,3793847765
2020-04-15,1,RPG,8,8,4494,16217460,6492780,22710240
2020-04-15,1,Staff,38,280,1211895,70820275663,3941521863,74761797526
2020-04-15,1,TPG,0,0,0,0,0,0
2020-04-15,1,Total,53,312,1256011,74664504648,4067312173,78731816821
2020-04-15,1,UG,4,4,1441,102680239,50781051,153461290
2020-04-15,All-Floors,Alumni,3,8,33641,2252940276,125964261,2378904537
2020-04-15,All-Floors,Non-HKUST,1,2,0,631471,341454,972925
2020-04-15,All-Floors,Others(HKUST),10,76,1617847,42837302160,5646929698,48484231858
2020-04-15,All-Floors,RPG,77,84,7914,3124134695,212549264,3336683959
2020-04-15,All-Floors,Staff,107,669,1801883,92378072969,7851333440,100229406409
2020-04-15,All-Floors,TPG,10,20,25897,5733746281,635510351,6369256632
2020-04-15,All-Floors,Total,271,975,3593729,180731819622,16944405553,197676225175
2020-04-15,All-Floors,UG,63,116,106547,34404991770,2471777085,36876768855
2020-04-15,G,Alumni,0,0,0,0,0,0
2020-04-15,G,Non-HKUST,0,0,0,0,0,0
2020-04-15,G,Others(HKUST),5,13,359102,10025024695,1214501021,11239525716
2020-04-15,G,RPG,1,1,0,103080,67849,170929
2020-04-15,G,Staff,32,163,458598,14837364272,2231675058,17069039330
2020-04-15,G,TPG,0,0,0,0,0,0
2020-04-15,G,Total,41,180,817700,24864100231,3447272790,28311373021
2020-04-15,G,UG,3,3,0,1608184,1028862,2637046
2020-04-15,LG1,Alumni,0,0,0,0,0,0
2020-04-15,LG1,Non-HKUST,0,0,0,0,0,0
2020-04-15,LG1,Others(HKUST),3,14,865612,14566553639,2420872612,16987426251
2020-04-15,LG1,RPG,4,4,361,43101285,2618905,45720190
2020-04-15,LG1,Staff,16,35,50779,1161293492,841088062,2002381554
2020-04-15,LG1,TPG,0,0,0,0,0,0
2020-04-15,LG1,Total,28,58,919091,15913858203,3275932927,19189791130
2020-04-15,LG1,UG,5,5,2339,142909787,11353348,154263135
2020-04-15,LG3,Alumni,2,7,33641,2250505153,125529344,2376034497
2020-04-15,LG3,Non-HKUST,1,1,0,324218,180209,504427
2020-04-15,LG3,Others(HKUST),3,8,0,76321018,9385833,85706851
2020-04-15,LG3,RPG,33,34,2337,2196373845,117287235,2313661080
2020-04-15,LG3,Staff,59,150,77010,4781194189,736675473,5517869662
2020-04-15,LG3,TPG,9,17,25897,5293581622,618747580,5912329202
2020-04-15,LG3,Total,131,258,169666,28894151581,2614957937,31509109518
2020-04-15,LG3,UG,24,41,30781,14295851536,1007152263,15303003799
2020-04-15,LG4,Alumni,1,1,0,2435123,434917,2870040
2020-04-15,LG4,Non-HKUST,1,1,0,307253,161245,468498
2020-04-15,LG4,Others(HKUST),6,21,354952,14444071522,1933653753,16377725275
2020-04-15,LG4,RPG,36,37,722,868339025,86082495,954421520
2020-04-15,LG4,Staff,26,41,3601,777945353,100372984,878318337
2020-04-15,LG4,TPG,3,3,0,440164659,16762771,456927430
2020-04-15,LG4,Total,104,167,431261,36395204959,3538929726,39934134685
2020-04-15,LG4,UG,31,63,71986,19861942024,1401461561,21263403585
2020-04-16,1,Alumni,0,0,0,0,0,0
2020-04-16,1,Non-HKUST,0,0,0,0,0,0
2020-04-16,1,Others(HKUST),1,1,360,1849403,315697,2165100
2020-04-16,1,RPG,9,9,3063,18754851,15914886,34669737
2020-04-16,1,Staff,37,295,1217358,73264364224,5614304770,78878668994
2020-04-16,1,TPG,1,1,361,2044681,499091,2543772
2020-04-16,1,Total,50,308,1221142,73287059251,5631077023,78918136274
2020-04-16,1,UG,2,2,0,46092,42579,88671
2020-04-16,All-Floors,Alumni,1,5,20331,1401971651,119351312,1521322963
2020-04-16,All-Floors,Non-HKUST,0,0,0,0,0,0
2020-04-16,All-Floors,Others(HKUST),9,40,1559327,38537220419,5524839191,44062059610
2020-04-16,All-Floors,RPG,76,78,5764,4792752080,384089160,5176841240
2020-04-16,All-Floors,Staff,110,698,1808826,92663543157,9910195666,102573738823
2020-04-16,All-Floors,TPG,15,18,3963,1014144178,66081239,1080225417
2020-04-16,All-Floors,Total,290,971,3518807,181446872727,20150561926,201597434653
2020-04-16,All-Floors,UG,79,132,120596,43037241242,4146005358,47183246600
2020-04-16,G,Alumni,0,0,0,0,0,0
2020-04-16,G,Non-HKUST,0,0,0,0,0,0
2020-04-16,G,Others(HKUST),5,11,349201,10090469505,1214467201,11304936706
2020-04-16,G,RPG,4,4,180,20000150,1462709,21462859
2020-04-16,G,Staff,35,164,428902,14899708058,2478166577,17377874635
2020-04-16,G,TPG,0,0,0,0,0,0
2020-04-16,G,Total,46,181,778283,25138198408,3696529551,28834727959
2020-04-16,G,UG,2,2,0,128020695,2433064,130453759
2020-04-16,LG1,Alumni,0,0,0,0,0,0
2020-04-16,LG1,Non-HKUST,0,0,0,0,0,0
2020-04-16,LG1,Others(HKUST),3,15,864170,14813929823,2448250160,17262179983
2020-04-16,LG1,RPG,3,3,0,70336937,2457720,72794657
2020-04-16,LG1,Staff,14,46,79416,993169924,103885088,1097055012
2020-04-16,LG1,TPG,1,1,540,50066,20048,70114
2020-04-16,LG1,Total,32,77,946466,16339751105,2569482493,18909233598
2020-04-16,LG1,UG,11,12,2340,462264355,14869477,477133832
2020-04-16,LG3,Alumni,1,5,20331,1401971651,119351312,1521322963
2020-04-16,LG3,Non-HKUST,0,0,0,0,0,0
2020-04-16,LG3,Others(HKUST),4,6,0,106197047,4312287,110509334
2020-04-16,LG3,RPG,34,35,899,3434810117,248563650,3683373767
2020-04-16,LG3,Staff,60,138,65863,2322990618,560075290,2883065908
2020-04-16,LG3,TPG,6,6,0,221301258,18863266,240164524
2020-04-16,LG3,Total,139,241,138568,24361416129,3943141026,28304557155
2020-04-16,LG3,UG,34,51,51475,16874145438,2991975221,19866120659
2020-04-16,LG4,Alumni,0,0,0,0,0,0
2020-04-16,LG4,Non-HKUST,0,0,0,0,0,0
2020-04-16,LG4,Others(HKUST),3,7,345596,13524774641,1857493846,15382268487
2020-04-16,LG4,RPG,27,27,1622,1248850025,115690195,1364540220
2020-04-16,LG4,Staff,30,55,17287,1183310333,1153763941,2337074274
2020-04-16,LG4,TPG,8,10,3062,790748173,46698834,837447007
2020-04-16,LG4,Total,103,164,434348,42320447834,4310331833,46630779667
2020-04-16,LG4,UG,35,65,66781,25572764662,1136685017,26709449679
2020-04-17,1,Alumni,0,0,0,0,0,0
2020-04-17,1,Non-HKUST,0,0,0,0,0,0
2020-04-17,1,Others(HKUST),1,1,360,6630264,341075,6971339
2020-04-17,1,RPG,4,4,1619,824965,476277,1301242
2020-04-17,1,Staff,29,245,898100,52451709055,7880823694,60332532749
2020-04-17,1,TPG,1,1,359,16998,12698,29696
2020-04-17,1,Total,37,253,900438,52459763066,7881877196,60341640262
2020-04-17,1,UG,2,2,0,581784,223452,805236
2020-04-17,All-Floors,Alumni,0,0,0,0,0,0
2020-04-17,All-Floors,Non-HKUST,3,3,0,2041761,776728,2818489
2020-04-17,All-Floors,Others(HKUST),14,53,1436893,36938862282,5090335840,42029198122
2020-04-17,All-Floors,RPG,79,87,7562,2972870548,285691736,3258562284
2020-04-17,All-Floors,Staff,106,710,1515292,89671607252,24060186900,113731794152
2020-04-17,All-Floors,TPG,13,18,32754,4834623428,554404424,5389027852
2020-04-17,All-Floors,Total,281,1003,3088424,177186062118,33702764246,210888826364
2020-04-17,All-Floors,UG,66,132,95923,42766056847,3711368618,46477425465
2020-04-17,G,Alumni,0,0,0,0,0,0
2020-04-17,G,Non-HKUST,0,0,0,0,0,0
2020-04-17,G,Others(HKUST),4,10,311726,7773877053,957002722,8730879775
2020-04-17,G,RPG,2,2,720,11696565,1331014,13027579
2020-04-17,G,Staff,32,193,460145,19662977938,11827701816,31490679754
2020-04-17,G,TPG,1,1,0,21114,12634,33748
2020-04-17,G,Total,39,206,772591,27448572670,12786048186,40234620856
2020-04-17,G,UG,0,0,0,0,0,0
2020-04-17,LG1,Alumni,0,0,0,0,0,0
2020-04-17,LG1,Non-HKUST,0,0,0,0,0,0
2020-04-17,LG1,Others(HKUST),2,11,778490,13615869274,2229165076,15845034350
2020-04-17,LG1,RPG,3,3,0,20600493,1691917,22292410
2020-04-17,LG1,Staff,17,61,79240,3772987219,236153758,4009140977
2020-04-17,LG1,TPG,0,0,0,0,0,0
2020-04-17,LG1,Total,30,83,861690,18605262476,2545120448,21150382924
2020-04-17,LG1,UG,8,8,3960,1195805490,78109697,1273915187
2020-04-17,LG3,Alumni,0,0,0,0,0,0
2020-04-17,LG3,Non-HKUST,2,2,0,495405,286325,781730
2020-04-17,LG3,Others(HKUST),7,11,0,1841871807,27489094,1869360901
2020-04-17,LG3,RPG,34,36,3242,1486233040,104489629,1590722669
2020-04-17,LG3,Staff,57,151,58718,11076103661,2672810756,13748914417
2020-04-17,LG3,TPG,7,11,32395,4741695203,544312628,5286007831
2020-04-17,LG3,Total,135,252,124041,32486875300,4390613062,36877488362
2020-04-17,LG3,UG,28,41,29686,13340476184,1041224630,14381700814
2020-04-17,LG4,Alumni,0,0,0,0,0,0
2020-04-17,LG4,Non-HKUST,1,1,0,1546356,490403,2036759
2020-04-17,LG4,Others(HKUST),8,20,346317,13700613884,1876337873,15576951757
2020-04-17,LG4,RPG,42,42,1981,1453515485,177702899,1631218384
2020-04-17,LG4,Staff,23,60,19089,2707829379,1442696876,4150526255
2020-04-17,LG4,TPG,5,5,0,92890113,10066464,102956577
2020-04-17,LG4,Total,111,209,429664,46185588606,6099105354,52284693960
2020-04-17,LG4,UG,32,81,62277,28229193389,2591810839,30821004228
2020-04-18,1,Alumni,1,1,721,186698112,12035814,198733926
2020-04-18,1,Non-HKUST,0,0,0,0,0,0
2020-04-18,1,Others(HKUST),0,0,0,0,0,0
2020-04-18,1,RPG,4,4,1440,117716349,12893938,130610287
2020-04-18,1,Staff,7,78,617573,38965510785,1938565624,40904076409
2020-04-18,1,TPG,1,1,0,22863,19226,42089
2020-04-18,1,Total,14,85,619734,39270129279,1963552160,41233681439
2020-04-18,1,UG,1,1,0,181170,37558,218728
2020-04-18,All-Floors,Alumni,2,4,16019,193753261,98854280,292607541
2020-04-18,All-Floors,Non-HKUST,4,4,540,3113812205,98849517,3212661722
2020-04-18,All-Floors,Others(HKUST),10,42,1392069,39225226663,5835190825,45060417488
2020-04-18,All-Floors,RPG,68,96,33845,9885164266,1078737205,10963901471
2020-04-18,All-Floors,Staff,35,246,830698,52877109580,5274471566,58151581146
2020-04-18,All-Floors,TPG,4,4,360,1446707,624821,2071528
2020-04-18,All-Floors,Total,194,513,2364805,118576622848,14020502640,132597125488
2020-04-18,All-Floors,UG,71,117,91274,13280110166,1633774426,14913884592
2020-04-18,G,Alumni,0,0,0,0,0,0
2020-04-18,G,Non-HKUST,0,0,0,0,0,0
2020-04-18,G,Others(HKUST),2,6,431626,11636058163,1244170242,12880228405
2020-04-18,G,RPG,1,1,0,7485757,1200294,8686051
2020-04-18,G,Staff,6,55,181079,9892627723,2128328537,12020956260
2020-04-18,G,TPG,0,0,0,0,0,0
2020-04-18,G,Total,11,64,612705,22269330936,3402529167,25671860103
2020-04-18,G,UG,2,2,0,733159293,28830094,761989387
2020-04-18,LG1,Alumni,0,0,0,0,0,0
2020-04-18,LG1,Non-HKUST,0,0,0,0,0,0
2020-04-18,LG1,Others(HKUST),2,9,604424,11964986071,1995070703,13960056774
2020-04-18,LG1,RPG,1,1,0,7139,5800,12939
2020-04-18,LG1,Staff,6,12,541,140935229,32461524,173396753
2020-04-18,LG1,TPG,0,0,0,0,0,0
2020-04-18,LG1,Total,12,25,607124,12144532444,2032668965,14177201409
2020-04-18,LG1,UG,3,3,2159,38604005,5130938,43734943
2020-04-18,LG3,Alumni,1,3,15298,7055149,86818466,93873615
2020-04-18,LG3,Non-HKUST,2,2,540,133182817,2284840,135467657
2020-04-18,LG3,Others(HKUST),5,6,0,1009744,1033834,2043578
2020-04-18,LG3,RPG,32,46,14580,6559021134,483052443,7042073577
2020-04-18,LG3,Staff,17,75,21426,3391961291,787293880,4179255171
2020-04-18,LG3,TPG,3,3,360,1423844,605595,2029439
2020-04-18,LG3,Total,92,182,105304,14465654908,2513811092,16979466000
2020-04-18,LG3,UG,32,47,53100,4372000929,1152722034,5524722963
2020-04-18,LG4,Alumni,0,0,0,0,0,0
2020-04-18,LG4,Non-HKUST,2,2,0,2980629388,96564677,3077194065
2020-04-18,LG4,Others(HKUST),5,21,356019,15623172685,2594916046,18218088731
2020-04-18,LG4,RPG,33,44,17825,3200933887,581584730,3782518617
2020-04-18,LG4,Staff,11,26,10079,486074552,387822001,873896553
2020-04-18,LG4,TPG,0,0,0,0,0,0
2020-04-18,LG4,Total,88,157,419938,30426975281,4107941256,34534916537
2020-04-18,LG4,UG,37,64,36015,8136164769,447053802,8583218571
2020-04-19,1,Alumni,0,0,0,0,0,0
2020-04-19,1,Non-HKUST,0,0,0,0,0,0
2020-04-19,1,Others(HKUST),0,0,0,0,0,0
2020-04-19,1,RPG,5,5,2159,16730213,2834827,19565040
2020-04-19,1,Staff,4,28,593266,33873422568,1357793272,35231215840
2020-04-19,1,TPG,0,0,0,0,0,0
2020-04-19,1,Total,10,34,595605,33890390123,1360753440,35251143563
2020-04-19,1,UG,1,1,180,237342,125341,362683
2020-04-19,All-Floors,Alumni,3,8,34017,1578251614,262950566,1841202180
2020-04-19,All-Floors,Non-HKUST,3,3,0,23475604,3550018,27025622
2020-04-19,All-Floors,Others(HKUST),7,33,1495210,43035558999,5946168340,48981727339
2020-04-19,All-Floors,RPG,61,66,7022,2355537163,125846122,2481383285
2020-04-19,All-Floors,Staff,25,51,681106,38483934528,2137112916,40621047444
2020-04-19,All-Floors,TPG,11,13,900,3836815798,230916544,4067732342
2020-04-19,All-Floors,Total,167,304,2289363,119349773481,10997418160,130347191641
2020-04-19,All-Floors,UG,57,130,71108,30036199775,2290873654,32327073429
2020-04-19,G,Alumni,0,0,0,0,0,0
2020-04-19,G,Non-HKUST,1,1,0,8370816,1587887,9958703
2020-04-19,G,Others(HKUST),2,7,518025,13398027403,1604407639,15002435042
2020-04-19,G,RPG,0,0,0,0,0,0
2020-04-19,G,Staff,6,6,87121,4521924421,751082025,5273006446
2020-04-19,G,TPG,0,0,0,0,0,0
2020-04-19,G,Total,9,14,605146,17928322640,2357077551,20285400191
2020-04-19,G,UG,0,0,0,0,0,0
2020-04-19,LG1,Alumni,0,0,0,0,0,0
2020-04-19,LG1,Non-HKUST,0,0,0,0,0,0
2020-04-19,LG1,Others(HKUST),2,13,776484,18184626422,3030792482,21215418904
2020-04-19,LG1,RPG,6,6,1622,2389821,915948,3305769
2020-04-19,LG1,Staff,4,4,719,28850293,6353220,35203513
2020-04-19,LG1,TPG,0,0,0,0,0,0
2020-04-19,LG1,Total,15,26,779546,19311179248,3078483130,22389662378
2020-04-19,LG1,UG,3,3,721,1095312712,40421480,1135734192
2020-04-19,LG3,Alumni,1,4,19799,563494498,50038013,613532511
2020-04-19,LG3,Non-HKUST,1,1,0,6248060,229980,6478040
2020-04-19,LG3,Others(HKUST),3,3,720,2072941,164570,2237511
2020-04-19,LG3,RPG,28,29,3241,951512364,69491531,1021003895
2020-04-19,LG3,Staff,9,9,0,20400218,4506001,24906219
2020-04-19,LG3,TPG,6,8,900,3725029401,223925504,3948954905
2020-04-19,LG3,Total,78,102,60850,14163779632,1222072848,15385852480
2020-04-19,LG3,UG,30,48,36190,8895022150,873717249,9768739399
2020-04-19,LG4,Alumni,2,4,14218,1014757116,212912553,1227669669
2020-04-19,LG4,Non-HKUST,1,1,0,8856728,1732151,10588879
2020-04-19,LG4,Others(HKUST),3,10,199981,11450832233,1310803649,12761635882
2020-04-19,LG4,RPG,24,26,0,1384904765,52603816,1437508581
2020-04-19,LG4,Staff,4,4,0,39337028,17378398,56715426
2020-04-19,LG4,TPG,5,5,0,111786397,6991040,118777437
2020-04-19,LG4,Total,69,128,248216,34056101838,2979031191,37035133029
2020-04-19,LG4,UG,30,78,34017,20045627571,1376609584,21422237155
2020-04-20,1,Alumni,0,0,0,0,0,0
2020-04-20,1,Non-HKUST,0,0,0,0,0,0
2020-04-20,1,Others(HKUST),1,2,0,6048392,682752,6731144
2020-04-20,1,RPG,5,5,1080,171429543,13417134,184846677
2020-04-20,1,Staff,32,329,1064638,83643651345,5928252603,89571903948
2020-04-20,1,TPG,2,2,720,9881772,354126,10235898
2020-04-20,1,Total,43,341,1066438,83831044513,5942727153,89773771666
2020-04-20,1,UG,3,3,0,33461,20538,53999
2020-04-20,All-Floors,Alumni,2,2,0,4165934,29825817,33991751
2020-04-20,All-Floors,Non-HKUST,4,5,0,31630991,4157083,35788074
2020-04-20,All-Floors,Others(HKUST),10,63,1720570,58910072245,7970759058,66880831303
2020-04-20,All-Floors,RPG,77,85,3961,4652995919,415749030,5068744949
2020-04-20,All-Floors,Staff,117,903,1680445,146109162227,13440798361,159549960588
2020-04-20,All-Floors,TPG,13,24,65144,16473092290,704563040,17177655330
2020-04-20,All-Floors,Total,289,1215,3544821,284267627498,25216214250,309483841748
2020-04-20,All-Floors,UG,66,133,74701,58086507892,2650361861,60736869753
2020-04-20,G,Alumni,0,0,0,0,0,0
2020-04-20,G,Non-HKUST,0,0,0,0,0,0
2020-04-20,G,Others(HKUST),5,15,498578,11525334866,1311154373,12836489239
2020-04-20,G,RPG,2,2,0,10384607,1073758,11458365
2020-04-20,G,Staff,35,246,469578,25519898674,4889036631,30408935305
2020-04-20,G,TPG,0,0,0,0,0,0
2020-04-20,G,Total,42,263,968156,37055618147,6201264762,43256882909
2020-04-20,G,UG,0,0,0,0,0,0
2020-04-20,LG1,Alumni,0,0,0,0,0,0
2020-04-20,LG1,Non-HKUST,0,0,0,0,0,0
2020-04-20,LG1,Others(HKUST),4,23,875333,18803334918,2869021407,21672356325
2020-04-20,LG1,RPG,2,2,540,394592356,189102372,583694728
2020-04-20,LG1,Staff,21,90,101014,672200639,149682348,821882987
2020-04-20,LG1,TPG,0,0,0,0,0,0
2020-04-20,LG1,Total,35,123,980127,20593517057,3238498040,23832015097
2020-04-20,LG1,UG,8,8,3240,723389144,30691913,754081057
2020-04-20,LG3,Alumni,2,2,0,4165934,29825817,33991751
2020-04-20,LG3,Non-HKUST,4,5,0,31630991,4157083,35788074
2020-04-20,LG3,Others(HKUST),3,3,179,2982201,317766,3299967
2020-04-20,LG3,RPG,36,37,721,3202933511,149295974,3352229485
2020-04-20,LG3,Staff,68,185,32790,32961715255,1498192015,34459907270
2020-04-20,LG3,TPG,6,14,64424,15175134989,643245750,15818380739
2020-04-20,LG3,Total,156,310,124569,71219763053,3236760551,74456523604
2020-04-20,LG3,UG,37,64,26455,19841200172,911726146,20752926318
2020-04-20,LG4,Alumni,0,0,0,0,0,0
2020-04-20,LG4,Non-HKUST,0,0,0,0,0,0
2020-04-20,LG4,Others(HKUST),5,20,346480,28572371868,3789582760,32361954628
2020-04-20,LG4,RPG,34,39,1620,873655902,62859792,936515694
2020-04-20,LG4,Staff,31,53,12425,3311696314,975634764,4287331078
2020-04-20,LG4,TPG,7,8,0,1288075529,60963164,1349038693
2020-04-20,LG4,Total,99,178,405531,71567684728,6596963744,78164648472
2020-04-20,LG4,UG,22,58,45006,37521885115,1707923264,39229808379
2020-04-21,1,Alumni,0,0,0,0,0,0
2020-04-21,1,Non-HKUST,0,0,0,0,0,0
2020-04-21,1,Others(HKUST),3,24,22339,743138103,214759635,957897738
2020-04-21,1,RPG,6,7,3236,3030352,2657417,5687769
2020-04-21,1,Staff,34,347,1166035,72148453182,4521479189,76669932371
2020-04-21,1,TPG,1,1,0,390612024,11612705,402224729
2020-04-21,1,Total,45,380,1191610,73285446964,4750554265,78036001229
2020-04-21,1,UG,1,1,0,213303,45319,258622
2020-04-21,All-Floors,Alumni,2,3,5577,224900494,19302255,244202749
2020-04-21,All-Floors,Non-HKUST,3,10,21950,2508270979,131234667,2639505646
2020-04-21,All-Floors,Others(HKUST),11,67,1767606,47453121368,6602167122,54055288490
2020-04-21,All-Floors,RPG,80,93,5753,3475093710,338234943,3813328653
2020-04-21,All-Floors,Staff,96,825,1795630,118316587486,13715671551,132032259037
2020-04-21,All-Floors,TPG,15,34,101682,13682539987,2232261947,15914801934
2020-04-21,All-Floors,Total,279,1186,3794331,219380165271,56802621870,276182787141
2020-04-21,All-Floors,UG,72,154,96133,33719651247,33763749385,67483400632
2020-04-21,G,Alumni,0,0,0,0,0,0
2020-04-21,G,Non-HKUST,0,0,0,0,0,0
2020-04-21,G,Others(HKUST),4,13,532803,11152591020,1306675883,12459266903
2020-04-21,G,RPG,0,0,0,0,0,0
2020-04-21,G,Staff,34,221,495524,25831033665,4831026150,30662059815
2020-04-21,G,TPG,1,1,0,17625486,2047473,19672959
2020-04-21,G,Total,42,238,1028867,37049281936,6143734123,43193016059
2020-04-21,G,UG,3,3,540,48031765,3984617,52016382
2020-04-21,LG1,Alumni,0,0,0,0,0,0
2020-04-21,LG1,Non-HKUST,0,0,0,0,0,0
2020-04-21,LG1,Others(HKUST),2,13,864348,15624592708,2578716715,18203309423
2020-04-21,LG1,RPG,2,2,719,2030640,640398,2671038
2020-04-21,LG1,Staff,13,35,25209,5938121446,1505408221,7443529667
2020-04-21,LG1,TPG,2,3,1080,82791742,7968571,90760313
2020-04-21,LG1,Total,24,59,894053,22244420680,4116429566,26360850246
2020-04-21,LG1,UG,5,6,2697,596884144,23695661,620579805
2020-04-21,LG3,Alumni,2,3,5577,224900494,19302255,244202749
2020-04-21,LG3,Non-HKUST,3,10,21950,2508270979,131234667,2639505646
2020-04-21,LG3,Others(HKUST),4,7,720,47972270,26286497,74258767
2020-04-21,LG3,RPG,38,42,719,2896691787,108324206,3005015993
2020-04-21,LG3,Staff,56,133,86346,9462662407,2089606334,11552268741
2020-04-21,LG3,TPG,9,13,7551,5345667714,792314658,6137982372
2020-04-21,LG3,Total,144,257,135470,30081737487,3827711358,33909448845
2020-04-21,LG3,UG,32,49,12607,9595571836,660642741,10256214577
2020-04-21,LG4,Alumni,0,0,0,0,0,0
2020-04-21,LG4,Non-HKUST,0,0,0,0,0,0
2020-04-21,LG4,Others(HKUST),5,10,347396,19884827267,2475728392,22360555659
2020-04-21,LG4,RPG,40,42,1079,573340931,226612922,799953853
2020-04-21,LG4,Staff,35,89,22516,4936316786,768151657,5704468443
2020-04-21,LG4,TPG,4,16,93051,7845843021,1418318540,9264161561
2020-04-21,LG4,Total,123,252,544331,56719278204,37964192558,94683470762
2020-04-21,LG4,UG,39,95,80289,23478950199,33075381047,56554331246
2020-04-22,1,Alumni,0,0,0,0,0,0
2020-04-22,1,Non-HKUST,0,0,0,0,0,0
2020-04-22,1,Others(HKUST),1,2,0,9801349,903513,10704862
2020-04-22,1,RPG,1,1,722,15000755,1509098,16509853
2020-04-22,1,Staff,34,397,1186827,72166565121,9427315566,81593880687
2020-04-22,1,TPG,0,0,0,0,0,0
2020-04-22,1,Total,36,400,1187549,72191367225,9429728177,81621095402
2020-04-22,1,UG,0,0,0,0,0,0
2020-04-22,All-Floors,Alumni,3,3,0,320273761,17581169,337854930
2020-04-22,All-Floors,Non-HKUST,2,2,0,95116,33600,128716
2020-04-22,All-Floors,Others(HKUST),10,45,1653073,45784071065,6535207881,52319278946
2020-04-22,All-Floors,RPG,71,81,11696,5801759039,645840364,6447599403
2020-04-22,All-Floors,Staff,103,851,1930754,113250788257,41650939185,154901727442
2020-04-22,All-Floors,TPG,11,14,19628,1333542868,237543162,1571086030
2020-04-22,All-Floors,Total,278,1175,3798128,207463518192,53381157639,260844675831
2020-04-22,All-Floors,UG,78,179,182977,40972988086,4294012278,45267000364
2020-04-22,G,Alumni,0,0,0,0,0,0
2020-04-22,G,Non-HKUST,0,0,0,0,0,0
2020-04-22,G,Others(HKUST),3,12,441518,11240350826,1319646033,12559996859
2020-04-22,G,RPG,4,4,0,200454164,9740581,210194745
2020-04-22,G,Staff,28,161,463256,18706966413,4387772914,23094739327
2020-04-22,G,TPG,0,0,0,0,0,0
2020-04-22,G,Total,38,180,911251,30837344523,5763221644,36600566167
2020-04-22,G,UG,3,3,6477,689573120,46062116,735635236
2020-04-22,LG1,Alumni,0,0,0,0,0,0
2020-04-22,LG1,Non-HKUST,0,0,0,0,0,0
2020-04-22,LG1,Others(HKUST),3,15,864351,15797022651,2605551419,18402574070
2020-04-22,LG1,RPG,0,0,0,0,0,0
2020-04-22,LG1,Staff,12,58,76001,2918896973,511540178,3430437151
2020-04-22,LG1,TPG,0,0,0,0,0,0
2020-04-22,LG1,Total,24,83,942332,21883454167,3384105083,25267559250
2020-04-22,LG1,UG,9,10,1980,3167534543,267013486,3434548029
2020-04-22,LG3,Alumni,2,2,0,4897092,1844562,6741654
2020-04-22,LG3,Non-HKUST,0,0,0,0,0,0
2020-04-22,LG3,Others(HKUST),4,4,0,674968280,13818463,688786743
2020-04-22,LG3,RPG,34,39,0,3128302265,185636276,3313938541
2020-04-22,LG3,Staff,70,148,181802,12738163244,13834345036,26572508280
2020-04-22,LG3,TPG,5,6,8102,597238363,158143537,755381900
2020-04-22,LG3,Total,152,271,328432,32380834524,16035756983,48416591507
2020-04-22,LG3,UG,37,72,138528,15237265280,1841969109,17079234389
2020-04-22,LG4,Alumni,1,1,0,315376669,15736607,331113276
2020-04-22,LG4,Non-HKUST,2,2,0,95116,33600,128716
2020-04-22,LG4,Others(HKUST),4,12,347204,18061927959,2595288453,20657216412
2020-04-22,LG4,RPG,35,37,10974,2458001855,448954409,2906956264
2020-04-22,LG4,Staff,35,87,22868,6720196506,13489965491,20210161997
2020-04-22,LG4,TPG,6,8,11526,736304505,79399625,815704130
2020-04-22,LG4,Total,123,241,428564,50170517753,18768345752,68938863505
2020-04-22,LG4,UG,40,94,35992,21878615143,2138967567,24017582710
2020-04-23,1,Alumni,0,0,0,0,0,0
2020-04-23,1,Non-HKUST,0,0,0,0,0,0
2020-04-23,1,Others(HKUST),3,5,107792,2228355528,34203947,2262559475
2020-04-23,1,RPG,3,3,2156,324661089,67666507,392327596
2020-04-23,1,Staff,40,305,1084165,121544721096,5289294978,126834016074
2020-04-23,1,TPG,0,0,0,0,0,0
2020-04-23,1,Total,46,313,1194113,124097737713,5391165432,129488903145
2020-04-23,1,UG,0,0,0,0,0,0
2020-04-23,All-Floors,Alumni,2,2,0,8701744,767491,9469235
2020-04-23,All-Floors,Non-HKUST,9,10,361,9239826,3222412,12462238
2020-04-23,All-Floors,Others(HKUST),14,64,1606643,54931542355,8471826314,63403368669
2020-04-23,All-Floors,RPG,89,96,7004,7054188018,427233420,7481421438
2020-04-23,All-Floors,Staff,109,741,1722281,170005958649,10183362133,180189320782
2020-04-23,All-Floors,TPG,7,9,3601,5690213908,295940602,5986154510
2020-04-23,All-Floors,Total,304,1120,3574754,344524419635,36968964278,381493383913
2020-04-23,All-Floors,UG,74,198,234864,106824575135,17586611906,124411187041
2020-04-23,G,Alumni,0,0,0,0,0,0
2020-04-23,G,Non-HKUST,2,2,361,3202545,1415915,4618460
2020-04-23,G,Others(HKUST),5,13,362325,8014160540,1021431573,9035592113
2020-04-23,G,RPG,1,1,0,151846,64913,216759
2020-04-23,G,Staff,37,149,436997,19845835636,2718940249,22564775885
2020-04-23,G,TPG,0,0,0,0,0,0
2020-04-23,G,Total,47,167,799683,27866104890,3742473108,31608577998
2020-04-23,G,UG,2,2,0,2754323,620458,3374781
2020-04-23,LG1,Alumni,0,0,0,0,0,0
2020-04-23,LG1,Non-HKUST,0,0,0,0,0,0
2020-04-23,LG1,Others(HKUST),2,13,777953,14472304943,2370949754,16843254697
2020-04-23,LG1,RPG,4,4,1789,260806,212186,472992
2020-04-23,LG1,Staff,11,58,86633,4067783675,378775197,4446558872
2020-04-23,LG1,TPG,0,0,0,0,0,0
2020-04-23,LG1,Total,24,82,869255,18615396924,3488968949,22104365873
2020-04-23,LG1,UG,7,7,2880,75047500,739031812,814079312
2020-04-23,LG3,Alumni,0,0,0,0,0,0
2020-04-23,LG3,Non-HKUST,3,3,0,3366098,740386,4106484
2020-04-23,LG3,Others(HKUST),8,14,5762,4300255199,1713875399,6014130598
2020-04-23,LG3,RPG,44,46,1621,2592170835,144455347,2736626182
2020-04-23,LG3,Staff,62,157,89647,14490983935,1105143519,15596127454
2020-04-23,LG3,TPG,4,6,3601,1967206525,226177208,2193383733
2020-04-23,LG3,Total,157,308,264775,82661253935,13692663868,96353917803
2020-04-23,LG3,UG,36,82,164144,59307271343,10502272009,69809543352
2020-04-23,LG4,Alumni,2,2,0,8701744,767491,9469235
2020-04-23,LG4,Non-HKUST,5,5,0,2671183,1066111,3737294
2020-04-23,LG4,Others(HKUST),5,19,352811,25916466145,3331365641,29247831786
2020-04-23,LG4,RPG,39,42,1438,4136943442,214834467,4351777909
2020-04-23,LG4,Staff,34,72,24839,10056634307,691208190,10747842497
2020-04-23,LG4,TPG,3,3,0,3723007383,69763394,3792770777
2020-04-23,LG4,Total,126,250,446928,91283926173,10653692921,101937619094
2020-04-23,LG4,UG,38,107,67840,47439501969,6344687627,53784189596
2020-04-24,1,Alumni,0,0,0,0,0,0
2020-04-24,1,Non-HKUST,0,0,0,0,0,0
2020-04-24,1,Others(HKUST),2,5,93736,2256152590,45846680,2301999270
2020-04-24,1,RPG,2,2,1439,3315627,634396,3950023
2020-04-24,1,Staff,40,403,1306583,91388794536,3947588295,95336382831
2020-04-24,1,TPG,0,0,0,0,0,0
2020-04-24,1,Total,47,413,1401758,93648361501,3994152898,97642514399
2020-04-24,1,UG,3,3,0,98748,83527,182275
2020-04-24,All-Floors,Alumni,2,2,12424,120146940,9272829,129419769
2020-04-24,All-Floors,Non-HKUST,4,8,721,126933735,8485160,135418895
2020-04-24,All-Floors,Others(HKUST),11,70,1514271,63578040236,6924708643,70502748879
2020-04-24,All-Floors,RPG,71,91,12599,4728376247,1077784329,5806160576
2020-04-24,All-Floors,Staff,123,1084,2353146,280357108162,98580318078,378937426240
2020-04-24,All-Floors,TPG,15,21,1438,1290722557,81136460,1371859017
2020-04-24,All-Floors,Total,294,1430,4042397,393109439964,141334517589,534443957553
2020-04-24,All-Floors,UG,68,154,147798,42908112087,34652812090,77560924177
2020-04-24,G,Alumni,0,0,0,0,0,0
2020-04-24,G,Non-HKUST,1,1,361,60809,40589,101398
2020-04-24,G,Others(HKUST),4,22,462240,19867190841,1521984619,21389175460
2020-04-24,G,RPG,2,2,0,1834482,549171,2383653
2020-04-24,G,Staff,47,243,666397,50091527698,3252618276,53344145974
2020-04-24,G,TPG,0,0,0,0,0,0
2020-04-24,G,Total,56,270,1128998,70151979806,4784735959,74936715765
2020-04-24,G,UG,2,2,0,191365976,9543304,200909280
2020-04-24,LG1,Alumni,0,0,0,0,0,0
2020-04-24,LG1,Non-HKUST,1,4,360,722305,396824,1119129
2020-04-24,LG1,Others(HKUST),5,19,605863,18425485638,2256260991,20681746629
2020-04-24,LG1,RPG,5,5,1799,1446882,3111877,4558759
2020-04-24,LG1,Staff,19,100,142072,90528156618,1312764578,91840921196
2020-04-24,LG1,TPG,0,0,0,0,0,0
2020-04-24,LG1,Total,42,140,760907,110464730218,29420491588,139885221806
2020-04-24,LG1,UG,12,12,10813,1508918775,25847957318,27356876093
2020-04-24,LG3,Alumni,1,1,12424,118899131,8929003,127828134
2020-04-24,LG3,Non-HKUST,2,2,0,126094271,7994500,134088771
2020-04-24,LG3,Others(HKUST),4,8,5398,25484593,7581466,33066059
2020-04-24,LG3,RPG,37,44,9361,3914592558,786239037,4700831595
2020-04-24,LG3,Staff,70,240,125671,23462369551,89000341378,112462710929
2020-04-24,LG3,TPG,9,11,1259,834770653,55739808,890510461
2020-04-24,LG3,Total,153,364,198041,47807455750,92623395984,140430851734
2020-04-24,LG3,UG,30,58,43928,19325244993,2756570792,22081815785
2020-04-24,LG4,Alumni,1,1,0,1247809,343826,1591635
2020-04-24,LG4,Non-HKUST,1,1,0,56350,53247,109597
2020-04-24,LG4,Others(HKUST),5,16,347034,23003726574,3093034887,26096761461
2020-04-24,LG4,RPG,30,38,0,807186698,287249848,1094436546
2020-04-24,LG4,Staff,44,98,112423,24886259759,1067005551,25953265310
2020-04-24,LG4,TPG,8,10,179,455951904,25396652,481348556
2020-04-24,LG4,Total,118,243,552693,71036912689,10511741160,81548653849
2020-04-24,LG4,UG,29,79,93057,21882483595,6038657149,27921140744
2020-04-25,1,Alumni,0,0,0,0,0,0
2020-04-25,1,Non-HKUST,0,0,0,0,0,0
2020-04-25,1,Others(HKUST),1,2,172798,9223422,5411640,14635062
2020-04-25,1,RPG,4,5,719,14529163,2713387,17242550
2020-04-25,1,Staff,9,61,588456,30095600810,1320156301,31415757111
2020-04-25,1,TPG,0,0,0,0,0,0
2020-04-25,1,Total,14,68,761973,30119353395,1328281328,31447634723
2020-04-25,1,UG,0,0,0,0,0,0
2020-04-25,All-Floors,Alumni,1,3,0,154802047,24190520,178992567
2020-04-25,All-Floors,Non-HKUST,2,2,0,339172415,9758558,348930973
2020-04-25,All-Floors,Others(HKUST),7,39,1737469,48267279242,6990769177,55258048419
2020-04-25,All-Floors,RPG,66,67,1626,2793026905,235899803,3028926708
2020-04-25,All-Floors,Staff,46,215,1018136,42469203956,3137751788,45606955744
2020-04-25,All-Floors,TPG,9,16,57625,2399307708,274313110,2673620818
2020-04-25,All-Floors,Total,197,472,2883781,118826143706,13173483532,131999627238
2020-04-25,All-Floors,UG,66,130,68925,22403351433,2500800576,24904152009
2020-04-25,G,Alumni,0,0,0,0,0,0
2020-04-25,G,Non-HKUST,0,0,0,0,0,0
2020-04-25,G,Others(HKUST),3,10,518563,14815369691,1719842882,16535212573
2020-04-25,G,RPG,3,3,0,103704246,33835825,137540071
2020-04-25,G,Staff,11,48,352805,6274528232,1277358690,7551886922
2020-04-25,G,TPG,0,0,0,0,0,0
2020-04-25,G,Total,20,64,871368,21193896759,3031398009,24225294768
2020-04-25,G,UG,3,3,0,294590,360612,655202
2020-04-25,LG1,Alumni,0,0,0,0,0,0
2020-04-25,LG1,Non-HKUST,0,0,0,0,0,0
2020-04-25,LG1,Others(HKUST),3,14,777194,19384082404,3415908995,22799991399
2020-04-25,LG1,RPG,5,5,188,6556628,761797,7318425
2020-04-25,LG1,Staff,6,7,1260,41333551,3407622,44741173
2020-04-25,LG1,TPG,0,0,0,0,0,0
2020-04-25,LG1,Total,17,29,780263,19469386173,3423389454,22892775627
2020-04-25,LG1,UG,3,3,1621,37413590,3311040,40724630
2020-04-25,LG3,Alumni,1,3,0,154802047,24190520,178992567
2020-04-25,LG3,Non-HKUST,0,0,0,0,0,0
2020-04-25,LG3,Others(HKUST),2,3,360,54144967,3703937,57848904
2020-04-25,LG3,RPG,23,23,0,926662340,63797587,990459927
2020-04-25,LG3,Staff,20,75,57612,4106315621,370193405,4476509026
2020-04-25,LG3,TPG,9,15,57625,2276214648,263533467,2539748115
2020-04-25,LG3,Total,95,174,132879,14003282379,1562617494,15565899873
2020-04-25,LG3,UG,40,55,17282,6485142756,837198578,7322341334
2020-04-25,LG4,Alumni,0,0,0,0,0,0
2020-04-25,LG4,Non-HKUST,2,2,0,339172415,9758558,348930973
2020-04-25,LG4,Others(HKUST),4,10,268554,14004458758,1845901723,15850360481
2020-04-25,LG4,RPG,31,31,719,1741574528,134791207,1876365735
2020-04-25,LG4,Staff,12,24,18003,1951425742,166635770,2118061512
2020-04-25,LG4,TPG,1,1,0,123093060,10779643,133872703
2020-04-25,LG4,Total,79,137,337298,34040225000,3827797247,37868022247
2020-04-25,LG4,UG,29,69,50022,15880500497,1659930346,17540430843
2020-04-26,1,Alumni,0,0,0,0,0,0
2020-04-26,1,Non-HKUST,0,0,0,0,0,0
2020-04-26,1,Others(HKUST),1,2,172798,15031580,9344092,24375672
2020-04-26,1,RPG,3,3,1441,19238137,3123507,22361644
2020-04-26,1,Staff,9,34,595794,53557389225,2098055617,55655444842
2020-04-26,1,TPG,0,0,0,0,0,0
2020-04-26,1,Total,16,42,770751,53624294668,2112006900,55736301568
2020-04-26,1,UG,3,3,718,32635726,1483684,34119410
2020-04-26,All-Floors,Alumni,2,9,12244,5844121162,285983469,6130104631
2020-04-26,All-Floors,Non-HKUST,2,2,0,21191228,1433508,22624736
2020-04-26,All-Floors,Others(HKUST),7,39,1897696,64847377279,8982777386,73830154665
2020-04-26,All-Floors,RPG,56,64,3779,1698085825,114558709,1812644534
2020-04-26,All-Floors,Staff,38,99,1037488,69822997035,4732312651,74555309686
2020-04-26,All-Floors,TPG,9,15,25026,2538308049,424604129,2962912178
2020-04-26,All-Floors,Total,208,380,3077732,158078827090,15769610972,173848438062
2020-04-26,All-Floors,UG,94,152,101499,13306746512,1227941120,14534687632
2020-04-26,G,Alumni,0,0,0,0,0,0
2020-04-26,G,Non-HKUST,0,0,0,0,0,0
2020-04-26,G,Others(HKUST),3,8,519114,12607302460,1407693761,14014996221
2020-04-26,G,RPG,0,0,0,0,0,0
2020-04-26,G,Staff,5,32,419012,14586941386,2572251375,17159192761
2020-04-26,G,TPG,0,0,0,0,0,0
2020-04-26,G,Total,12,44,938126,27215028991,3983943408,31198972399
2020-04-26,G,UG,4,4,0,20785145,3998272,24783417
2020-04-26,LG1,Alumni,0,0,0,0,0,0
2020-04-26,LG1,Non-HKUST,0,0,0,0,0,0
2020-04-26,LG1,Others(HKUST),4,15,864523,18279883120,2983812591,21263695711
2020-04-26,LG1,RPG,3,3,900,11999802,816381,12816183
2020-04-26,LG1,Staff,8,10,721,50740705,3042066,53782771
2020-04-26,LG1,TPG,0,0,0,0,0,0
2020-04-26,LG1,Total,26,41,870992,18946825996,3011571670,21958397666
2020-04-26,LG1,UG,11,13,4848,604202369,23900632,628103001
2020-04-26,LG3,Alumni,1,6,12064,4237558577,213408731,4450967308
2020-04-26,LG3,Non-HKUST,1,1,0,21057487,1381467,22438954
2020-04-26,LG3,Others(HKUST),1,2,0,5049023,1366437,6415460
2020-04-26,LG3,RPG,32,34,1258,941850788,81597651,1023448439
2020-04-26,LG3,Staff,12,15,17820,1600775476,54823344,1655598820
2020-04-26,LG3,TPG,8,10,25026,2453373967,401072112,2854446079
2020-04-26,LG3,Total,92,113,84239,16186154792,1623337841,17809492633
2020-04-26,LG3,UG,37,45,28071,6926489474,869688099,7796177573
2020-04-26,LG4,Alumni,2,3,180,1606562585,72574738,1679137323
2020-04-26,LG4,Non-HKUST,1,1,0,133741,52041,185782
2020-04-26,LG4,Others(HKUST),2,12,341261,33940111096,4580560505,38520671601
2020-04-26,LG4,RPG,23,24,180,724997098,29021170,754018268
2020-04-26,LG4,Staff,7,8,4141,27150243,4140249,31290492
2020-04-26,LG4,TPG,4,5,0,84934082,23532017,108466099
2020-04-26,LG4,Total,89,140,413624,42106522643,5038751153,47145273796
2020-04-26,LG4,UG,50,87,67862,5722633798,328870433,6051504231
2020-04-27,1,Alumni,0,0,0,0,0,0
2020-04-27,1,Non-HKUST,0,0,0,0,0,0
2020-04-27,1,Others(HKUST),3,16,141105,160746174,66294794,227040968
2020-04-27,1,RPG,5,5,1439,128799706,44351595,173151301
2020-04-27,1,Staff,35,323,1164545,61484395086,8553817561,70038212647
2020-04-27,1,TPG,1,1,720,77106247,1689637,78795884
2020-04-27,1,Total,49,368,1320955,62931387644,8751599286,71682986930
2020-04-27,1,UG,5,23,13146,1080340431,85445699,1165786130
2020-04-27,All-Floors,Alumni,0,0,0,0,0,0
2020-04-27,All-Floors,Non-HKUST,6,7,0,330505821,13266648,343772469
2020-04-27,All-Floors,Others(HKUST),12,75,1761302,52343410474,7389028474,59732438948
2020-04-27,All-Floors,RPG,95,98,3958,3930545365,354243164,4284788529
2020-04-27,All-Floors,Staff,126,935,2164074,159728696350,28575302186,188303998536
2020-04-27,All-Floors,TPG,13,27,4138,2793694420,127584581,2921279001
2020-04-27,All-Floors,Total,326,1326,4178046,263782271647,40604214145,304386485792
2020-04-27,All-Floors,UG,74,184,244574,44655419217,4144789092,48800208309
2020-04-27,G,Alumni,0,0,0,0,0,0
2020-04-27,G,Non-HKUST,0,0,0,0,0,0
2020-04-27,G,Others(HKUST),4,15,408448,12687024251,1428835456,14115859707
2020-04-27,G,RPG,1,1,0,6658767,4164970,10823737
2020-04-27,G,Staff,39,257,735278,31868983213,5314810510,37183793723
2020-04-27,G,TPG,0,0,0,0,0,0
2020-04-27,G,Total,46,276,1143906,44583199823,6750711927,51333911750
2020-04-27,G,UG,2,3,180,20533592,2900991,23434583
2020-04-27,LG1,Alumni,0,0,0,0,0,0
2020-04-27,LG1,Non-HKUST,0,0,0,0,0,0
2020-04-27,LG1,Others(HKUST),3,14,864893,16682205146,2737150985,19419356131
2020-04-27,LG1,RPG,10,10,1979,185728992,12646603,198375595
2020-04-27,LG1,Staff,25,74,115229,25611381439,3259991996,28871373435
2020-04-27,LG1,TPG,0,0,0,0,0,0
2020-04-27,LG1,Total,45,105,983910,42527444156,6016265955,48543710111
2020-04-27,LG1,UG,7,7,1809,48128579,6476371,54604950
2020-04-27,LG3,Alumni,0,0,0,0,0,0
2020-04-27,LG3,Non-HKUST,5,6,0,330206601,13122833,343329434
2020-04-27,LG3,Others(HKUST),7,11,181,76110563,28916250,105026813
2020-04-27,LG3,RPG,42,43,540,3201060560,264258929,3465319489
2020-04-27,LG3,Staff,67,174,126154,35344225694,11025968709,46370194403
2020-04-27,LG3,TPG,3,6,3418,2662094556,84165501,2746260057
2020-04-27,LG3,Total,157,298,158729,55262983511,13497741204,68760724715
2020-04-27,LG3,UG,33,58,28436,13649285537,2081308982,15730594519
2020-04-27,LG4,Alumni,0,0,0,0,0,0
2020-04-27,LG4,Non-HKUST,1,1,0,299220,143815,443035
2020-04-27,LG4,Others(HKUST),5,19,346675,22737324340,3127830989,25865155329
2020-04-27,LG4,RPG,39,39,0,408297340,28821067,437118407
2020-04-27,LG4,Staff,48,107,22868,5419710918,420713410,5840424328
2020-04-27,LG4,TPG,10,20,0,54493617,41729443,96223060
2020-04-27,LG4,Total,140,279,570546,58477256513,5587895773,64065152286
2020-04-27,LG4,UG,37,93,201003,29857131078,1968657049,31825788127
2020-04-28,1,Alumni,0,0,0,0,0,0
2020-04-28,1,Non-HKUST,0,0,0,0,0,0
2020-04-28,1,Others(HKUST),2,7,124892,59961658,42604221,102565879
2020-04-28,1,RPG,4,4,0,3709544,665577,4375121
2020-04-28,1,Staff,41,395,1308254,110016464425,5706120713,115722585138
2020-04-28,1,TPG,1,1,719,55553,29719,85272
2020-04-28,1,Total,48,407,1433865,110080191180,5749420230,115829611410
2020-04-28,1,UG,0,0,0,0,0,0
2020-04-28,All-Floors,Alumni,3,3,0,1562890372,92578423,1655468795
2020-04-28,All-Floors,Non-HKUST,1,1,0,29547,21844,51391
2020-04-28,All-Floors,Others(HKUST),11,61,1715747,54385861747,7794737273,62180599020
2020-04-28,All-Floors,RPG,87,99,2867,2575705493,189630748,2765336241
2020-04-28,All-Floors,Staff,143,1105,2379750,182025584028,16831285003,198856869031
2020-04-28,All-Floors,TPG,12,44,100717,122352123872,6918251828,129270375700
2020-04-28,All-Floors,Total,335,1455,4359541,372828503605,32981323218,405809826823
2020-04-28,All-Floors,UG,78,142,160460,9926308546,1154818099,11081126645
2020-04-28,G,Alumni,0,0,0,0,0,0
2020-04-28,G,Non-HKUST,0,0,0,0,0,0
2020-04-28,G,Others(HKUST),3,8,358564,12785492982,1447539153,14233032135
2020-04-28,G,RPG,3,3,0,96859517,9061643,105921160
2020-04-28,G,Staff,41,272,642632,42928276958,6766746266,49695023224
2020-04-28,G,TPG,0,0,0,0,0,0
2020-04-28,G,Total,49,285,1001917,55812051162,8225040028,64037091190
2020-04-28,G,UG,2,2,721,1421705,1692966,3114671
2020-04-28,LG1,Alumni,0,0,0,0,0,0
2020-04-28,LG1,Non-HKUST,0,0,0,0,0,0
2020-04-28,LG1,Others(HKUST),2,13,864712,16856067498,2763219812,19619287310
2020-04-28,LG1,RPG,4,4,0,111793116,1773579,113566695
2020-04-28,LG1,Staff,32,115,122812,4505796243,341823140,4847619383
2020-04-28,LG1,TPG,0,0,0,0,0,0
2020-04-28,LG1,Total,47,141,991121,21636965635,3114064831,24751030466
2020-04-28,LG1,UG,9,9,3597,163308778,7248300,170557078
2020-04-28,LG3,Alumni,0,0,0,0,0,0
2020-04-28,LG3,Non-HKUST,0,0,0,0,0,0
2020-04-28,LG3,Others(HKUST),5,12,20366,1787929768,142975873,1930905641
2020-04-28,LG3,RPG,48,52,1967,1804436750,111166384,1915603134
2020-04-28,LG3,Staff,94,214,260672,14649251062,2220848863,16870099925
2020-04-28,LG3,TPG,8,29,92080,57185333855,3529811555,60715145410
2020-04-28,LG3,Total,191,348,385508,78697107376,6448356965,85145464341
2020-04-28,LG3,UG,36,41,10423,3270155941,443554290,3713710231
2020-04-28,LG4,Alumni,3,3,0,1562890372,92578423,1655468795
2020-04-28,LG4,Non-HKUST,1,1,0,29547,21844,51391
2020-04-28,LG4,Others(HKUST),7,21,347213,22896409841,3398398214,26294808055
2020-04-28,LG4,RPG,34,36,900,558906566,66963565,625870131
2020-04-28,LG4,Staff,37,109,45380,9925795340,1795746021,11721541361
2020-04-28,LG4,TPG,6,14,7918,65166734464,3388410554,68555145018
2020-04-28,LG4,Total,127,274,547130,106602188252,9444441164,116046629416
2020-04-28,LG4,UG,39,90,145719,6491422122,702322543,7193744665
2020-04-29,1,Alumni,0,0,0,0,0,0
2020-04-29,1,Non-HKUST,1,1,0,9110482,15129763,24240245
2020-04-29,1,Others(HKUST),2,6,113728,78395087,47952985,126348072
2020-04-29,1,RPG,2,2,0,501485,311394,812879
2020-04-29,1,Staff,37,409,1195183,79936038740,4981346764,84917385504
2020-04-29,1,TPG,0,0,0,0,0,0
2020-04-29,1,Total,46,441,1332683,87700459064,5330133337,93030592401
2020-04-29,1,UG,4,23,23772,7676413270,285392431,7961805701
2020-04-29,All-Floors,Alumni,5,10,26438,2955335327,190234991,3145570318
2020-04-29,All-Floors,Non-HKUST,5,9,14940,38903313,37556176,76459489
2020-04-29,All-Floors,Others(HKUST),7,55,1437444,61185274338,8418577945,69603852283
2020-04-29,All-Floors,RPG,81,96,12435,8791277912,581314782,9372592694
2020-04-29,All-Floors,Staff,128,1135,1877763,188861139353,15453613883,204314753236
2020-04-29,All-Floors,TPG,16,23,35319,7350500616,370372222,7720872838
2020-04-29,All-Floors,Total,307,1432,3479192,288514514190,26255286258,314769800448
2020-04-29,All-Floors,UG,65,104,74853,19332083331,1203616259,20535699590
2020-04-29,G,Alumni,0,0,0,0,0,0
2020-04-29,G,Non-HKUST,1,1,360,3550786,728976,4279762
2020-04-29,G,Others(HKUST),3,10,260319,8920036726,1084194143,10004230869
2020-04-29,G,RPG,1,1,0,30113,3928,34041
2020-04-29,G,Staff,47,290,482131,27548121435,3585257022,31133378457
2020-04-29,G,TPG,0,0,0,0,0,0
2020-04-29,G,Total,54,304,742810,36485694895,4673177372,41158872267
2020-04-29,G,UG,2,2,0,13955835,2993303,16949138
2020-04-29,LG1,Alumni,1,1,0,833209111,77225557,910434668
2020-04-29,LG1,Non-HKUST,0,0,0,0,0,0
2020-04-29,LG1,Others(HKUST),2,12,777771,15416878571,2513994186,17930872757
2020-04-29,LG1,RPG,5,5,1439,1896993,962807,2859800
2020-04-29,LG1,Staff,22,92,77439,39452593288,1544474435,40997067723
2020-04-29,LG1,TPG,0,0,0,0,0,0
2020-04-29,LG1,Total,39,119,858809,56108979007,4154669509,60263648516
2020-04-29,LG1,UG,9,9,2160,404401044,18012524,422413568
2020-04-29,LG3,Alumni,2,7,26438,2115264751,112329110,2227593861
2020-04-29,LG3,Non-HKUST,4,5,7739,18950437,19000975,37951412
2020-04-29,LG3,Others(HKUST),3,8,180,127485567,1069425896,1196911463
2020-04-29,LG3,RPG,53,58,9554,7210525083,479199783,7689724866
2020-04-29,LG3,Staff,71,208,75641,25733306552,3138264730,28871571282
2020-04-29,LG3,TPG,10,13,13891,4999089369,228940764,5228030133
2020-04-29,LG3,Total,170,328,143517,46256672331,5684737788,51941410119
2020-04-29,LG3,UG,27,29,10074,6052050572,637576530,6689627102
2020-04-29,LG4,Alumni,2,2,0,6861465,680324,7541789
2020-04-29,LG4,Non-HKUST,2,2,6841,7291608,2696462,9988070
2020-04-29,LG4,Others(HKUST),4,19,285446,36642478387,3703010735,40345489122
2020-04-29,LG4,RPG,29,30,1442,1578324238,100836870,1679161108
2020-04-29,LG4,Staff,41,136,47369,16191079338,2204270932,18395350270
2020-04-29,LG4,TPG,8,10,21428,2351411247,141431458,2492842705
2020-04-29,LG4,Total,117,240,401373,61962708893,6412568252,68375277145
2020-04-29,LG4,UG,31,41,38847,5185262610,259641471,5444904081
2020-04-30,1,Alumni,0,0,0,0,0,0
2020-04-30,1,Non-HKUST,0,0,0,0,0,0
2020-04-30,1,Others(HKUST),1,2,172798,44295944,29712432,74008376
2020-04-30,1,RPG,8,9,3240,300983896,11136626,312120522
2020-04-30,1,Staff,8,29,423345,13611260854,357313600,13968574454
2020-04-30,1,TPG,0,0,0,0,0,0
2020-04-30,1,Total,18,41,599383,13956540694,398162658,14354703352
2020-04-30,1,UG,1,1,0,0,0,0
2020-04-30,All-Floors,Alumni,4,19,6300,32177410110,959539553,33136949663
2020-04-30,All-Floors,Non-HKUST,7,7,0,289159741,16177444,305337185
2020-04-30,All-Floors,Others(HKUST),4,20,1209394,38809894845,5727359331,44537254176
2020-04-30,All-Floors,RPG,83,93,31500,3400574478,226708217,3627282695
2020-04-30,All-Floors,Staff,41,65,606401,25209132116,2669133601,27878265717
2020-04-30,All-Floors,TPG,21,32,61213,9979080902,754163955,10733244857
2020-04-30,All-Floors,Total,228,358,1997954,124485498639,11238055787,135723554426
2020-04-30,All-Floors,UG,68,122,83146,14620246447,884973686,15505220133
2020-04-30,G,Alumni,0,0,0,0,0,0
2020-04-30,G,Non-HKUST,0,0,0,0,0,0
2020-04-30,G,Others(HKUST),1,1,86399,2466762514,352565571,2819328085
2020-04-30,G,RPG,1,1,0,270901403,8925073,279826476
2020-04-30,G,Staff,8,11,173338,11415689084,1907952989,13323642073
2020-04-30,G,TPG,1,1,0,68107504,6500787,74608291
2020-04-30,G,Total,15,18,259737,14221596716,2276037786,16497634502
2020-04-30,G,UG,4,4,0,136211,93366,229577
2020-04-30,LG1,Alumni,0,0,0,0,0,0
2020-04-30,LG1,Non-HKUST,0,0,0,0,0,0
2020-04-30,LG1,Others(HKUST),1,8,604422,13529933510,2244426085,15774359595
2020-04-30,LG1,RPG,3,3,899,17162904,1554249,18717153
2020-04-30,LG1,Staff,3,3,1979,6735240,849401,7584641
2020-04-30,LG1,TPG,0,0,0,0,0,0
2020-04-30,LG1,Total,11,18,607480,13616074075,2249982191,15866056266
2020-04-30,LG1,UG,4,4,180,62242421,3152456,65394877
2020-04-30,LG3,Alumni,3,11,5759,17970069826,533546109,18503615935
2020-04-30,LG3,Non-HKUST,3,3,0,43606271,8633483,52239754
2020-04-30,LG3,Others(HKUST),1,1,0,96454591,2249327,98703918
2020-04-30,LG3,RPG,39,43,27361,2137540151,162421791,2299961942
2020-04-30,LG3,Staff,11,11,6840,68484054,394143569,462627623
2020-04-30,LG3,TPG,8,13,20889,1299670685,186723602,1486394287
2020-04-30,LG3,Total,93,120,99355,27123051420,1695870909,28818922329
2020-04-30,LG3,UG,28,38,38506,5507225842,408153028,5915378870
2020-04-30,LG4,Alumni,3,8,541,14207340284,425993444,14633333728
2020-04-30,LG4,Non-HKUST,4,4,0,245553470,7543961,253097431
2020-04-30,LG4,Others(HKUST),3,8,345775,22672448286,3098405916,25770854202
2020-04-30,LG4,RPG,36,37,0,673986124,42670478,716656602
2020-04-30,LG4,Staff,11,11,899,106962884,8874042,115836926
2020-04-30,LG4,TPG,15,18,40324,8611302713,560939566,9172242279
2020-04-30,LG4,Total,111,161,431999,55568235734,4618002243,60186237977
2020-04-30,LG4,UG,39,75,44460,9050641973,473574836,9524216809
