Date,Floor,User-Group,User-Count,WiFi-Conn,Duration-Sec,Traffic-In-Byte,Traffic-Out-Byte,Traffic-Both-Byte
2021-01-01,1,Alumni,0,0,0,0,0,0
2021-01-01,1,Non-HKUST,1,2,95,1632,1310,2942
2021-01-01,1,Others(HKUST),0,0,0,0,0,0
2021-01-01,1,RPG,3,3,1065,32504,255555,288059
2021-01-01,1,Staff,5,8,2198,98222,2459733,2557955
2021-01-01,1,TPG,0,0,0,0,0,0
2021-01-01,1,Total,9,13,3358,132358,2716598,2848956
2021-01-01,1,UG,0,0,0,0,0,0
2021-01-01,All-Floors,Alumni,1,1,421,1653,5710,7363
2021-01-01,All-Floors,Non-HKUST,9,29,7796,84015,5728148,5812163
2021-01-01,All-Floors,Others(HKUST),4,27,199456,55192727,327064781,382257508
2021-01-01,All-Floors,RPG,216,354,97859,11864352,576728587,588592939
2021-01-01,All-Floors,Staff,84,236,70304,3835093,134187325,138022418
2021-01-01,All-Floors,TPG,25,44,16272,4368068,41658381,46026449
2021-01-01,All-Floors,Total,495,1059,622230,97873194,1967606239,2065479433
2021-01-01,All-Floors,UG,156,368,230122,22527286,882233307,904760593
2021-01-01,G,Alumni,0,0,0,0,0,0
2021-01-01,G,Non-HKUST,3,7,1842,18799,32587,51386
2021-01-01,G,Others(HKUST),0,0,0,0,0,0
2021-01-01,G,RPG,14,17,6293,207642,389400,597042
2021-01-01,G,Staff,24,48,15321,1177819,105573806,106751625
2021-01-01,G,TPG,3,4,3516,526787,4102075,4628862
2021-01-01,G,Total,55,87,29341,1999247,110183519,112182766
2021-01-01,G,UG,11,11,2369,68200,85651,153851
2021-01-01,LG1,Alumni,0,0,0,0,0,0
2021-01-01,LG1,Non-HKUST,1,4,280,1036,1650,2686
2021-01-01,LG1,Others(HKUST),1,2,92888,5802653,36765885,42568538
2021-01-01,LG1,RPG,9,11,4067,580488,4073340,4653828
2021-01-01,LG1,Staff,7,11,3227,158328,227597,385925
2021-01-01,LG1,TPG,1,1,10,0,0,0
2021-01-01,LG1,Total,30,41,101278,6546523,41076606,47623129
2021-01-01,LG1,UG,11,12,806,4018,8134,12152
2021-01-01,LG3,Alumni,0,0,0,0,0,0
2021-01-01,LG3,Non-HKUST,6,9,1757,28471,4556521,4584992
2021-01-01,LG3,Others(HKUST),3,11,2453,41057,64126,105183
2021-01-01,LG3,RPG,143,163,16518,2941574,76853971,79795545
2021-01-01,LG3,Staff,51,105,31005,1842435,15895827,17738262
2021-01-01,LG3,TPG,15,21,4726,1198159,24216628,25414787
2021-01-01,LG3,Total,320,444,116868,9071988,523982452,533054440
2021-01-01,LG3,UG,102,135,60409,3020292,402395379,405415671
2021-01-01,LG4,Alumni,1,1,421,1653,5710,7363
2021-01-01,LG4,Non-HKUST,6,7,3822,34077,1136080,1170157
2021-01-01,LG4,Others(HKUST),4,14,104115,49349017,290234770,339583787
2021-01-01,LG4,RPG,133,160,69916,8102144,495156321,503258465
2021-01-01,LG4,Staff,46,64,18553,558289,10030362,10588651
2021-01-01,LG4,TPG,17,18,8020,2643122,13339678,15982800
2021-01-01,LG4,Total,312,474,371385,80123078,1289647064,1369770142
2021-01-01,LG4,UG,105,210,166538,19434776,479744143,499178919
2021-01-02,1,Alumni,0,0,0,0,0,0
2021-01-02,1,Non-HKUST,3,3,1601,7208,7861,15069
2021-01-02,1,Others(HKUST),0,0,0,0,0,0
2021-01-02,1,RPG,4,4,1196,17836,6941,24777
2021-01-02,1,Staff,2,3,1101,125645,8735136,8860781
2021-01-02,1,TPG,1,1,7955,41202,1109277,1150479
2021-01-02,1,Total,10,11,11853,191891,9859215,10051106
2021-01-02,1,UG,0,0,0,0,0,0
2021-01-02,All-Floors,Alumni,6,14,3143,125138,6903101,7028239
2021-01-02,All-Floors,Non-HKUST,18,84,30229,7073849,3570880912,3577954761
2021-01-02,All-Floors,Others(HKUST),6,52,213748,41691009,756625945,798316954
2021-01-02,All-Floors,RPG,233,417,101290,9829028,703772443,713601471
2021-01-02,All-Floors,Staff,112,255,94765,10245366,371224336,381469702
2021-01-02,All-Floors,TPG,27,53,20286,3621423,267347731,270969154
2021-01-02,All-Floors,Total,616,1406,762215,109428918,8953424389,9062853307
2021-01-02,All-Floors,UG,214,531,298754,36843105,3276669921,3313513026
2021-01-02,G,Alumni,0,0,0,0,0,0
2021-01-02,G,Non-HKUST,5,24,9365,3247670,2569099865,2572347535
2021-01-02,G,Others(HKUST),1,1,115,7006,9935,16941
2021-01-02,G,RPG,17,18,2624,57257,84454,141711
2021-01-02,G,Staff,19,41,16428,1138931,6026662,7165593
2021-01-02,G,TPG,4,4,120,52316,665475,717791
2021-01-02,G,Total,64,108,35041,4696742,2579699433,2584396175
2021-01-02,G,UG,18,20,6389,193562,3813042,4006604
2021-01-02,LG1,Alumni,0,0,0,0,0,0
2021-01-02,LG1,Non-HKUST,3,22,4017,1130166,162801024,163931190
2021-01-02,LG1,Others(HKUST),2,3,93027,5835647,24172682,30008329
2021-01-02,LG1,RPG,9,9,95,2987,4938,7925
2021-01-02,LG1,Staff,13,23,6794,183831,217990,401821
2021-01-02,LG1,TPG,0,0,0,0,0,0
2021-01-02,LG1,Total,38,68,148295,9944031,277052676,286996707
2021-01-02,LG1,UG,11,11,44362,2791400,89856042,92647442
2021-01-02,LG3,Alumni,4,7,190,0,0,0
2021-01-02,LG3,Non-HKUST,11,16,8285,872344,14195295,15067639
2021-01-02,LG3,Others(HKUST),4,26,8079,481000,3584620,4065620
2021-01-02,LG3,RPG,164,195,19579,3007674,40390312,43397986
2021-01-02,LG3,Staff,68,101,44575,5044140,85688024,90732164
2021-01-02,LG3,TPG,16,26,4692,1808162,115379867,117188029
2021-01-02,LG3,Total,412,580,143915,20862459,1640416907,1661279366
2021-01-02,LG3,UG,145,209,58515,9649139,1381178789,1390827928
2021-01-02,LG4,Alumni,4,7,2953,125138,6903101,7028239
2021-01-02,LG4,Non-HKUST,10,19,6961,1816461,824776867,826593328
2021-01-02,LG4,Others(HKUST),3,22,112527,35367356,728858708,764226064
2021-01-02,LG4,RPG,143,191,77796,6743274,663285798,670029072
2021-01-02,LG4,Staff,56,87,25867,3752819,270556524,274309343
2021-01-02,LG4,TPG,16,22,7519,1719743,150193112,151912855
2021-01-02,LG4,Total,388,639,423111,73733795,4446396158,4520129953
2021-01-02,LG4,UG,156,291,189488,24209004,1801822048,1826031052
2021-01-03,1,Alumni,0,0,0,0,0,0
2021-01-03,1,Non-HKUST,0,0,0,0,0,0
2021-01-03,1,Others(HKUST),1,1,0,0,0,0
2021-01-03,1,RPG,1,1,10,25221,341345,366566
2021-01-03,1,Staff,4,22,8048,818090,4080965,4899055
2021-01-03,1,TPG,0,0,0,0,0,0
2021-01-03,1,Total,9,29,9742,981772,4584574,5566346
2021-01-03,1,UG,3,5,1684,138461,162264,300725
2021-01-03,All-Floors,Alumni,7,24,6024,416665,24882895,25299560
2021-01-03,All-Floors,Non-HKUST,17,26,20841,5448343,59545787,64994130
2021-01-03,All-Floors,Others(HKUST),12,95,198310,10255451,72356884,82612335
2021-01-03,All-Floors,RPG,238,426,125192,35097696,2227087038,2262184734
2021-01-03,All-Floors,Staff,121,415,129482,18568111,265288564,283856675
2021-01-03,All-Floors,TPG,28,52,26561,17333302,1300911729,1318245031
2021-01-03,All-Floors,Total,615,1547,850366,458036448,8651945220,9109981668
2021-01-03,All-Floors,UG,192,509,343956,370916880,4701872323,5072789203
2021-01-03,G,Alumni,0,0,0,0,0,0
2021-01-03,G,Non-HKUST,2,2,330,71932,105494,177426
2021-01-03,G,Others(HKUST),1,16,901,11753,22822,34575
2021-01-03,G,RPG,20,20,3213,107538,1017190,1124728
2021-01-03,G,Staff,28,104,29547,12457222,73943686,86400908
2021-01-03,G,TPG,2,2,135,11854,25534,37388
2021-01-03,G,Total,61,152,36362,12718822,75299317,88018139
2021-01-03,G,UG,8,8,2236,58523,184591,243114
2021-01-03,LG1,Alumni,0,0,0,0,0,0
2021-01-03,LG1,Non-HKUST,2,2,1091,18770,41135,59905
2021-01-03,LG1,Others(HKUST),5,16,94419,2885754,17993176,20878930
2021-01-03,LG1,RPG,15,15,9527,1203668,144288514,145492182
2021-01-03,LG1,Staff,13,40,4386,57092,285211,342303
2021-01-03,LG1,TPG,1,1,5,0,0,0
2021-01-03,LG1,Total,45,83,113607,4292822,162781337,167074159
2021-01-03,LG1,UG,9,9,4179,127538,173301,300839
2021-01-03,LG3,Alumni,5,15,3447,175466,1329546,1505012
2021-01-03,LG3,Non-HKUST,8,10,2847,33856,69145,103001
2021-01-03,LG3,Others(HKUST),8,30,3328,389789,1259976,1649765
2021-01-03,LG3,RPG,143,176,23536,8260732,306026328,314287060
2021-01-03,LG3,Staff,66,144,40950,2486099,113472665,115958764
2021-01-03,LG3,TPG,17,24,16893,16560184,1267074539,1283634723
2021-01-03,LG3,Total,383,598,122748,30017205,1780129101,1810146306
2021-01-03,LG3,UG,136,199,31747,2111079,90896902,93007981
2021-01-03,LG4,Alumni,5,9,2577,241199,23553349,23794548
2021-01-03,LG4,Non-HKUST,11,12,16573,5323785,59330013,64653798
2021-01-03,LG4,Others(HKUST),9,32,99662,6968155,53080910,60049065
2021-01-03,LG4,RPG,166,214,88906,25500537,1775413661,1800914198
2021-01-03,LG4,Staff,74,105,46551,2749608,73506037,76255645
2021-01-03,LG4,TPG,17,25,9528,761264,33811656,34572920
2021-01-03,LG4,Total,425,685,567907,410025827,6629150891,7039176718
2021-01-03,LG4,UG,143,288,304110,368481279,4610455265,4978936544
2021-01-04,1,Alumni,3,138,66900,1376113869,3264153383,4640267252
2021-01-04,1,Non-HKUST,17,67,219530,173077574,5007754648,5180832222
2021-01-04,1,Others(HKUST),3,17,10579,2857952,197727311,200585263
2021-01-04,1,RPG,21,239,360458,478763027,9600414950,10079177977
2021-01-04,1,Staff,41,762,680406,1962730086,6734101822,8696831908
2021-01-04,1,TPG,21,321,534573,322498381,14188273394,14510771775
2021-01-04,1,Total,120,1635,2014237,4477365139,44814044745,49291409884
2021-01-04,1,UG,14,91,141791,161324250,5821619237,5982943487
2021-01-04,All-Floors,Alumni,20,485,422700,1734084667,13290079737,15024164404
2021-01-04,All-Floors,Non-HKUST,93,907,738406,1017448610,16791446155,17808894765
2021-01-04,All-Floors,Others(HKUST),18,172,318269,42248598,6410041116,6452289714
2021-01-04,All-Floors,RPG,455,2676,1694994,1724230707,40376356466,42100587173
2021-01-04,All-Floors,Staff,361,3623,1880844,2758561670,35839588274,38598149944
2021-01-04,All-Floors,TPG,105,2367,2379915,2007304215,70506605358,72513909573
2021-01-04,All-Floors,Total,1408,13809,10279006,17447661974,376439626496,393887288470
2021-01-04,All-Floors,UG,356,3579,2843878,8163783507,193225509390,201389292897
2021-01-04,G,Alumni,13,139,111619,125939394,2102707586,2228646980
2021-01-04,G,Non-HKUST,53,253,137413,75679860,2301696735,2377376595
2021-01-04,G,Others(HKUST),6,22,25783,2216433,21171007,23387440
2021-01-04,G,RPG,107,906,498551,383638923,12981938351,13365577274
2021-01-04,G,Staff,108,945,595151,149221170,4696104084,4845325254
2021-01-04,G,TPG,86,908,423371,352180806,8082125747,8434306553
2021-01-04,G,Total,515,4407,2232781,1457716049,49888605039,51346321088
2021-01-04,G,UG,142,1234,440893,368839463,19702861529,20071700992
2021-01-04,LG1,Alumni,7,78,45915,113320881,3485047511,3598368392
2021-01-04,LG1,Non-HKUST,26,214,168460,634741296,5462766126,6097507422
2021-01-04,LG1,Others(HKUST),7,24,126067,6788364,66367901,73156265
2021-01-04,LG1,RPG,48,384,288484,535962529,4540466267,5076428796
2021-01-04,LG1,Staff,49,450,242528,243396084,17511408471,17754804555
2021-01-04,LG1,TPG,43,532,611362,567704702,23221762195,23789466897
2021-01-04,LG1,Total,280,2705,2845753,8875913712,194743190901,203619104613
2021-01-04,LG1,UG,100,1023,1362937,6773999856,140455372430,147229372286
2021-01-04,LG3,Alumni,9,78,142173,72790109,2391302118,2464092227
2021-01-04,LG3,Non-HKUST,36,231,154141,112515454,3457863161,3570378615
2021-01-04,LG3,Others(HKUST),10,46,11772,305824,1652023,1957847
2021-01-04,LG3,RPG,287,615,319600,241055463,6129085039,6370140502
2021-01-04,LG3,Staff,241,841,163159,340475252,3775882766,4116358018
2021-01-04,LG3,TPG,53,400,631231,655320771,21918766483,22574087254
2021-01-04,LG3,Total,872,2931,1949625,2065200315,57125436658,59190636973
2021-01-04,LG3,UG,236,720,527549,642737442,19450885068,20093622510
2021-01-04,LG4,Alumni,10,52,56093,45920414,2046869139,2092789553
2021-01-04,LG4,Non-HKUST,32,142,58862,21434426,561365485,582799911
2021-01-04,LG4,Others(HKUST),11,63,144068,30080025,6123122874,6153202899
2021-01-04,LG4,RPG,309,532,227901,84810765,7124451859,7209262624
2021-01-04,LG4,Staff,214,625,199600,62739078,3122091131,3184830209
2021-01-04,LG4,TPG,42,206,179378,109599555,3095677539,3205277094
2021-01-04,LG4,Total,843,2131,1236610,571466759,29868349153,30439815912
2021-01-04,LG4,UG,225,511,370708,216882496,7794771126,8011653622
2021-01-05,1,Alumni,1,4,7727,3731345,45622484,49353829
2021-01-05,1,Non-HKUST,16,157,193011,101429459,4123587673,4225017132
2021-01-05,1,Others(HKUST),2,12,31103,11433329,398101785,409535114
2021-01-05,1,RPG,15,147,264759,254797222,3923979236,4178776458
2021-01-05,1,Staff,42,998,634199,163096807,5401275052,5564371859
2021-01-05,1,TPG,30,341,645488,751963275,27533025582,28284988857
2021-01-05,1,Total,123,1972,1939939,1448037748,48537089738,49985127486
2021-01-05,1,UG,17,313,163652,161586311,7111497926,7273084237
2021-01-05,All-Floors,Alumni,24,298,258773,276026827,20423265430,20699292257
2021-01-05,All-Floors,Non-HKUST,109,970,930918,822227678,26788479434,27610707112
2021-01-05,All-Floors,Others(HKUST),13,155,325106,33676777,1705996490,1739673267
2021-01-05,All-Floors,RPG,462,2615,1618116,2468596006,37179507507,39648103513
2021-01-05,All-Floors,Staff,357,4093,1675991,491921703,18090881663,18582803366
2021-01-05,All-Floors,TPG,130,2572,2328240,2342829643,71646993680,73989823323
2021-01-05,All-Floors,Total,1426,14326,9617525,10418713718,304681273603,315099987321
2021-01-05,All-Floors,UG,331,3623,2480381,3983435084,128846149399,132829584483
2021-01-05,G,Alumni,12,140,63936,42819335,1290945748,1333765083
2021-01-05,G,Non-HKUST,51,299,301809,247552304,6257129407,6504681711
2021-01-05,G,Others(HKUST),4,11,49432,5180406,1152958801,1158139207
2021-01-05,G,RPG,101,887,445577,609486692,7651344381,8260831073
2021-01-05,G,Staff,100,983,478203,151002607,4219993835,4370996442
2021-01-05,G,TPG,99,1059,400101,396303126,10979439512,11375742638
2021-01-05,G,Total,495,4570,2160037,2271094983,65193230259,67464325242
2021-01-05,G,UG,128,1191,420979,818750513,33641418575,34460169088
2021-01-05,LG1,Alumni,4,49,40833,64740971,3579705251,3644446222
2021-01-05,LG1,Non-HKUST,32,180,239814,138716131,12332615087,12471331218
2021-01-05,LG1,Others(HKUST),8,50,131954,7747418,58203625,65951043
2021-01-05,LG1,RPG,51,483,428563,1363639845,12276584088,13640223933
2021-01-05,LG1,Staff,56,462,266378,90921568,5401610304,5492531872
2021-01-05,LG1,TPG,48,558,546997,500088919,16665934259,17166023178
2021-01-05,LG1,Total,297,2704,2876468,4570365621,120471122607,125041488228
2021-01-05,LG1,UG,98,922,1221929,2404510769,70156469993,72560980762
2021-01-05,LG3,Alumni,9,52,101395,128996439,9128807550,9257803989
2021-01-05,LG3,Non-HKUST,46,285,173686,311582128,3679063293,3990645421
2021-01-05,LG3,Others(HKUST),7,42,8639,178411,15219762,15398173
2021-01-05,LG3,RPG,314,626,316914,199973241,11910276009,12110249250
2021-01-05,LG3,Staff,248,974,137490,21008285,625438881,646447166
2021-01-05,LG3,TPG,62,453,565512,644694035,12754660381,13399354416
2021-01-05,LG3,Total,902,3065,1656027,1604591078,51824513112,53429104190
2021-01-05,LG3,UG,216,633,352391,298158539,13711047236,14009205775
2021-01-05,LG4,Alumni,12,53,44882,35738737,6378184397,6413923134
2021-01-05,LG4,Non-HKUST,29,49,22598,22947656,396083974,419031630
2021-01-05,LG4,Others(HKUST),5,40,103978,9137213,81512517,90649730
2021-01-05,LG4,RPG,303,472,162303,40699006,1417323793,1458022799
2021-01-05,LG4,Staff,205,676,159721,65892436,2442563591,2508456027
2021-01-05,LG4,TPG,51,161,170142,49780288,3713933946,3763714234
2021-01-05,LG4,Total,807,2015,985054,524624288,18655317887,19179942175
2021-01-05,LG4,UG,202,564,321430,300428952,4225715669,4526144621
2021-01-06,1,Alumni,1,47,22785,45521230,732514835,778036065
2021-01-06,1,Non-HKUST,17,103,162549,118285130,3045176029,3163461159
2021-01-06,1,Others(HKUST),5,48,30011,120818378,8515080413,8635898791
2021-01-06,1,RPG,16,181,359707,224892513,6795767059,7020659572
2021-01-06,1,Staff,41,723,751750,119292566,1949995336,2069287902
2021-01-06,1,TPG,27,294,540261,399925478,16700735435,17100660913
2021-01-06,1,Total,131,1700,2197329,2035484267,48265915363,50301399630
2021-01-06,1,UG,24,304,330266,1006748972,10526646256,11533395228
2021-01-06,All-Floors,Alumni,14,323,266696,327577893,11228342328,11555920221
2021-01-06,All-Floors,Non-HKUST,98,882,744268,710919697,22824074469,23534994166
2021-01-06,All-Floors,Others(HKUST),15,458,331796,177566134,9463145107,9640711241
2021-01-06,All-Floors,RPG,468,2641,2014272,2351405331,73239257236,75590662567
2021-01-06,All-Floors,Staff,366,3495,1752338,538769624,20085029455,20623799079
2021-01-06,All-Floors,TPG,114,2621,2336020,2576957468,60631716747,63208674215
2021-01-06,All-Floors,Total,1435,14603,10489659,10747911186,295009781737,305757692923
2021-01-06,All-Floors,UG,360,4183,3044269,4064715039,97538216395,101602931434
2021-01-06,G,Alumni,10,141,77713,160862620,1865646223,2026508843
2021-01-06,G,Non-HKUST,48,270,207224,72199862,1563654063,1635853925
2021-01-06,G,Others(HKUST),6,91,9876,1180100,45517350,46697450
2021-01-06,G,RPG,120,922,493838,352915260,8794780587,9147695847
2021-01-06,G,Staff,97,855,430219,251082663,10865179019,11116261682
2021-01-06,G,TPG,85,970,347677,586918790,7774496453,8361415243
2021-01-06,G,Total,502,4711,1995586,1945601916,44989937879,46935539795
2021-01-06,G,UG,136,1462,429039,520442621,14080664184,14601106805
2021-01-06,LG1,Alumni,4,46,25997,21590536,279562437,301152973
2021-01-06,LG1,Non-HKUST,33,214,246801,459880108,15435446709,15895326817
2021-01-06,LG1,Others(HKUST),8,55,134107,18329098,308289511,326618609
2021-01-06,LG1,RPG,60,433,511757,688859194,17743082364,18431941558
2021-01-06,LG1,Staff,48,514,248558,125745620,5778520829,5904266449
2021-01-06,LG1,TPG,47,710,946390,1165356800,27346912189,28512268989
2021-01-06,LG1,Total,302,3366,3784999,4449098336,122969188511,127418286847
2021-01-06,LG1,UG,102,1394,1671389,1969336980,56077374472,58046711452
2021-01-06,LG3,Alumni,9,53,113627,84755636,7430552000,7515307636
2021-01-06,LG3,Non-HKUST,42,155,62231,36191203,864107651,900298854
2021-01-06,LG3,Others(HKUST),9,206,52503,32758979,533314642,566073621
2021-01-06,LG3,RPG,299,615,396868,864701738,36010321329,36875023067
2021-01-06,LG3,Staff,253,772,142378,25099818,991377640,1016477458
2021-01-06,LG3,TPG,64,444,423692,374443435,7211276152,7585719587
2021-01-06,LG3,Total,888,2791,1508399,1913960737,65739821644,67653782381
2021-01-06,LG3,UG,212,546,317100,496009928,12698872230,13194882158
2021-01-06,LG4,Alumni,9,36,26574,14847871,920066833,934914704
2021-01-06,LG4,Non-HKUST,38,140,65463,24363394,1915690017,1940053411
2021-01-06,LG4,Others(HKUST),10,58,105299,4479579,60943191,65422770
2021-01-06,LG4,RPG,305,490,252102,220036626,3895305897,4115342523
2021-01-06,LG4,Staff,224,631,179433,17548957,499956631,517505588
2021-01-06,LG4,TPG,51,203,78000,50312965,1598296518,1648609483
2021-01-06,LG4,Total,862,2035,1003346,403765930,13044918340,13448684270
2021-01-06,LG4,UG,225,477,296475,72176538,4154659253,4226835791
2021-01-07,1,Alumni,2,49,26145,81018309,917715904,998734213
2021-01-07,1,Non-HKUST,10,31,90255,62468190,2436227477,2498695667
2021-01-07,1,Others(HKUST),3,25,47122,908437,149490249,150398686
2021-01-07,1,RPG,12,120,218079,147906960,2812676802,2960583762
2021-01-07,1,Staff,35,815,565538,158247666,3783652770,3941900436
2021-01-07,1,TPG,29,370,687447,788526910,29997583168,30786110078
2021-01-07,1,Total,107,1623,1927391,1527695721,51066071251,52593766972
2021-01-07,1,UG,16,213,292805,288619249,10968724881,11257344130
2021-01-07,All-Floors,Alumni,15,381,289429,386022247,29411827235,29797849482
2021-01-07,All-Floors,Non-HKUST,109,786,736615,465019078,22522117002,22987136080
2021-01-07,All-Floors,Others(HKUST),15,170,352359,49074782,770939444,820014226
2021-01-07,All-Floors,RPG,416,2703,1699300,1685801093,45728195048,47413996141
2021-01-07,All-Floors,Staff,341,3331,1430650,572338059,14569511983,15141850042
2021-01-07,All-Floors,TPG,105,2609,2502429,3690890463,93537941307,97228831770
2021-01-07,All-Floors,Total,1304,13113,9334545,9629366776,323218124713,332847491489
2021-01-07,All-Floors,UG,303,3133,2323763,2780221054,116677592694,119457813748
2021-01-07,G,Alumni,10,194,98171,129053868,15665587859,15794641727
2021-01-07,G,Non-HKUST,56,279,172479,75221339,2977588506,3052809845
2021-01-07,G,Others(HKUST),5,28,39708,2059148,43767635,45826783
2021-01-07,G,RPG,106,876,401630,308413673,10017718600,10326132273
2021-01-07,G,Staff,94,938,417328,172459079,2743377493,2915836572
2021-01-07,G,TPG,81,1044,510444,447915306,26225155155,26673070461
2021-01-07,G,Total,471,4390,2143997,1691102404,80576888944,82267991348
2021-01-07,G,UG,119,1031,504237,555979991,22903693696,23459673687
2021-01-07,LG1,Alumni,7,50,35425,50021224,4417482893,4467504117
2021-01-07,LG1,Non-HKUST,35,206,273474,192139713,6705529859,6897669572
2021-01-07,LG1,Others(HKUST),4,6,122050,6784920,152871492,159656412
2021-01-07,LG1,RPG,50,606,611359,849925777,23045918174,23895843951
2021-01-07,LG1,Staff,50,369,150023,131530464,4557342510,4688872974
2021-01-07,LG1,TPG,47,788,953923,2086854783,28169044681,30255899464
2021-01-07,LG1,Total,281,2903,2969121,4802819303,115880418601,120683237904
2021-01-07,LG1,UG,88,878,822867,1485562422,48832228992,50317791414
2021-01-07,LG3,Alumni,10,75,120370,116468861,5967829818,6084298679
2021-01-07,LG3,Non-HKUST,44,147,101360,58607700,7548298246,7606905946
2021-01-07,LG3,Others(HKUST),11,58,31091,10922390,337385824,348308214
2021-01-07,LG3,RPG,254,633,279113,160595510,5926069130,6086664640
2021-01-07,LG3,Staff,226,775,150310,26141230,1554725103,1580866333
2021-01-07,LG3,TPG,47,320,315041,338121864,7395685809,7733807673
2021-01-07,LG3,Total,765,2541,1346993,992534655,47929148643,48921683298
2021-01-07,LG3,UG,173,533,349708,281677100,19199154713,19480831813
2021-01-07,LG4,Alumni,6,13,9318,9459985,2443210761,2452670746
2021-01-07,LG4,Non-HKUST,38,123,99047,76582136,2854472914,2931055050
2021-01-07,LG4,Others(HKUST),10,53,112388,28399887,87424244,115824131
2021-01-07,LG4,RPG,268,468,189119,218959173,3925812342,4144771515
2021-01-07,LG4,Staff,201,434,147451,83959620,1930414107,2014373727
2021-01-07,LG4,TPG,42,87,35574,29471600,1750472494,1779944094
2021-01-07,LG4,Total,751,1656,947043,615214693,27765597274,28380811967
2021-01-07,LG4,UG,186,478,354146,168382292,14773790412,14942172704
2021-01-08,1,Alumni,4,64,61004,128245649,1292923834,1421169483
2021-01-08,1,Non-HKUST,22,102,255025,159780172,4015530516,4175310688
2021-01-08,1,Others(HKUST),4,27,60291,8950573,102254955,111205528
2021-01-08,1,RPG,7,53,52267,25251183,823870956,849122139
2021-01-08,1,Staff,32,503,446066,134483873,2658839959,2793323832
2021-01-08,1,TPG,29,495,671820,604674759,39078505000,39683179759
2021-01-08,1,Total,112,1511,1714577,1185711162,52265253785,53450964947
2021-01-08,1,UG,14,267,168104,124324953,4293328565,4417653518
2021-01-08,All-Floors,Alumni,19,406,305193,343561315,13384367456,13727928771
2021-01-08,All-Floors,Non-HKUST,101,886,878295,641709475,27739321102,28381030577
2021-01-08,All-Floors,Others(HKUST),18,204,324509,41148804,465185768,506334572
2021-01-08,All-Floors,RPG,333,2012,1460749,763327323,35987229352,36750556675
2021-01-08,All-Floors,Staff,271,2428,1292981,534058799,25427283089,25961341888
2021-01-08,All-Floors,TPG,96,2320,2205190,2175057677,101122106366,103297164043
2021-01-08,All-Floors,Total,1127,11086,8293427,6203853081,277946612814,284150465895
2021-01-08,All-Floors,UG,289,2830,1826510,1704989688,73821119681,75526109369
2021-01-08,G,Alumni,13,169,69482,91666687,4320289267,4411955954
2021-01-08,G,Non-HKUST,52,311,208109,74236147,2664546868,2738783015
2021-01-08,G,Others(HKUST),7,29,11836,1621974,12527402,14149376
2021-01-08,G,RPG,71,717,374644,247288983,16584766528,16832055511
2021-01-08,G,Staff,67,614,460390,166108226,9524320318,9690428544
2021-01-08,G,TPG,83,872,264911,186960712,8389055033,8576015745
2021-01-08,G,Total,417,3650,1831451,1297689075,72481060258,73778749333
2021-01-08,G,UG,124,938,442079,529806346,30985554842,31515361188
2021-01-08,LG1,Alumni,8,34,9352,7587197,269923073,277510270
2021-01-08,LG1,Non-HKUST,36,126,199846,165050458,13129321948,13294372406
2021-01-08,LG1,Others(HKUST),7,40,130312,10979592,87944010,98923602
2021-01-08,LG1,RPG,41,499,566059,208400208,10045220222,10253620430
2021-01-08,LG1,Staff,39,340,154241,91124153,10423424905,10514549058
2021-01-08,LG1,TPG,41,560,857342,742000467,39543340214,40285340681
2021-01-08,LG1,Total,240,2302,2574127,1900479130,92081180466,93981659596
2021-01-08,LG1,UG,68,703,656975,675337055,18582006094,19257343149
2021-01-08,LG3,Alumni,15,89,147374,100506987,6397400383,6497907370
2021-01-08,LG3,Non-HKUST,41,224,149706,213538125,5552723801,5766261926
2021-01-08,LG3,Others(HKUST),6,46,10024,202430,1073580,1276010
2021-01-08,LG3,RPG,212,419,294243,234053498,6142699434,6376752932
2021-01-08,LG3,Staff,176,605,136267,120714422,2472797245,2593511667
2021-01-08,LG3,TPG,36,283,330429,605016980,11917783375,12522800355
2021-01-08,LG3,Total,663,2154,1331187,1484994409,44055303822,45540298231
2021-01-08,LG3,UG,177,488,263144,210961967,11570826004,11781787971
2021-01-08,LG4,Alumni,13,50,17981,15554795,1103830899,1119385694
2021-01-08,LG4,Non-HKUST,26,123,65609,29104573,2377197969,2406302542
2021-01-08,LG4,Others(HKUST),12,62,112046,19394235,261385821,280780056
2021-01-08,LG4,RPG,201,324,173536,48333451,2390672212,2439005663
2021-01-08,LG4,Staff,147,366,96017,21628125,347900662,369528787
2021-01-08,LG4,TPG,35,110,80688,36404759,2193422744,2229827503
2021-01-08,LG4,Total,604,1469,842085,334979305,17063814483,17398793788
2021-01-08,LG4,UG,170,434,296208,164559367,8389404176,8553963543
2021-01-09,1,Alumni,0,0,0,0,0,0
2021-01-09,1,Non-HKUST,8,15,65791,50116535,1858766712,1908883247
2021-01-09,1,Others(HKUST),1,1,36979,796352,5046087,5842439
2021-01-09,1,RPG,3,20,30460,22237013,1352072595,1374309608
2021-01-09,1,Staff,11,48,80351,11237684,55573878,66811562
2021-01-09,1,TPG,9,77,78200,57535309,3972918280,4030453589
2021-01-09,1,Total,42,238,455494,261700859,14662119093,14923819952
2021-01-09,1,UG,10,77,163713,119777966,7417741541,7537519507
2021-01-09,All-Floors,Alumni,10,85,54265,44395583,3506821478,3551217061
2021-01-09,All-Floors,Non-HKUST,44,360,254559,166916541,4642977530,4809894071
2021-01-09,All-Floors,Others(HKUST),7,47,252612,15983293,2894433467,2910416760
2021-01-09,All-Floors,RPG,216,868,491960,369738439,16078491436,16448229875
2021-01-09,All-Floors,Staff,118,794,317336,221954262,1876441632,2098395894
2021-01-09,All-Floors,TPG,67,784,618457,478776716,28208742330,28687519046
2021-01-09,All-Floors,Total,695,4478,3033789,2160572741,88284494217,90445066958
2021-01-09,All-Floors,UG,233,1540,1044600,862807907,31076586344,31939394251
2021-01-09,G,Alumni,5,23,2698,2252756,536054112,538306868
2021-01-09,G,Non-HKUST,20,97,31785,10700788,61893025,72593813
2021-01-09,G,Others(HKUST),2,2,9434,63548,854842,918390
2021-01-09,G,RPG,40,243,129168,94467028,5007173175,5101640203
2021-01-09,G,Staff,40,224,67663,182524040,1396929526,1579453566
2021-01-09,G,TPG,40,319,270382,189832395,15630674729,15820507124
2021-01-09,G,Total,216,1410,686062,608865845,30588300715,31197166560
2021-01-09,G,UG,69,502,174932,129025290,7954721306,8083746596
2021-01-09,LG1,Alumni,4,28,20009,18620769,593279919,611900688
2021-01-09,LG1,Non-HKUST,16,167,114109,61415936,2066125182,2127541118
2021-01-09,LG1,Others(HKUST),2,3,92898,3482,13239,16721
2021-01-09,LG1,RPG,23,183,147436,180673342,6937029683,7117703025
2021-01-09,LG1,Staff,22,101,75675,11512066,234934980,246447046
2021-01-09,LG1,TPG,19,112,84099,165568751,4458394997,4623963748
2021-01-09,LG1,Total,135,930,804396,949714943,25488030401,26437745344
2021-01-09,LG1,UG,49,336,270170,511920597,11198252401,11710172998
2021-01-09,LG3,Alumni,4,13,624,18367,19892,38259
2021-01-09,LG3,Non-HKUST,14,32,15158,17024698,259184565,276209263
2021-01-09,LG3,Others(HKUST),5,17,5195,241992,594916,836908
2021-01-09,LG3,RPG,125,210,77215,36941948,656030101,692972049
2021-01-09,LG3,Staff,75,268,71297,15198357,153552171,168750528
2021-01-09,LG3,TPG,34,186,141377,51380795,3210041467,3261422262
2021-01-09,LG3,Total,405,1073,511638,187211692,7068094461,7255306153
2021-01-09,LG3,UG,148,347,200772,66405535,2788671349,2855076884
2021-01-09,LG4,Alumni,7,21,30934,23503691,2377467555,2400971246
2021-01-09,LG4,Non-HKUST,12,49,27716,27658584,397008046,424666630
2021-01-09,LG4,Others(HKUST),5,24,108106,14877919,2887924383,2902802302
2021-01-09,LG4,RPG,139,212,107681,35419108,2126185882,2161604990
2021-01-09,LG4,Staff,51,153,22350,1482115,35451077,36933192
2021-01-09,LG4,TPG,34,90,44399,14459466,936712857,951172323
2021-01-09,LG4,Total,389,827,576199,153079402,10477949547,10631028949
2021-01-09,LG4,UG,141,278,235013,35678519,1717199747,1752878266
2021-01-10,1,Alumni,0,0,0,0,0,0
2021-01-10,1,Non-HKUST,5,20,41980,48820213,1027085011,1075905224
2021-01-10,1,Others(HKUST),1,1,36693,759521,4273588,5033109
2021-01-10,1,RPG,12,89,113852,37615492,2759003475,2796618967
2021-01-10,1,Staff,5,35,9584,2799317,53324845,56124162
2021-01-10,1,TPG,8,50,70121,56696213,2460104628,2516800841
2021-01-10,1,Total,36,211,287766,150150612,6399229146,6549379758
2021-01-10,1,UG,5,16,15536,3459856,95437599,98897455
2021-01-10,All-Floors,Alumni,9,85,98736,84348646,7029542653,7113891299
2021-01-10,All-Floors,Non-HKUST,32,186,171091,129680768,3173712415,3303393183
2021-01-10,All-Floors,Others(HKUST),9,45,283505,15201547,129870704,145072251
2021-01-10,All-Floors,RPG,243,912,563603,321640492,15474648356,15796288848
2021-01-10,All-Floors,Staff,94,410,176906,95801039,1065252589,1161053628
2021-01-10,All-Floors,TPG,56,942,733696,552381748,45236918482,45789300230
2021-01-10,All-Floors,Total,684,4157,3171578,2176031506,131984676024,134160707530
2021-01-10,All-Floors,UG,241,1577,1144041,976977266,59874730825,60851708091
2021-01-10,G,Alumni,4,24,1032,1204436,60721870,61926306
2021-01-10,G,Non-HKUST,15,93,35936,21250971,682296896,703547867
2021-01-10,G,Others(HKUST),3,8,54045,1319186,17290230,18609416
2021-01-10,G,RPG,51,276,218300,185639356,5783782319,5969421675
2021-01-10,G,Staff,25,106,45127,53116448,144197496,197313944
2021-01-10,G,TPG,34,318,203374,114667266,10379427396,10494094662
2021-01-10,G,Total,199,1305,840471,555634045,24003887652,24559521697
2021-01-10,G,UG,67,480,282657,178436382,6936171445,7114607827
2021-01-10,LG1,Alumni,4,27,56408,53388795,4133975607,4187364402
2021-01-10,LG1,Non-HKUST,12,42,65493,29392820,992326806,1021719626
2021-01-10,LG1,Others(HKUST),2,3,92882,5775597,37111920,42887517
2021-01-10,LG1,RPG,25,94,83162,46739217,4809371201,4856110418
2021-01-10,LG1,Staff,12,40,29633,24172096,374933635,399105731
2021-01-10,LG1,TPG,22,245,234680,234181943,23463140889,23697322832
2021-01-10,LG1,Total,122,892,1009771,1128059513,83739355372,84867414885
2021-01-10,LG1,UG,45,441,447513,734409045,49928495314,50662904359
2021-01-10,LG3,Alumni,6,26,22432,18320210,396339274,414659484
2021-01-10,LG3,Non-HKUST,9,13,9970,24659251,167731724,192390975
2021-01-10,LG3,Others(HKUST),6,13,1575,32681,90679,123360
2021-01-10,LG3,RPG,153,252,65870,38845048,1713564089,1752409137
2021-01-10,LG3,Staff,60,140,66851,4436997,42324910,46761907
2021-01-10,LG3,TPG,29,231,148771,100812085,3102653868,3203465953
2021-01-10,LG3,Total,406,1011,467615,222079556,7053891798,7275971354
2021-01-10,LG3,UG,143,336,152146,34973284,1631187254,1666160538
2021-01-10,LG4,Alumni,4,8,18864,11435205,2438505902,2449941107
2021-01-10,LG4,Non-HKUST,9,18,17712,5557513,304271978,309829491
2021-01-10,LG4,Others(HKUST),4,20,98310,7314562,71104287,78418849
2021-01-10,LG4,RPG,145,201,82419,12801379,408927272,421728651
2021-01-10,LG4,Staff,47,89,25711,11276181,450471703,461747884
2021-01-10,LG4,TPG,36,98,76750,46024241,5831591701,5877615942
2021-01-10,LG4,Total,407,738,565955,120107780,10788312056,10908419836
2021-01-10,LG4,UG,162,304,246189,25698699,1283439213,1309137912
2021-01-11,1,Alumni,1,52,39246,83858659,1651448468,1735307127
2021-01-11,1,Non-HKUST,5,12,51140,309418325,1059974110,1369392435
2021-01-11,1,Others(HKUST),4,41,40999,5417227,583773193,589190420
2021-01-11,1,RPG,19,179,227591,126343546,4441670208,4568013754
2021-01-11,1,Staff,50,770,693378,267124881,7061099313,7328224194
2021-01-11,1,TPG,30,309,516378,443138952,14083613764,14526752716
2021-01-11,1,Total,122,1479,1750267,1378280535,34303824439,35682104974
2021-01-11,1,UG,13,116,181535,142978945,5422245383,5565224328
2021-01-11,All-Floors,Alumni,16,371,371049,402448026,14668855075,15071303101
2021-01-11,All-Floors,Non-HKUST,77,922,603553,687164159,20307808709,20994972868
2021-01-11,All-Floors,Others(HKUST),15,253,423204,55544325,2465477763,2521022088
2021-01-11,All-Floors,RPG,355,2678,1813647,1348109458,39725304153,41073413611
2021-01-11,All-Floors,Staff,346,3558,1631447,708143804,20952499545,21660643349
2021-01-11,All-Floors,TPG,85,2106,2054298,3233341466,74631813623,77865155089
2021-01-11,All-Floors,Total,1183,13094,9269156,9592823161,296754563129,306347386290
2021-01-11,All-Floors,UG,289,3206,2371958,3158071923,124002804261,127160876184
2021-01-11,G,Alumni,12,158,126673,188388432,6467116611,6655505043
2021-01-11,G,Non-HKUST,37,295,133285,111817720,1351562294,1463380014
2021-01-11,G,Others(HKUST),4,30,124615,25447839,279270709,304718548
2021-01-11,G,RPG,113,1011,471066,342353262,13481436039,13823789301
2021-01-11,G,Staff,116,981,433838,241337578,2212929831,2454267409
2021-01-11,G,TPG,78,844,485767,1003845811,16504557251,17508403062
2021-01-11,G,Total,490,4485,2300157,2500424006,55509060228,58009484234
2021-01-11,G,UG,130,1166,524913,587233364,15212187493,15799420857
2021-01-11,LG1,Alumni,5,23,14432,9375646,322517051,331892697
2021-01-11,LG1,Non-HKUST,35,164,244245,187417956,9401004498,9588422454
2021-01-11,LG1,Others(HKUST),6,19,122980,6598813,61427004,68025817
2021-01-11,LG1,RPG,60,628,612416,625110617,12161070412,12786181029
2021-01-11,LG1,Staff,61,437,237429,133940217,9092931427,9226871644
2021-01-11,LG1,TPG,37,573,648594,661476664,23931405270,24592881934
2021-01-11,LG1,Total,290,2754,2793152,2991027450,88888326462,91879353912
2021-01-11,LG1,UG,86,910,913056,1367107537,33917970800,35285078337
2021-01-11,LG3,Alumni,9,94,175046,112066536,5408692448,5520758984
2021-01-11,LG3,Non-HKUST,33,176,110970,44930447,2242306522,2287236969
2021-01-11,LG3,Others(HKUST),11,123,19688,4980394,727972371,732952765
2021-01-11,LG3,RPG,206,525,358769,217083641,8179246690,8396330331
2021-01-11,LG3,Staff,231,708,105821,14975412,803987318,818962730
2021-01-11,LG3,TPG,37,244,259447,1058592534,15365206413,16423798947
2021-01-11,LG3,Total,680,2470,1509986,2426024920,94716649760,97142674680
2021-01-11,LG3,UG,153,600,480245,973395956,61989237998,62962633954
2021-01-11,LG4,Alumni,6,44,15652,8758753,819080497,827839250
2021-01-11,LG4,Non-HKUST,28,275,63913,33579711,6252961285,6286540996
2021-01-11,LG4,Others(HKUST),12,40,114922,13100052,813034486,826134538
2021-01-11,LG4,RPG,207,335,143805,37218392,1461880804,1499099196
2021-01-11,LG4,Staff,180,662,160981,50765716,1781551656,1832317372
2021-01-11,LG4,TPG,28,136,144112,66287505,4747030925,4813318430
2021-01-11,LG4,Total,632,1906,915594,297066250,23336702240,23633768490
2021-01-11,LG4,UG,171,414,272209,87356121,7461162587,7548518708
2021-01-12,1,Alumni,3,14,8296,14588676,532798499,547387175
2021-01-12,1,Non-HKUST,16,136,173510,145321754,5360542653,5505864407
2021-01-12,1,Others(HKUST),4,12,12259,85035070,617060866,702095936
2021-01-12,1,RPG,8,57,105895,110501623,3622974546,3733476169
2021-01-12,1,Staff,46,718,737918,99564459,3050907427,3150471886
2021-01-12,1,TPG,24,259,590971,645184987,36757986821,37403171808
2021-01-12,1,Total,113,1405,1906127,1638695269,88328678535,89967373804
2021-01-12,1,UG,12,209,277278,538498700,38386407723,38924906423
2021-01-12,All-Floors,Alumni,12,271,221907,153549385,7388916163,7542465548
2021-01-12,All-Floors,Non-HKUST,90,1273,801616,537457827,27123705436,27661163263
2021-01-12,All-Floors,Others(HKUST),15,149,312614,110340304,1364735465,1475075769
2021-01-12,All-Floors,RPG,377,2392,1770994,2528249577,66936312794,69464562371
2021-01-12,All-Floors,Staff,344,3093,1751101,464994841,26977682958,27442677799
2021-01-12,All-Floors,TPG,97,2132,2212501,2079770541,108653152341,110732922882
2021-01-12,All-Floors,Total,1243,12124,9242132,7877554341,356258385787,364135940128
2021-01-12,All-Floors,UG,308,2814,2171399,2003191866,117813880630,119817072496
2021-01-12,G,Alumni,6,137,45412,37615651,1166468416,1204084067
2021-01-12,G,Non-HKUST,46,331,262521,195980284,6782992146,6978972430
2021-01-12,G,Others(HKUST),4,11,54771,1105858,17649231,18755089
2021-01-12,G,RPG,110,817,463207,334909953,9008277604,9343187557
2021-01-12,G,Staff,104,806,429542,166225504,14840725740,15006951244
2021-01-12,G,TPG,78,864,422040,446441613,17247787997,17694229610
2021-01-12,G,Total,459,3865,2162467,1577002509,69313751391,70890753900
2021-01-12,G,UG,111,899,484974,394723646,20249850257,20644573903
2021-01-12,LG1,Alumni,3,55,54463,37673664,3483099232,3520772896
2021-01-12,LG1,Non-HKUST,38,310,191575,138724963,12475792577,12614517540
2021-01-12,LG1,Others(HKUST),4,15,122869,4482122,605179493,609661615
2021-01-12,LG1,RPG,63,615,753210,1878390879,45833840788,47712231667
2021-01-12,LG1,Staff,49,322,242576,115218438,6386181891,6501400329
2021-01-12,LG1,TPG,38,610,733089,599491781,36003802218,36603293999
2021-01-12,LG1,Total,268,2614,2816529,3544755592,136918720532,140463476124
2021-01-12,LG1,UG,73,687,718747,770773745,32130824333,32901598078
2021-01-12,LG3,Alumni,7,38,84592,53894380,1559766165,1613660545
2021-01-12,LG3,Non-HKUST,36,224,76989,22861686,1669494563,1692356249
2021-01-12,LG3,Others(HKUST),6,51,5089,8497850,12088009,20585859
2021-01-12,LG3,RPG,234,507,264209,158067492,6245061391,6403128883
2021-01-12,LG3,Staff,228,787,152643,34081643,1605685353,1639766996
2021-01-12,LG3,TPG,34,238,281754,213399814,13613225029,13826624843
2021-01-12,LG3,Total,734,2433,1275019,716764586,44868322478,45585087064
2021-01-12,LG3,UG,189,588,409743,225961721,20163001968,20388963689
2021-01-12,LG4,Alumni,6,27,29144,9777014,646783851,656560865
2021-01-12,LG4,Non-HKUST,29,272,97021,34569140,834883497,869452637
2021-01-12,LG4,Others(HKUST),10,60,117626,11219404,112757866,123977270
2021-01-12,LG4,RPG,238,396,184473,46379630,2226158465,2272538095
2021-01-12,LG4,Staff,182,460,188422,49904797,1094182547,1144087344
2021-01-12,LG4,TPG,39,161,184647,175252346,5030350276,5205602622
2021-01-12,LG4,Total,692,1807,1081990,400336385,16828912851,17229249236
2021-01-12,LG4,UG,188,431,280657,73234054,6883796349,6957030403
2021-01-13,1,Alumni,2,64,73285,43243002,1897880286,1941123288
2021-01-13,1,Non-HKUST,16,86,125859,245211289,6085279839,6330491128
2021-01-13,1,Others(HKUST),4,15,1896,193939,19571499,19765438
2021-01-13,1,RPG,12,159,219677,110797658,4261014685,4371812343
2021-01-13,1,Staff,52,957,868167,144193769,4296928329,4441122098
2021-01-13,1,TPG,26,350,561319,780617887,35799516302,36580134189
2021-01-13,1,Total,131,1747,2093669,1732745951,78780262009,80513007960
2021-01-13,1,UG,19,116,243466,408488407,26420071069,26828559476
2021-01-13,All-Floors,Alumni,15,361,359040,277253357,68195091226,68472344583
2021-01-13,All-Floors,Non-HKUST,79,938,787771,946185741,41931488293,42877674034
2021-01-13,All-Floors,Others(HKUST),18,139,283721,82349820,1525423788,1607773608
2021-01-13,All-Floors,RPG,391,2369,1808414,2329622134,55087962405,57417584539
2021-01-13,All-Floors,Staff,379,3898,1804797,619038670,16758381596,17377420266
2021-01-13,All-Floors,TPG,95,2338,2144207,2235942770,106294001782,108529944552
2021-01-13,All-Floors,Total,1283,13402,9742540,14920516445,454751365443,469671881888
2021-01-13,All-Floors,UG,306,3359,2554590,8430123953,164959016353,173389140306
2021-01-13,G,Alumni,11,91,4588,14157656,736640906,750798562
2021-01-13,G,Non-HKUST,46,309,169690,94461972,5413243145,5507705117
2021-01-13,G,Others(HKUST),6,19,31682,12371032,559612042,571983074
2021-01-13,G,RPG,100,825,488015,339440431,12744927528,13084367959
2021-01-13,G,Staff,119,938,370235,317894202,5260217934,5578112136
2021-01-13,G,TPG,72,881,374193,341174257,22877410965,23218585222
2021-01-13,G,Total,487,4421,2088481,1759560577,74810142862,76569703439
2021-01-13,G,UG,133,1358,650078,640061027,27218090342,27858151369
2021-01-13,LG1,Alumni,6,93,100202,88455700,56485639922,56574095622
2021-01-13,LG1,Non-HKUST,34,209,277588,478411456,25594098758,26072510214
2021-01-13,LG1,Others(HKUST),6,21,136030,10645477,663686661,674332138
2021-01-13,LG1,RPG,53,483,595228,1582626960,24416918204,25999545164
2021-01-13,LG1,Staff,46,406,218404,58863073,4301025400,4359888473
2021-01-13,LG1,TPG,42,454,535724,662045545,29599430715,30261476260
2021-01-13,LG1,Total,273,2469,2661422,4552424657,187002603155,191555027812
2021-01-13,LG1,UG,86,803,798246,1671376446,45941803495,47613179941
2021-01-13,LG3,Alumni,7,80,135726,114092363,7196905524,7310997887
2021-01-13,LG3,Non-HKUST,35,204,96958,73353472,2534188790,2607542262
2021-01-13,LG3,Others(HKUST),13,52,16712,50606266,235698724,286304990
2021-01-13,LG3,RPG,247,517,293885,240141075,10405928133,10646069208
2021-01-13,LG3,Staff,247,954,167421,33334119,1677942094,1711276213
2021-01-13,LG3,TPG,55,411,456939,279454890,11545108645,11824563535
2021-01-13,LG3,Total,784,2906,1725000,6413453600,93619346200,100032799800
2021-01-13,LG3,UG,180,688,557359,5622471415,60023574290,65646045705
2021-01-13,LG4,Alumni,5,33,45239,17304636,1878024588,1895329224
2021-01-13,LG4,Non-HKUST,24,130,117676,54747552,2304677761,2359425313
2021-01-13,LG4,Others(HKUST),11,32,97401,8533106,46854862,55387968
2021-01-13,LG4,RPG,236,385,211609,56616010,3259173855,3315789865
2021-01-13,LG4,Staff,202,643,180570,64753507,1222267839,1287021346
2021-01-13,LG4,TPG,49,242,216032,172650191,6472535155,6645185346
2021-01-13,LG4,Total,713,1859,1173968,462331660,20539011217,21001342877
2021-01-13,LG4,UG,186,394,305441,87726658,5355477157,5443203815
2021-01-14,1,Alumni,3,53,29462,13170366,365086360,378256726
2021-01-14,1,Non-HKUST,23,110,213237,219602559,7890738008,8110340567
2021-01-14,1,Others(HKUST),3,24,29682,2045046,21986492,24031538
2021-01-14,1,RPG,15,101,129999,74504519,5903863421,5978367940
2021-01-14,1,Staff,45,816,720825,233387800,5043593395,5276981195
2021-01-14,1,TPG,30,369,618265,1333749191,36208926880,37542676071
2021-01-14,1,Total,135,1650,2139300,2462385827,87528729724,89991115551
2021-01-14,1,UG,16,177,397830,585926346,32094535168,32680461514
2021-01-14,All-Floors,Alumni,19,357,335016,416476220,18093830975,18510307195
2021-01-14,All-Floors,Non-HKUST,109,1115,925338,671870746,34111929876,34783800622
2021-01-14,All-Floors,Others(HKUST),21,235,393765,43491563,1000230523,1043722086
2021-01-14,All-Floors,RPG,397,2367,1564651,1097625120,47629533069,48727158189
2021-01-14,All-Floors,Staff,354,3862,1753834,822451958,27630411553,28452863511
2021-01-14,All-Floors,TPG,125,3087,2882260,4200783951,126074167096,130274951047
2021-01-14,All-Floors,Total,1336,14329,10396441,11748930765,356576797540,368325728305
2021-01-14,All-Floors,UG,311,3306,2541577,4496231207,102036694448,106532925655
2021-01-14,G,Alumni,12,170,100214,100079517,1418925408,1519004925
2021-01-14,G,Non-HKUST,53,325,94956,30685574,1118483714,1149169288
2021-01-14,G,Others(HKUST),5,24,34184,973532,10577936,11551468
2021-01-14,G,RPG,105,864,397764,238329903,10701336267,10939666170
2021-01-14,G,Staff,126,925,354587,276137703,2474178288,2750315991
2021-01-14,G,TPG,88,1127,538076,521205467,24752688155,25273893622
2021-01-14,G,Total,514,4592,1988247,1926850717,58593191197,60520041914
2021-01-14,G,UG,125,1157,468466,759439021,18117001429,18876440450
2021-01-14,LG1,Alumni,3,40,33990,33717135,3754681168,3788398303
2021-01-14,LG1,Non-HKUST,48,246,322045,267410604,17252835275,17520245879
2021-01-14,LG1,Others(HKUST),5,39,131066,10785810,641042081,651827891
2021-01-14,LG1,RPG,57,433,529524,427196600,14185247265,14612443865
2021-01-14,LG1,Staff,54,540,265597,179179095,16642080062,16821259157
2021-01-14,LG1,TPG,55,842,1000554,1055835656,31584957185,32640792841
2021-01-14,LG1,Total,307,2941,3182012,3143816951,119668277907,122812094858
2021-01-14,LG1,UG,85,801,899236,1169692051,35607434871,36777126922
2021-01-14,LG3,Alumni,9,66,135887,244168796,8294541686,8538710482
2021-01-14,LG3,Non-HKUST,56,224,168103,71873160,6119723032,6191596192
2021-01-14,LG3,Others(HKUST),13,92,39440,9135005,103699508,112834513
2021-01-14,LG3,RPG,244,487,255655,217059802,10390688691,10607748493
2021-01-14,LG3,Staff,231,885,157541,52544286,883507751,936052037
2021-01-14,LG3,TPG,76,482,523768,1167822660,24380331701,25548154361
2021-01-14,LG3,Total,798,2999,1779824,2100582480,62926911012,65027493492
2021-01-14,LG3,UG,169,763,499430,337978771,12754418643,13092397414
2021-01-14,LG4,Alumni,10,28,35463,25340406,4260596353,4285936759
2021-01-14,LG4,Non-HKUST,36,210,126997,82298849,1730149847,1812448696
2021-01-14,LG4,Others(HKUST),15,56,159393,20552170,222924506,243476676
2021-01-14,LG4,RPG,250,482,251709,140534296,6448397425,6588931721
2021-01-14,LG4,Staff,199,696,255284,81203074,2587052057,2668255131
2021-01-14,LG4,TPG,63,267,201597,122170977,9147263175,9269434152
2021-01-14,LG4,Total,765,2147,1307058,2115294790,27859687700,29974982490
2021-01-14,LG4,UG,192,408,276615,1643195018,3463304337,5106499355
2021-01-15,1,Alumni,5,21,23544,32351574,1515844389,1548195963
2021-01-15,1,Non-HKUST,13,99,106962,93618291,5944063822,6037682113
2021-01-15,1,Others(HKUST),6,56,52551,5353422,126441737,131795159
2021-01-15,1,RPG,9,47,100760,77744016,2528109093,2605853109
2021-01-15,1,Staff,51,825,780712,389460368,11226920215,11616380583
2021-01-15,1,TPG,27,345,516009,460225942,18351622820,18811848762
2021-01-15,1,Total,126,1532,1834854,1395876174,51009820273,52405696447
2021-01-15,1,UG,15,139,254316,337122561,11316818197,11653940758
2021-01-15,All-Floors,Alumni,21,487,458352,469938605,27849365649,28319304254
2021-01-15,All-Floors,Non-HKUST,102,1172,868893,752347569,37324879519,38077227088
2021-01-15,All-Floors,Others(HKUST),22,431,423748,227330344,3710315741,3937646085
2021-01-15,All-Floors,RPG,374,1733,1030123,865600377,36881472699,37747073076
2021-01-15,All-Floors,Staff,392,3763,1874715,982246198,31696390559,32678636757
2021-01-15,All-Floors,TPG,107,2806,2786254,2939677773,98835950055,101775627828
2021-01-15,All-Floors,Total,1309,12988,9635498,9759779302,339176911718,348936691020
2021-01-15,All-Floors,UG,291,2596,2193413,3522638436,102878537496,106401175932
2021-01-15,G,Alumni,16,244,127000,212085426,3438926971,3651012397
2021-01-15,G,Non-HKUST,59,319,187831,88491277,1871595352,1960086629
2021-01-15,G,Others(HKUST),10,62,20492,6008442,789751147,795759589
2021-01-15,G,RPG,73,559,216312,158165604,3289772066,3447937670
2021-01-15,G,Staff,122,1036,309466,91946057,5133486488,5225432545
2021-01-15,G,TPG,90,1113,464035,479065686,12413905900,12892971586
2021-01-15,G,Total,481,4329,1869210,1662684408,50743695208,52406379616
2021-01-15,G,UG,111,996,544074,626921916,23806257284,24433179200
2021-01-15,LG1,Alumni,6,110,144875,104808409,14641312220,14746120629
2021-01-15,LG1,Non-HKUST,39,219,284390,201475582,18205608467,18407084049
2021-01-15,LG1,Others(HKUST),7,59,139702,8279733,30822892,39102625
2021-01-15,LG1,RPG,31,370,418719,460182697,11937141222,12397323919
2021-01-15,LG1,Staff,59,506,313078,162461937,3497874551,3660336488
2021-01-15,LG1,TPG,50,812,1090986,1253076117,45475809487,46728885604
2021-01-15,LG1,Total,259,2653,2983651,3969925030,126312583425,130282508455
2021-01-15,LG1,UG,67,577,591901,1779640555,32524014586,34303655141
2021-01-15,LG3,Alumni,10,74,137056,105579525,7201157109,7306736634
2021-01-15,LG3,Non-HKUST,39,303,112348,104371688,5823959990,5928331678
2021-01-15,LG3,Others(HKUST),13,156,32274,8652300,169363938,178016238
2021-01-15,LG3,RPG,235,381,136062,122712357,17141848447,17264560804
2021-01-15,LG3,Staff,264,821,144815,85726249,3419598479,3505324728
2021-01-15,LG3,TPG,60,371,522878,653502170,16431524517,17085026687
2021-01-15,LG3,Total,792,2591,1544902,1714841551,77738392740,79453234291
2021-01-15,LG3,UG,171,485,459469,634297262,27550940260,28185237522
2021-01-15,LG4,Alumni,12,38,25877,15113671,1052124960,1067238631
2021-01-15,LG4,Non-HKUST,40,232,177362,264390731,5479651888,5744042619
2021-01-15,LG4,Others(HKUST),17,98,178729,199036447,2593936027,2792972474
2021-01-15,LG4,RPG,238,376,158270,46795703,1984601871,2031397574
2021-01-15,LG4,Staff,216,575,326644,252651587,8418510826,8671162413
2021-01-15,LG4,TPG,46,165,192346,93807858,6163087331,6256895189
2021-01-15,LG4,Total,753,1883,1402881,1016452139,33372420072,34388872211
2021-01-15,LG4,UG,184,399,343653,144656142,7680507169,7825163311
2021-01-16,1,Alumni,0,0,0,0,0,0
2021-01-16,1,Non-HKUST,4,15,21849,27529977,565358299,592888276
2021-01-16,1,Others(HKUST),1,1,23697,404187,1454464,1858651
2021-01-16,1,RPG,4,21,33929,15916127,1691606605,1707522732
2021-01-16,1,Staff,7,61,47904,19344967,232751271,252096238
2021-01-16,1,TPG,8,99,192013,171216637,8587191897,8758408534
2021-01-16,1,Total,30,254,447497,424704132,15326410369,15751114501
2021-01-16,1,UG,6,57,128105,190292237,4248047833,4438340070
2021-01-16,All-Floors,Alumni,11,295,136122,70289444,5665354320,5735643764
2021-01-16,All-Floors,Non-HKUST,50,274,267103,226993769,5685234928,5912228697
2021-01-16,All-Floors,Others(HKUST),10,67,254556,15579517,328453241,344032758
2021-01-16,All-Floors,RPG,237,700,373652,266925421,8963707123,9230632544
2021-01-16,All-Floors,Staff,123,519,265679,63791056,1711435110,1775226166
2021-01-16,All-Floors,TPG,56,732,615011,1003592503,32044753932,33048346435
2021-01-16,All-Floors,Total,712,3855,2888180,2242820301,80466668205,82709488506
2021-01-16,All-Floors,UG,225,1268,976057,595648591,26067729551,26663378142
2021-01-16,G,Alumni,10,75,15220,6120241,809074344,815194585
2021-01-16,G,Non-HKUST,19,117,100283,55271820,954958012,1010229832
2021-01-16,G,Others(HKUST),1,1,19690,290724,2656744,2947468
2021-01-16,G,RPG,24,170,100801,130897232,1270731567,1401628799
2021-01-16,G,Staff,33,141,42765,7129654,143149727,150279381
2021-01-16,G,TPG,31,282,110578,80832170,5927719686,6008551856
2021-01-16,G,Total,164,1103,579061,390259212,13554827797,13945087009
2021-01-16,G,UG,46,317,189724,109717371,4446537717,4556255088
2021-01-16,LG1,Alumni,3,46,5610,1323388,20908364,22231752
2021-01-16,LG1,Non-HKUST,15,63,84697,120132694,3108658566,3228791260
2021-01-16,LG1,Others(HKUST),3,4,92776,10193669,191009052,201202721
2021-01-16,LG1,RPG,18,88,74272,98298363,4365006900,4463305263
2021-01-16,LG1,Staff,14,48,38994,10173458,478094249,488267707
2021-01-16,LG1,TPG,16,173,197749,659768851,10453567407,11113336258
2021-01-16,LG1,Total,106,643,720356,1037342918,27878150654,28915493572
2021-01-16,LG1,UG,37,221,226258,137452495,9260906116,9398358611
2021-01-16,LG3,Alumni,9,145,73832,49038645,3391803107,3440841752
2021-01-16,LG3,Non-HKUST,18,24,33074,19178093,852008314,871186407
2021-01-16,LG3,Others(HKUST),7,29,8721,74825,304360,379185
2021-01-16,LG3,RPG,146,212,51921,13015483,1389917503,1402932986
2021-01-16,LG3,Staff,81,191,102544,13378878,87428756,100807634
2021-01-16,LG3,TPG,29,134,94181,85728737,7013368531,7099097268
2021-01-16,LG3,Total,431,1149,575280,314224203,20033396121,20347620324
2021-01-16,LG3,UG,141,414,211007,133809542,7298565550,7432375092
2021-01-16,LG4,Alumni,5,29,41460,13807170,1443568505,1457375675
2021-01-16,LG4,Non-HKUST,18,55,27200,4881185,204251737,209132922
2021-01-16,LG4,Others(HKUST),7,32,109672,4616112,133028621,137644733
2021-01-16,LG4,RPG,161,209,112729,8798216,246444548,255242764
2021-01-16,LG4,Staff,57,78,33472,13764099,770011107,783775206
2021-01-16,LG4,TPG,24,44,20490,6046108,62906411,68952519
2021-01-16,LG4,Total,414,706,565986,76289836,3673883264,3750173100
2021-01-16,LG4,UG,142,259,220963,24376946,813672335,838049281
2021-01-17,1,Alumni,3,35,43926,41827888,4375646610,4417474498
2021-01-17,1,Non-HKUST,6,53,39415,28552231,570455718,599007949
2021-01-17,1,Others(HKUST),1,1,23412,537475,2152681,2690156
2021-01-17,1,RPG,9,69,104768,44757401,3399658748,3444416149
2021-01-17,1,Staff,5,84,31184,3005044,103133146,106138190
2021-01-17,1,TPG,9,75,187044,248892882,24583287682,24832180564
2021-01-17,1,Total,39,345,477699,382216983,33392533562,33774750545
2021-01-17,1,UG,6,28,47950,14644062,358198977,372843039
2021-01-17,All-Floors,Alumni,15,237,190775,135100098,9397283970,9532384068
2021-01-17,All-Floors,Non-HKUST,37,262,185748,132266617,4072231946,4204498563
2021-01-17,All-Floors,Others(HKUST),6,38,238804,17751759,101551722,119303481
2021-01-17,All-Floors,RPG,214,739,412476,629114425,15852538922,16481653347
2021-01-17,All-Floors,Staff,103,706,303050,66171746,2585443261,2651615007
2021-01-17,All-Floors,TPG,45,626,634376,681152767,45049765945,45730918712
2021-01-17,All-Floors,Total,613,3781,2787667,2923102328,188868663318,191791765646
2021-01-17,All-Floors,UG,193,1173,822438,1261544916,111809847552,113071392468
2021-01-17,G,Alumni,10,81,5266,3699095,97104384,100803479
2021-01-17,G,Non-HKUST,18,100,15768,3547981,196406214,199954195
2021-01-17,G,Others(HKUST),1,1,20934,580029,8034950,8614979
2021-01-17,G,RPG,24,164,79013,39709190,3989186813,4028896003
2021-01-17,G,Staff,28,159,39190,2531121,30160833,32691954
2021-01-17,G,TPG,32,239,87180,81785411,5324282154,5406067565
2021-01-17,G,Total,163,1121,394757,297412184,14540157177,14837569361
2021-01-17,G,UG,50,377,147406,165559357,4894981829,5060541186
2021-01-17,LG1,Alumni,6,50,53341,49069656,1405265644,1454335300
2021-01-17,LG1,Non-HKUST,13,32,53423,54309403,1436904901,1491214304
2021-01-17,LG1,Others(HKUST),2,5,92977,5863766,24295401,30159167
2021-01-17,LG1,RPG,17,91,39693,37748071,2927404103,2965152174
2021-01-17,LG1,Staff,20,150,84801,33193042,1424720827,1457913869
2021-01-17,LG1,TPG,18,195,200834,176409200,5100250009,5276659209
2021-01-17,LG1,Total,110,728,742229,1201690430,97120666807,98322357237
2021-01-17,LG1,UG,34,205,217160,845097292,84801825922,85646923214
2021-01-17,LG3,Alumni,9,44,39258,13533328,1130281787,1143815115
2021-01-17,LG3,Non-HKUST,13,37,42390,34478904,1004113618,1038592522
2021-01-17,LG3,Others(HKUST),4,11,250,1902,5011,6913
2021-01-17,LG3,RPG,127,201,89194,457074928,3078844645,3535919573
2021-01-17,LG3,Staff,68,198,50526,11629268,21688063,33317331
2021-01-17,LG3,TPG,23,61,76130,124322245,4214473797,4338796042
2021-01-17,LG3,Total,357,862,500749,817297012,28346905201,29164202213
2021-01-17,LG3,UG,113,310,203001,176256437,18897498280,19073754717
2021-01-17,LG4,Alumni,6,27,48984,26970131,2388985545,2415955676
2021-01-17,LG4,Non-HKUST,13,40,34752,11378098,864351495,875729593
2021-01-17,LG4,Others(HKUST),4,20,101231,10768587,67063679,77832266
2021-01-17,LG4,RPG,151,214,99808,49824835,2457444613,2507269448
2021-01-17,LG4,Staff,48,115,97349,15813271,1005740392,1021553663
2021-01-17,LG4,TPG,21,56,83188,49743029,5827472303,5877215332
2021-01-17,LG4,Total,375,725,672233,224485719,15468400571,15692886290
2021-01-17,LG4,UG,132,253,206921,59987768,2857342544,2917330312
2021-01-18,1,Alumni,1,23,34975,29556284,1584057545,1613613829
2021-01-18,1,Non-HKUST,18,81,166898,103311866,3295807023,3399118889
2021-01-18,1,Others(HKUST),3,7,25847,629812,2743122,3372934
2021-01-18,1,RPG,14,70,110513,84527604,2344558885,2429086489
2021-01-18,1,Staff,42,932,783530,163290217,3105057636,3268347853
2021-01-18,1,TPG,25,450,689750,990198654,20759110612,21749309266
2021-01-18,1,Total,117,1687,2013191,1543988988,39598416290,41142405278
2021-01-18,1,UG,14,124,201678,172474551,8507081467,8679556018
2021-01-18,All-Floors,Alumni,16,376,396473,8801091755,21488954799,30290046554
2021-01-18,All-Floors,Non-HKUST,121,891,931997,896931508,29469357709,30366289217
2021-01-18,All-Floors,Others(HKUST),15,135,370541,27738918,943035700,970774618
2021-01-18,All-Floors,RPG,352,1864,1400059,2176006384,81379499171,83555505555
2021-01-18,All-Floors,Staff,347,3956,1690562,585316606,14713593557,15298910163
2021-01-18,All-Floors,TPG,117,2694,2507107,2406166015,95870931239,98277097254
2021-01-18,All-Floors,Total,1287,13419,10009598,17904290205,527617974147,545522264352
2021-01-18,All-Floors,UG,319,3503,2712859,3011039019,283752601972,286763640991
2021-01-18,G,Alumni,10,134,61665,103611737,1798262826,1901874563
2021-01-18,G,Non-HKUST,57,268,255849,360582481,6260715640,6621298121
2021-01-18,G,Others(HKUST),6,19,94819,10760109,90458137,101218246
2021-01-18,G,RPG,73,624,301116,1220319182,54990937843,56211257025
2021-01-18,G,Staff,115,953,339768,250538133,5211717951,5462256084
2021-01-18,G,TPG,95,1077,607733,491189785,18587263560,19078453345
2021-01-18,G,Total,493,4535,2299739,3163676386,114744860175,117908536561
2021-01-18,G,UG,137,1460,638789,726674959,27805504218,28532179177
2021-01-18,LG1,Alumni,6,114,123720,8493588079,7796611380,16290199459
2021-01-18,LG1,Non-HKUST,36,186,282318,226259974,11974622016,12200881990
2021-01-18,LG1,Others(HKUST),4,14,122525,3849246,41947419,45796665
2021-01-18,LG1,RPG,40,376,487317,507884835,14879581858,15387466693
2021-01-18,LG1,Staff,60,483,222879,88027592,3895872144,3983899736
2021-01-18,LG1,TPG,53,702,777945,598218203,26840775843,27438994046
2021-01-18,LG1,Total,281,2722,3049294,11487376398,271888988589,283376364987
2021-01-18,LG1,UG,82,847,1032590,1569548469,206459577929,208029126398
2021-01-18,LG3,Alumni,8,67,163325,165708427,9777888204,9943596631
2021-01-18,LG3,Non-HKUST,46,198,112743,50960746,2937770985,2988731731
2021-01-18,LG3,Others(HKUST),11,41,10335,6573881,610924227,617498108
2021-01-18,LG3,RPG,238,444,324694,178258360,7179833802,7358092162
2021-01-18,LG3,Staff,225,847,155100,32000456,1042656016,1074656472
2021-01-18,LG3,TPG,44,357,333072,282943528,27123884083,27406827611
2021-01-18,LG3,Total,737,2531,1491975,1052312987,83876572611,84928885598
2021-01-18,LG3,UG,165,577,392706,335867589,35203615294,35539482883
2021-01-18,LG4,Alumni,7,38,12788,8627228,532134844,540762072
2021-01-18,LG4,Non-HKUST,49,158,114189,155816441,5000442045,5156258486
2021-01-18,LG4,Others(HKUST),11,54,117015,5925870,196962795,202888665
2021-01-18,LG4,RPG,227,350,176419,185016403,1984586783,2169603186
2021-01-18,LG4,Staff,205,741,189285,51460208,1458289810,1509750018
2021-01-18,LG4,TPG,36,108,98607,43615845,2559897141,2603512986
2021-01-18,LG4,Total,724,1944,1155399,656935446,17509136482,18166071928
2021-01-18,LG4,UG,189,495,447096,206473451,5776823064,5983296515
2021-01-19,1,Alumni,2,2,5,0,0,0
2021-01-19,1,Non-HKUST,24,184,281354,282148316,5776237288,6058385604
2021-01-19,1,Others(HKUST),2,12,40933,3687904,220431516,224119420
2021-01-19,1,RPG,12,72,121647,153275326,4748140181,4901415507
2021-01-19,1,Staff,45,953,958773,188729598,21448822360,21637551958
2021-01-19,1,TPG,36,534,1108194,1235856561,34166889688,35402746249
2021-01-19,1,Total,134,2124,2747822,2089731950,75665819817,77755551767
2021-01-19,1,UG,13,367,236916,226034245,9305298784,9531333029
2021-01-19,All-Floors,Alumni,18,346,356649,638181602,15252628607,15890810209
2021-01-19,All-Floors,Non-HKUST,104,889,787415,686352573,24608441364,25294793937
2021-01-19,All-Floors,Others(HKUST),18,148,563616,182673111,1211312002,1393985113
2021-01-19,All-Floors,RPG,388,2193,1708869,2762166491,61370428289,64132594780
2021-01-19,All-Floors,Staff,371,4150,1944696,688543285,44306675574,44995218859
2021-01-19,All-Floors,TPG,139,3395,3396456,3720156196,132888164752,136608320948
2021-01-19,All-Floors,Total,1369,14977,11588175,11997297634,403403199979,415400497613
2021-01-19,All-Floors,UG,331,3856,2830474,3319224376,123765549391,127084773767
2021-01-19,G,Alumni,9,220,117141,313997908,2717824150,3031822058
2021-01-19,G,Non-HKUST,57,217,100816,68222928,1889499617,1957722545
2021-01-19,G,Others(HKUST),5,17,9494,1439563,43775521,45215084
2021-01-19,G,RPG,93,921,737492,1856352484,20590340565,22446693049
2021-01-19,G,Staff,114,1055,240892,66111025,2619357275,2685468300
2021-01-19,G,TPG,115,1373,560610,427522523,19665182205,20092704728
2021-01-19,G,Total,531,5107,2201459,3151371467,59212185810,62363557277
2021-01-19,G,UG,138,1304,435014,417725036,11686206477,12103931513
2021-01-19,LG1,Alumni,5,45,93572,213524398,6116311690,6329836088
2021-01-19,LG1,Non-HKUST,31,189,200651,197700326,7618486100,7816186426
2021-01-19,LG1,Others(HKUST),7,37,362648,169307702,891340594,1060648296
2021-01-19,LG1,RPG,49,437,500085,585832151,9059948095,9645780246
2021-01-19,LG1,Staff,69,626,446664,339569034,18152391248,18491960282
2021-01-19,LG1,TPG,66,834,1157363,954153938,63300204524,64254358462
2021-01-19,LG1,Total,327,3430,4168865,4721917590,182495872778,187217790368
2021-01-19,LG1,UG,100,1262,1407882,2261830041,77357190527,79619020568
2021-01-19,LG3,Alumni,9,62,133725,100040187,6036801221,6136841408
2021-01-19,LG3,Non-HKUST,42,175,138004,98566779,6225543569,6324110348
2021-01-19,LG3,Others(HKUST),9,37,11191,1955287,3137362,5092649
2021-01-19,LG3,RPG,235,434,232230,151778213,26360578110,26512356323
2021-01-19,LG3,Staff,256,993,156056,29418558,1054496793,1083915351
2021-01-19,LG3,TPG,60,571,532132,1074238723,12966256132,14040494855
2021-01-19,LG3,Total,795,2820,1639928,1818988187,71260718218,73079706405
2021-01-19,LG3,UG,184,548,436590,362990440,18613905031,18976895471
2021-01-19,LG4,Alumni,8,17,12206,10619109,381691546,392310655
2021-01-19,LG4,Non-HKUST,37,124,66590,39714224,3098674790,3138389014
2021-01-19,LG4,Others(HKUST),11,45,139350,6282655,52627009,58909664
2021-01-19,LG4,RPG,237,329,117415,14928317,611421338,626349655
2021-01-19,LG4,Staff,203,523,142311,64715070,1031607898,1096322968
2021-01-19,LG4,TPG,44,83,38157,28384451,2789632203,2818016654
2021-01-19,LG4,Total,738,1496,830101,215288440,14768603356,14983891796
2021-01-19,LG4,UG,198,375,314072,50644614,6802948572,6853593186
2021-01-20,1,Alumni,0,0,0,0,0,0
2021-01-20,1,Non-HKUST,25,161,298171,228219904,9210670560,9438890464
2021-01-20,1,Others(HKUST),5,28,63292,13193403,1065666988,1078860391
2021-01-20,1,RPG,12,208,292946,249468046,10363019647,10612487693
2021-01-20,1,Staff,51,977,900644,299079941,14746655277,15045735218
2021-01-20,1,TPG,27,347,728034,431372116,17512845575,17944217691
2021-01-20,1,Total,131,2080,2449381,1319647529,57533733968,58853381497
2021-01-20,1,UG,11,359,166294,98314119,4634875921,4733190040
2021-01-20,All-Floors,Alumni,11,202,169977,161608638,6357143254,6518751892
2021-01-20,All-Floors,Non-HKUST,102,1353,1000648,678058021,37648431430,38326489451
2021-01-20,All-Floors,Others(HKUST),18,238,425838,36167046,1894985740,1931152786
2021-01-20,All-Floors,RPG,382,2250,1656287,1979270230,54766277165,56745547395
2021-01-20,All-Floors,Staff,350,3912,1910382,1004018884,39032311907,40036330791
2021-01-20,All-Floors,TPG,119,2703,2587561,3734233461,82078802821,85813036282
2021-01-20,All-Floors,Total,1286,14112,10195005,9856061513,326395215625,336251277138
2021-01-20,All-Floors,UG,304,3454,2444312,2262705233,104617263308,106879968541
2021-01-20,G,Alumni,6,66,7063,9722072,903447345,913169417
2021-01-20,G,Non-HKUST,57,394,222191,134229155,5708740431,5842969586
2021-01-20,G,Others(HKUST),7,45,28716,854535,6222424,7076959
2021-01-20,G,RPG,80,735,385561,1023517256,9604971370,10628488626
2021-01-20,G,Staff,112,1032,342416,339114819,8923736057,9262850876
2021-01-20,G,TPG,91,1047,430368,300136990,12195340396,12495477386
2021-01-20,G,Total,472,4522,2048074,2349863251,57800691897,60150555148
2021-01-20,G,UG,119,1203,631759,542288424,20458233874,21000522298
2021-01-20,LG1,Alumni,2,13,14529,6007701,149172255,155179956
2021-01-20,LG1,Non-HKUST,37,352,329108,256327003,18404437868,18660764871
2021-01-20,LG1,Others(HKUST),7,63,151371,7816167,263206708,271022875
2021-01-20,LG1,RPG,45,444,563837,546376302,29183711319,29730087621
2021-01-20,LG1,Staff,57,427,321189,308972517,13566358773,13875331290
2021-01-20,LG1,TPG,54,890,1146419,1653329683,47440951874,49094281557
2021-01-20,LG1,Total,285,3181,3558328,3958040426,175609255790,179567296216
2021-01-20,LG1,UG,83,992,1031875,1179211053,66601416993,67780628046
2021-01-20,LG3,Alumni,9,92,132854,132288525,4654876229,4787164754
2021-01-20,LG3,Non-HKUST,37,176,79082,44187626,1837409064,1881596690
2021-01-20,LG3,Others(HKUST),7,48,6072,122402,885885,1008287
2021-01-20,LG3,RPG,237,485,253570,126219315,4000105004,4126324319
2021-01-20,LG3,Staff,235,927,194563,36802678,970391196,1007193874
2021-01-20,LG3,TPG,56,347,249206,1333592513,4665781444,5999373957
2021-01-20,LG3,Total,760,2595,1207094,1995674516,24886313914,26881988430
2021-01-20,LG3,UG,179,520,291747,322461457,8756865092,9079326549
2021-01-20,LG4,Alumni,5,31,15531,13590340,649647425,663237765
2021-01-20,LG4,Non-HKUST,31,270,72096,15094333,2487173507,2502267840
2021-01-20,LG4,Others(HKUST),12,54,176387,14180539,559003735,573184274
2021-01-20,LG4,RPG,248,378,160373,33689311,1614469825,1648159136
2021-01-20,LG4,Staff,196,549,151570,20048929,825170604,845219533
2021-01-20,LG4,TPG,39,72,33534,15802159,263883532,279685691
2021-01-20,LG4,Total,707,1734,932128,232835791,10565220056,10798055847
2021-01-20,LG4,UG,176,380,322637,120430180,4165871428,4286301608
2021-01-21,1,Alumni,2,20,22309,50878107,1053235450,1104113557
2021-01-21,1,Non-HKUST,19,138,207662,200681752,7641070531,7841752283
2021-01-21,1,Others(HKUST),3,38,46158,2567198,50864469,53431667
2021-01-21,1,RPG,18,157,250737,245889238,5492998863,5738888101
2021-01-21,1,Staff,58,1039,1011427,293478791,6059897208,6353375999
2021-01-21,1,TPG,27,370,717794,2236554500,95152995433,97389549933
2021-01-21,1,Total,144,2065,2501723,3179645066,121619194112,124798839178
2021-01-21,1,UG,17,303,245636,149595480,6168132158,6317727638
2021-01-21,All-Floors,Alumni,16,354,310628,446973843,13592664949,14039638792
2021-01-21,All-Floors,Non-HKUST,106,1137,862215,842072102,32243094549,33085166651
2021-01-21,All-Floors,Others(HKUST),19,148,392479,20744155,348198603,368942758
2021-01-21,All-Floors,RPG,434,2545,1781963,1978746434,37761830945,39740577379
2021-01-21,All-Floors,Staff,345,4123,2370837,1105713056,39740014930,40845727986
2021-01-21,All-Floors,TPG,112,2264,2512557,5654492494,168601173229,174255665723
2021-01-21,All-Floors,Total,1379,14839,11502730,17874412455,468363486310,486237898765
2021-01-21,All-Floors,UG,347,4268,3272051,7825670371,176076509105,183902179476
2021-01-21,G,Alumni,12,240,135039,280932076,6459524882,6740456958
2021-01-21,G,Non-HKUST,53,310,123508,62125914,1183249273,1245375187
2021-01-21,G,Others(HKUST),3,18,38744,966827,21838014,22804841
2021-01-21,G,RPG,97,919,592000,327227820,8356308043,8683535863
2021-01-21,G,Staff,114,1067,534308,524968106,20170471262,20695439368
2021-01-21,G,TPG,85,993,531659,1821169408,29991983457,31813152865
2021-01-21,G,Total,506,4899,2395479,3414634766,79891742288,83306377054
2021-01-21,G,UG,142,1352,440221,397244615,13708367357,14105611972
2021-01-21,LG1,Alumni,5,24,65668,41292222,1212388893,1253681115
2021-01-21,LG1,Non-HKUST,45,213,315705,416110459,10954707310,11370817769
2021-01-21,LG1,Others(HKUST),6,13,130231,6279852,66773462,73053314
2021-01-21,LG1,RPG,54,370,426995,1039756925,15110480528,16150237453
2021-01-21,LG1,Staff,68,588,355427,143520505,8882555614,9026076119
2021-01-21,LG1,TPG,50,569,802041,1251700120,29914167886,31165868006
2021-01-21,LG1,Total,338,3078,3626840,9067122853,188869071285,197936194138
2021-01-21,LG1,UG,110,1301,1530773,6168462770,122727997592,128896460362
2021-01-21,LG3,Alumni,5,29,53003,50538012,3541684528,3592222540
2021-01-21,LG3,Non-HKUST,47,300,116704,108413235,9612257130,9720670365
2021-01-21,LG3,Others(HKUST),11,27,3274,1522906,2579838,4102744
2021-01-21,LG3,RPG,272,657,331405,328727002,7582239222,7910966224
2021-01-21,LG3,Staff,230,878,219693,24095285,905218590,929313875
2021-01-21,LG3,TPG,44,258,423642,302807989,11152952614,11455760603
2021-01-21,LG3,Total,823,2873,1794138,1346113190,58091718088,59437831278
2021-01-21,LG3,UG,214,724,646417,530008761,25294786166,25824794927
2021-01-21,LG4,Alumni,8,41,34609,23333426,1325831196,1349164622
2021-01-21,LG4,Non-HKUST,38,176,98636,54740742,2851810305,2906551047
2021-01-21,LG4,Others(HKUST),12,52,174072,9407372,206142820,215550192
2021-01-21,LG4,RPG,285,442,180826,37145449,1219804289,1256949738
2021-01-21,LG4,Staff,182,551,249982,119650369,3721872256,3841522625
2021-01-21,LG4,TPG,35,74,37421,42260477,2389073839,2431334316
2021-01-21,LG4,Total,788,1924,1184550,866896580,19891760537,20758657117
2021-01-21,LG4,UG,228,588,409004,580358745,8177225832,8757584577
2021-01-22,1,Alumni,2,24,27337,36302370,390378970,426681340
2021-01-22,1,Non-HKUST,29,204,378530,318761394,17635660899,17954422293
2021-01-22,1,Others(HKUST),2,7,45828,35177653,703672932,738850585
2021-01-22,1,RPG,18,270,168590,218198064,8597232962,8815431026
2021-01-22,1,Staff,49,1001,1119819,295092048,7947495314,8242587362
2021-01-22,1,TPG,34,428,859701,940851468,37205793143,38146644611
2021-01-22,1,Total,147,2128,2777459,1983069275,80870358511,82853427786
2021-01-22,1,UG,13,194,177654,138686278,8390124291,8528810569
2021-01-22,All-Floors,Alumni,21,435,427319,829952062,20121587513,20951539575
2021-01-22,All-Floors,Non-HKUST,126,1053,956910,1362033747,36671530064,38033563811
2021-01-22,All-Floors,Others(HKUST),19,243,324793,131035475,3259900085,3390935560
2021-01-22,All-Floors,RPG,390,2058,1332244,1421380072,37571229968,38992610040
2021-01-22,All-Floors,Staff,377,3979,2472682,859914587,34541656422,35401571009
2021-01-22,All-Floors,TPG,108,2730,2600307,4442052663,81566294249,86008346912
2021-01-22,All-Floors,Total,1333,13853,10527442,12305126373,480181763991,492486890364
2021-01-22,All-Floors,UG,292,3355,2413187,3258757767,266449565690,269708323457
2021-01-22,G,Alumni,13,214,144456,214620700,3625771438,3840392138
2021-01-22,G,Non-HKUST,63,376,164942,602976298,5008199187,5611175485
2021-01-22,G,Others(HKUST),3,24,3962,197828,1910576,2108404
2021-01-22,G,RPG,77,581,362173,215826354,7964319052,8180145406
2021-01-22,G,Staff,112,1002,475462,114427677,4497252745,4611680422
2021-01-22,G,TPG,94,1141,567600,1200379295,12282143144,13482522439
2021-01-22,G,Total,474,4633,2210119,2925264111,46611821424,49537085535
2021-01-22,G,UG,112,1295,491524,576835959,13232225282,13809061241
2021-01-22,LG1,Alumni,9,118,140068,511286040,11907254216,12418540256
2021-01-22,LG1,Non-HKUST,38,229,230091,333771531,7981652655,8315424186
2021-01-22,LG1,Others(HKUST),6,23,128708,6898849,106091323,112990172
2021-01-22,LG1,RPG,47,345,404508,794671497,10702604237,11497275734
2021-01-22,LG1,Staff,68,588,454835,301116465,16418998352,16720114817
2021-01-22,LG1,TPG,46,657,881994,2007929045,23541878297,25549807342
2021-01-22,LG1,Total,298,2849,3190605,5955836736,281483699885,287439536621
2021-01-22,LG1,UG,84,889,950401,2000163309,210825220805,212825384114
2021-01-22,LG3,Alumni,13,48,87683,49109553,3360883517,3409993070
2021-01-22,LG3,Non-HKUST,49,97,61034,25768607,1826225639,1851994246
2021-01-22,LG3,Others(HKUST),12,141,22099,10099716,56186687,66286403
2021-01-22,LG3,RPG,237,493,227155,150270860,6367549199,6517820059
2021-01-22,LG3,Staff,252,844,207464,66562621,2000110465,2066673086
2021-01-22,LG3,TPG,40,371,243222,271228686,6881314069,7152542755
2021-01-22,LG3,Total,784,2524,1272369,885972429,45195871930,46081844359
2021-01-22,LG3,UG,181,530,423712,312932386,24703602354,25016534740
2021-01-22,LG4,Alumni,12,31,27775,18633399,837299372,855932771
2021-01-22,LG4,Non-HKUST,42,147,122313,80755917,4219791684,4300547601
2021-01-22,LG4,Others(HKUST),12,48,124196,78661429,2392038567,2470699996
2021-01-22,LG4,RPG,249,369,169818,42413297,3939524518,3981937815
2021-01-22,LG4,Staff,215,544,215102,82715776,3677799546,3760515322
2021-01-22,LG4,TPG,37,133,47790,21664169,1655165596,1676829765
2021-01-22,LG4,Total,739,1719,1076890,554983822,26020012241,26574996063
2021-01-22,LG4,UG,172,447,369896,230139835,9298392958,9528532793
2021-01-23,1,Alumni,2,36,32089,20311647,2361868565,2382180212
2021-01-23,1,Non-HKUST,2,7,10231,5932434,270161576,276094010
2021-01-23,1,Others(HKUST),1,1,38470,554094,2382094,2936188
2021-01-23,1,RPG,7,20,19311,14030427,2404925769,2418956196
2021-01-23,1,Staff,7,38,39588,16639695,72524468,89164163
2021-01-23,1,TPG,12,100,149289,86831353,4169559041,4256390394
2021-01-23,1,Total,35,226,342240,172194977,10443437750,10615632727
2021-01-23,1,UG,4,24,53262,27895327,1162016237,1189911564
2021-01-23,All-Floors,Alumni,13,216,134429,112000952,7421185093,7533186045
2021-01-23,All-Floors,Non-HKUST,53,376,233263,148686981,8813489866,8962176847
2021-01-23,All-Floors,Others(HKUST),8,62,245293,14082749,81385239,95467988
2021-01-23,All-Floors,RPG,260,749,311555,164664267,6330437971,6495102238
2021-01-23,All-Floors,Staff,137,676,328013,172398930,6072038001,6244436931
2021-01-23,All-Floors,TPG,74,1104,839325,550320763,34857454092,35407774855
2021-01-23,All-Floors,Total,783,4552,3140858,2360667746,120597224384,122957892130
2021-01-23,All-Floors,UG,238,1369,1048980,1198513104,57021234122,58219747226
2021-01-23,G,Alumni,8,135,31836,56735488,2447546018,2504281506
2021-01-23,G,Non-HKUST,27,131,70874,22613216,1860311149,1882924365
2021-01-23,G,Others(HKUST),0,0,0,0,0,0
2021-01-23,G,RPG,30,212,153087,90978589,2906752356,2997730945
2021-01-23,G,Staff,39,196,71281,34642199,934642601,969284800
2021-01-23,G,TPG,47,512,261161,198540335,15767256263,15965796598
2021-01-23,G,Total,203,1510,774524,726957019,31447855013,32174812032
2021-01-23,G,UG,52,324,186285,323447192,7531346626,7854793818
2021-01-23,LG1,Alumni,5,24,43443,23282568,1296480756,1319763324
2021-01-23,LG1,Non-HKUST,16,114,74516,57424611,3251878099,3309302710
2021-01-23,LG1,Others(HKUST),1,2,98319,5797240,17806448,23603688
2021-01-23,LG1,RPG,12,23,12471,3565716,155160619,158726335
2021-01-23,LG1,Staff,17,75,72856,72770611,2454496888,2527267499
2021-01-23,LG1,TPG,22,279,232280,166157183,8736641272,8902798455
2021-01-23,LG1,Total,106,712,805585,661963591,57823586346,58485549937
2021-01-23,LG1,UG,33,195,271700,332965662,41911122264,42244087926
2021-01-23,LG3,Alumni,4,11,425,13650,29246,42896
2021-01-23,LG3,Non-HKUST,20,59,55210,57252757,2921497497,2978750254
2021-01-23,LG3,Others(HKUST),6,32,7802,357744,8090509,8448253
2021-01-23,LG3,RPG,162,243,44943,10092101,342151810,352243911
2021-01-23,LG3,Staff,87,209,88078,16670013,1017078781,1033748794
2021-01-23,LG3,TPG,32,148,134839,57376703,5706322363,5763699066
2021-01-23,LG3,Total,470,1077,525261,215326914,13262184035,13477510949
2021-01-23,LG3,UG,159,375,193964,73563946,3267013829,3340577775
2021-01-23,LG4,Alumni,5,10,26636,11657599,1315260508,1326918107
2021-01-23,LG4,Non-HKUST,17,65,22432,5463963,509641545,515105508
2021-01-23,LG4,Others(HKUST),5,27,100702,7373671,53106188,60479859
2021-01-23,LG4,RPG,172,251,81743,45997434,521447417,567444851
2021-01-23,LG4,Staff,80,158,56210,31676412,1593295263,1624971675
2021-01-23,LG4,TPG,33,65,61756,41415189,477675153,519090342
2021-01-23,LG4,Total,484,1027,693248,584225245,7620161240,8204386485
2021-01-23,LG4,UG,172,451,343769,440640977,3149735166,3590376143
2021-01-24,1,Alumni,0,0,0,0,0,0
2021-01-24,1,Non-HKUST,1,3,11333,9467310,289806,9757116
2021-01-24,1,Others(HKUST),1,1,38187,581240,2402644,2983884
2021-01-24,1,RPG,7,18,27749,14214807,697925973,712140780
2021-01-24,1,Staff,6,40,21554,7768355,742052135,749820490
2021-01-24,1,TPG,12,96,230069,117432249,5996036862,6113469111
2021-01-24,1,Total,32,184,368920,175219225,10769313845,10944533070
2021-01-24,1,UG,5,26,40028,25755264,3330606425,3356361689
2021-01-24,All-Floors,Alumni,14,117,88170,99831421,4373473507,4473304928
2021-01-24,All-Floors,Non-HKUST,52,268,203088,317002771,4359085547,4676088318
2021-01-24,All-Floors,Others(HKUST),6,23,234023,13082240,51096835,64179075
2021-01-24,All-Floors,RPG,235,964,484090,730013034,50713105712,51443118746
2021-01-24,All-Floors,Staff,136,829,277902,178597469,2898354334,3076951803
2021-01-24,All-Floors,TPG,59,644,789835,1328460564,27201762124,28530222688
2021-01-24,All-Floors,Total,738,4252,3179159,3685075113,140997133394,144682208507
2021-01-24,All-Floors,UG,236,1407,1102051,1018087614,51400255335,52418342949
2021-01-24,G,Alumni,7,53,35024,36516884,2260665217,2297182101
2021-01-24,G,Non-HKUST,21,115,93460,211381504,2105397843,2316779347
2021-01-24,G,Others(HKUST),0,0,0,0,0,0
2021-01-24,G,RPG,30,232,113666,181988057,37727542858,37909530915
2021-01-24,G,Staff,42,228,121409,78519456,1072998916,1151518372
2021-01-24,G,TPG,34,270,220907,431262086,4119029402,4550291488
2021-01-24,G,Total,182,1313,768379,1115015351,55263973715,56378989066
2021-01-24,G,UG,48,415,183913,175347364,7978339479,8153686843
2021-01-24,LG1,Alumni,4,23,27889,51805656,1031990441,1083796097
2021-01-24,LG1,Non-HKUST,12,45,56390,78753259,1240736905,1319490164
2021-01-24,LG1,Others(HKUST),1,2,98309,5810590,22940447,28751037
2021-01-24,LG1,RPG,24,192,131719,429212886,8942577014,9371789900
2021-01-24,LG1,Staff,15,72,16362,21586894,185559836,207146730
2021-01-24,LG1,TPG,19,192,281123,694558854,16125803173,16820362027
2021-01-24,LG1,Total,113,785,1087345,1990786954,63171553686,65162340640
2021-01-24,LG1,UG,38,259,475553,709058815,35621945870,36331004685
2021-01-24,LG3,Alumni,10,26,4587,1292620,50698750,51991370
2021-01-24,LG3,Non-HKUST,22,84,31478,13239883,807795374,821035257
2021-01-24,LG3,Others(HKUST),2,6,2414,23436,86115,109551
2021-01-24,LG3,RPG,160,256,49316,16518199,745276885,761795084
2021-01-24,LG3,Staff,88,285,53609,45165237,64118598,109283835
2021-01-24,LG3,TPG,21,39,15443,26635530,526160746,552796276
2021-01-24,LG3,Total,436,1079,316997,177188419,5024714250,5201902669
2021-01-24,LG3,UG,133,383,160150,74313514,2830577782,2904891296
2021-01-24,LG4,Alumni,8,15,20670,10216261,1030119099,1040335360
2021-01-24,LG4,Non-HKUST,19,21,10427,4160815,204865619,209026434
2021-01-24,LG4,Others(HKUST),5,14,95113,6666974,25667629,32334603
2021-01-24,LG4,RPG,157,266,161640,88079085,2599782982,2687862067
2021-01-24,LG4,Staff,72,204,64968,25557527,833624849,859182376
2021-01-24,LG4,TPG,28,47,42293,58571845,434731941,493303786
2021-01-24,LG4,Total,445,891,637518,226865164,6767577898,6994443062
2021-01-24,LG4,UG,156,324,242407,33612657,1638785779,1672398436
2021-01-25,1,Alumni,1,1,10,0,0,0
2021-01-25,1,Non-HKUST,20,124,194874,127818921,4512482500,4640301421
2021-01-25,1,Others(HKUST),3,31,104568,3100585,88607049,91707634
2021-01-25,1,RPG,9,62,104990,88414031,5158043575,5246457606
2021-01-25,1,Staff,55,960,951894,218723543,5239471801,5458195344
2021-01-25,1,TPG,30,352,690641,763138434,22898741026,23661879460
2021-01-25,1,Total,137,1757,2297561,1496693234,52980439292,54477132526
2021-01-25,1,UG,19,227,250584,295497720,15083093341,15378591061
2021-01-25,All-Floors,Alumni,14,393,331179,3684711582,19490988913,23175700495
2021-01-25,All-Floors,Non-HKUST,132,1041,915836,868714842,34796649596,35665364438
2021-01-25,All-Floors,Others(HKUST),23,331,515856,294996227,2463366231,2758362458
2021-01-25,All-Floors,RPG,435,2286,1317853,1780900810,37834071612,39614972422
2021-01-25,All-Floors,Staff,404,4308,2156308,1298080871,33265350025,34563430896
2021-01-25,All-Floors,TPG,117,2918,2703656,2803919873,101232254494,104036174367
2021-01-25,All-Floors,Total,1687,16413,11119985,14798699659,345548485423,360347185082
2021-01-25,All-Floors,UG,562,5136,3179297,4067375454,116465804552,120533180006
2021-01-25,G,Alumni,9,180,79124,76555422,583775817,660331239
2021-01-25,G,Non-HKUST,59,369,185362,267751009,3553684247,3821435256
2021-01-25,G,Others(HKUST),5,44,6981,1262120,50380976,51643096
2021-01-25,G,RPG,88,762,369146,174169232,4708933851,4883103083
2021-01-25,G,Staff,127,1126,549265,513122015,7783312538,8296434553
2021-01-25,G,TPG,98,1123,509913,363183908,25765411523,26128595431
2021-01-25,G,Total,556,5071,2282246,2094657724,70586125189,72680782913
2021-01-25,G,UG,170,1467,582455,698614018,28140626237,28839240255
2021-01-25,LG1,Alumni,4,98,88940,3522585326,3833365306,7355950632
2021-01-25,LG1,Non-HKUST,49,244,326038,299828977,17612146476,17911975453
2021-01-25,LG1,Others(HKUST),8,33,276382,280317199,2030731892,2311049091
2021-01-25,LG1,RPG,52,417,357616,1241614420,19248415356,20490029776
2021-01-25,LG1,Staff,53,586,231018,372754467,14406113085,14778867552
2021-01-25,LG1,TPG,61,945,1134991,1390630489,40031362008,41421992497
2021-01-25,LG1,Total,356,3941,3791289,9758420873,156723346329,166481767202
2021-01-25,LG1,UG,129,1618,1376304,2650689995,59561212206,62211902201
2021-01-25,LG3,Alumni,7,64,136487,66531873,7192526738,7259058611
2021-01-25,LG3,Non-HKUST,66,202,134870,70275476,7173518414,7243793890
2021-01-25,LG3,Others(HKUST),13,172,21076,2732292,187152620,189884912
2021-01-25,LG3,RPG,281,571,274219,219432780,6682112964,6901545744
2021-01-25,LG3,Staff,281,974,240943,164037184,5257937485,5421974669
2021-01-25,LG3,TPG,60,386,266375,233532446,10595384741,10828917187
2021-01-25,LG3,Total,1082,3363,1610517,1121646868,48723422336,49845069204
2021-01-25,LG3,UG,374,994,536547,365104817,11634789374,11999894191
2021-01-25,LG4,Alumni,10,50,26618,19038961,7881321052,7900360013
2021-01-25,LG4,Non-HKUST,38,102,74692,103040459,1944817959,2047858418
2021-01-25,LG4,Others(HKUST),11,51,106849,7584031,106493694,114077725
2021-01-25,LG4,RPG,304,474,211882,57270347,2036565866,2093836213
2021-01-25,LG4,Staff,218,662,183188,29443662,578515116,607958778
2021-01-25,LG4,TPG,41,112,101736,53434596,1941355196,1994789792
2021-01-25,LG4,Total,996,2281,1138372,327280960,16535152277,16862433237
2021-01-25,LG4,UG,374,830,433407,57468904,2046083394,2103552298
2021-01-26,1,Alumni,1,1,0,0,0,0
2021-01-26,1,Non-HKUST,19,147,156953,163135319,6259908386,6423043705
2021-01-26,1,Others(HKUST),2,6,48156,48997093,1170612821,1219609914
2021-01-26,1,RPG,12,119,175184,229236994,10820643184,11049880178
2021-01-26,1,Staff,47,830,954321,245835870,7047930395,7293766265
2021-01-26,1,TPG,31,303,610673,619794705,27108422983,27728217688
2021-01-26,1,Total,135,1687,2137584,1486741754,62031956867,63518698621
2021-01-26,1,UG,23,281,192297,179741773,9624439098,9804180871
2021-01-26,All-Floors,Alumni,19,536,350738,537295355,15901710761,16439006116
2021-01-26,All-Floors,Non-HKUST,123,1443,1054689,1117732439,54567385415,55685117854
2021-01-26,All-Floors,Others(HKUST),17,329,510116,132930992,5696698629,5829629621
2021-01-26,All-Floors,RPG,436,2732,1846502,2068426773,65666228360,67734655133
2021-01-26,All-Floors,Staff,407,4424,2237298,5605053710,40566465661,46171519371
2021-01-26,All-Floors,TPG,113,3089,3047341,3942841538,183877854600,187820696138
2021-01-26,All-Floors,Total,1652,16967,12074165,16958146331,483669305257,500627451588
2021-01-26,All-Floors,UG,537,4414,3027481,3553865524,117392961831,120946827355
2021-01-26,G,Alumni,13,187,64878,204053647,1330341942,1534395589
2021-01-26,G,Non-HKUST,60,326,132761,252534587,5383298525,5635833112
2021-01-26,G,Others(HKUST),4,13,38586,642932,14496262,15139194
2021-01-26,G,RPG,89,951,578154,550002103,19269533943,19819536046
2021-01-26,G,Staff,134,1402,513761,2658866786,14125116892,16783983678
2021-01-26,G,TPG,97,1136,426519,343528244,21313464090,21656992334
2021-01-26,G,Total,561,5479,2301525,4543320328,74783741800,79327062128
2021-01-26,G,UG,164,1464,546866,533692029,13347490146,13881182175
2021-01-26,LG1,Alumni,6,111,120338,222038855,4838184893,5060223748
2021-01-26,LG1,Non-HKUST,58,451,431143,442778705,18594583146,19037361851
2021-01-26,LG1,Others(HKUST),5,19,231390,8044008,41662972,49706980
2021-01-26,LG1,RPG,51,545,571546,901962952,17944170519,18846133471
2021-01-26,LG1,Staff,76,735,363162,2590499316,16319316658,18909815974
2021-01-26,LG1,TPG,60,1105,1264762,2468004830,110268085696,112736090526
2021-01-26,LG1,Total,387,4024,4345602,8604458025,229192284191,237796742216
2021-01-26,LG1,UG,131,1058,1363261,1971129359,61186280307,63157409666
2021-01-26,LG3,Alumni,9,164,107109,85628578,6414266189,6499894767
2021-01-26,LG3,Non-HKUST,51,328,211653,184279275,13502928822,13687208097
2021-01-26,LG3,Others(HKUST),10,222,30301,24688052,1095704048,1120392100
2021-01-26,LG3,RPG,293,630,306006,303417693,14744153585,15047571278
2021-01-26,LG3,Staff,284,952,206731,68779378,1250085301,1318864679
2021-01-26,LG3,TPG,57,417,606285,377972552,18429512572,18807485124
2021-01-26,LG3,Total,1069,3583,1866786,1332663248,73530244405,74862907653
2021-01-26,LG3,UG,365,870,398701,287897720,18093593888,18381491608
2021-01-26,LG4,Alumni,10,73,58413,25574275,3318917737,3344492012
2021-01-26,LG4,Non-HKUST,48,191,122179,75004553,10826666536,10901671089
2021-01-26,LG4,Others(HKUST),10,69,161683,50558907,3374222526,3424781433
2021-01-26,LG4,RPG,302,487,215612,83807031,2887727129,2971534160
2021-01-26,LG4,Staff,215,505,199323,41072360,1824016415,1865088775
2021-01-26,LG4,TPG,48,128,139102,133541207,6758369259,6891910466
2021-01-26,LG4,Total,963,2194,1422668,990962976,44131077994,45122040970
2021-01-26,LG4,UG,330,741,526356,581404643,15141158392,15722563035
2021-01-27,1,Alumni,2,20,44025,2071026035,6321085040,8392111075
2021-01-27,1,Non-HKUST,14,131,185793,123843405,6997291472,7121134877
2021-01-27,1,Others(HKUST),3,13,96905,1918295,27368047,29286342
2021-01-27,1,RPG,8,12,22706,7357026,826377763,833734789
2021-01-27,1,Staff,50,964,904324,190711531,9157444644,9348156175
2021-01-27,1,TPG,28,301,652682,751742832,32397222142,33148964974
2021-01-27,1,Total,125,1675,2045331,3271605043,94306176705,97577781748
2021-01-27,1,UG,20,234,138896,125005919,38579387597,38704393516
2021-01-27,All-Floors,Alumni,18,402,347093,2324357947,23615493994,25939851941
2021-01-27,All-Floors,Non-HKUST,108,981,874660,1061043795,41144483137,42205526932
2021-01-27,All-Floors,Others(HKUST),18,146,583912,59225775,1403038629,1462264404
2021-01-27,All-Floors,RPG,393,2209,1545834,2265687515,56957564281,59223251796
2021-01-27,All-Floors,Staff,406,4532,2191847,886347231,29359730993,30246078224
2021-01-27,All-Floors,TPG,112,2877,2821742,6548005059,100280120132,106828125191
2021-01-27,All-Floors,Total,1544,15278,11311860,17009228948,396623021626,413632250574
2021-01-27,All-Floors,UG,489,4131,2946772,3864561626,143862590460,147727152086
2021-01-27,G,Alumni,12,141,13526,6908169,99334910,106243079
2021-01-27,G,Non-HKUST,62,323,205808,152768891,6984105316,7136874207
2021-01-27,G,Others(HKUST),4,10,91158,29442204,167808280,197250484
2021-01-27,G,RPG,89,762,521541,439258468,21461029149,21900287617
2021-01-27,G,Staff,118,1173,513624,262041220,5440113730,5702154950
2021-01-27,G,TPG,91,1032,435322,356526890,16021354511,16377881401
2021-01-27,G,Total,531,4773,2453775,1883759056,72039550005,73923309061
2021-01-27,G,UG,155,1332,672796,636813214,21865804109,22502617323
2021-01-27,LG1,Alumni,7,113,127577,132413735,4255680206,4388093941
2021-01-27,LG1,Non-HKUST,35,227,310278,370956589,18311289207,18682245796
2021-01-27,LG1,Others(HKUST),8,34,290601,20397892,1176031870,1196429762
2021-01-27,LG1,RPG,47,453,508581,1503129420,18243994349,19747123769
2021-01-27,LG1,Staff,74,653,359992,177586762,10645032048,10822618810
2021-01-27,LG1,TPG,51,932,1287348,4840132218,35902708935,40742841153
2021-01-27,LG1,Total,338,3585,4017326,9440773959,141640837729,151081611688
2021-01-27,LG1,UG,116,1173,1132949,2396157343,53106101114,55502258457
2021-01-27,LG3,Alumni,12,70,122463,89413004,6460831360,6550244364
2021-01-27,LG3,Non-HKUST,48,129,133912,395339720,4367674326,4763014046
2021-01-27,LG3,Others(HKUST),10,45,7668,160718,1057430,1218148
2021-01-27,LG3,RPG,233,624,348511,287068763,15188462289,15475531052
2021-01-27,LG3,Staff,281,995,218436,153491819,1852751680,2006243499
2021-01-27,LG3,TPG,58,505,387293,459293566,14792778150,15252071716
2021-01-27,LG3,Total,965,3131,1719775,1818046162,66483895594,68301941756
2021-01-27,LG3,UG,323,763,501492,433278572,23820340359,24253618931
2021-01-27,LG4,Alumni,8,58,39502,24597004,6478562478,6503159482
2021-01-27,LG4,Non-HKUST,34,171,38869,18135190,4484122816,4502258006
2021-01-27,LG4,Others(HKUST),9,44,97580,7306666,30773002,38079668
2021-01-27,LG4,RPG,256,358,144495,28873838,1237700731,1266574569
2021-01-27,LG4,Staff,238,747,195471,102515899,2264388891,2366904790
2021-01-27,LG4,TPG,45,107,59097,140309553,1166056394,1306365947
2021-01-27,LG4,Total,903,2114,1075653,595044728,22152561593,22747606321
2021-01-27,LG4,UG,313,629,500639,273306578,6490957281,6764263859
2021-01-28,1,Alumni,4,15,10111,8041877,428940437,436982314
2021-01-28,1,Non-HKUST,11,152,99342,43517819,2808470133,2851987952
2021-01-28,1,Others(HKUST),4,49,120912,14804175,265109323,279913498
2021-01-28,1,RPG,9,80,124448,107195519,5170158616,5277354135
2021-01-28,1,Staff,44,930,863471,327615134,15583693655,15911308789
2021-01-28,1,TPG,26,327,683689,487429586,35368954819,35856384405
2021-01-28,1,Total,115,1809,2141753,1148922168,64736692682,65885614850
2021-01-28,1,UG,17,256,239780,160318058,5111365699,5271683757
2021-01-28,All-Floors,Alumni,19,317,302142,315677596,14001259494,14316937090
2021-01-28,All-Floors,Non-HKUST,113,952,685026,586095794,24081036584,24667132378
2021-01-28,All-Floors,Others(HKUST),17,203,531914,63374490,2606044769,2669419259
2021-01-28,All-Floors,RPG,406,2419,1431001,1306981617,60633251832,61940233449
2021-01-28,All-Floors,Staff,363,4229,2008319,923260363,39951441126,40874701489
2021-01-28,All-Floors,TPG,108,2368,2489653,2494244094,111100811995,113595056089
2021-01-28,All-Floors,Total,1500,14523,10404061,9474187499,383943769535,393417957034
2021-01-28,All-Floors,UG,474,4035,2956006,3784553545,131569923735,135354477280
2021-01-28,G,Alumni,9,128,68102,102761595,834520401,937281996
2021-01-28,G,Non-HKUST,56,255,220156,272017274,5020846019,5292863293
2021-01-28,G,Others(HKUST),5,24,40484,12300615,292592740,304893355
2021-01-28,G,RPG,88,795,402154,504946586,20322514933,20827461519
2021-01-28,G,Staff,107,1222,512890,171916171,4373154913,4545071084
2021-01-28,G,TPG,82,858,286353,263620442,7357458047,7621078489
2021-01-28,G,Total,504,4726,2280418,2006114762,59446870281,61452985043
2021-01-28,G,UG,157,1444,750279,678552079,21245783228,21924335307
2021-01-28,LG1,Alumni,3,82,70747,81655219,4971735238,5053390457
2021-01-28,LG1,Non-HKUST,36,183,223675,170784021,6060313806,6231097827
2021-01-28,LG1,Others(HKUST),7,17,241941,23998597,1839296972,1863295569
2021-01-28,LG1,RPG,52,616,588335,579460017,29662970884,30242430901
2021-01-28,LG1,Staff,63,580,358932,320537457,18378529458,18699066915
2021-01-28,LG1,TPG,49,808,1051531,1448457173,52743345215,54191802388
2021-01-28,LG1,Total,323,3236,3772720,5150338123,196639364423,201789702546
2021-01-28,LG1,UG,113,950,1237559,2525445639,82983172850,85508618489
2021-01-28,LG3,Alumni,13,60,128837,104644674,6270744466,6375389140
2021-01-28,LG3,Non-HKUST,50,167,93249,75333463,8828577615,8903911078
2021-01-28,LG3,Others(HKUST),8,68,10568,3075574,107993100,111068674
2021-01-28,LG3,RPG,254,538,173305,80402011,3741740526,3822142537
2021-01-28,LG3,Staff,257,868,124830,69854834,748070793,817925627
2021-01-28,LG3,TPG,47,266,365224,242674784,14047643423,14290318207
2021-01-28,LG3,Total,916,2656,1228855,855694045,42139030457,42994724502
2021-01-28,LG3,UG,287,689,332842,279708705,8394260534,8673969239
2021-01-28,LG4,Alumni,11,32,24345,18574231,1495318952,1513893183
2021-01-28,LG4,Non-HKUST,38,195,48604,24443217,1362829011,1387272228
2021-01-28,LG4,Others(HKUST),12,45,118009,9195529,101052634,110248163
2021-01-28,LG4,RPG,245,390,142759,34977484,1735866873,1770844357
2021-01-28,LG4,Staff,210,629,148196,33336767,867992307,901329074
2021-01-28,LG4,TPG,47,109,102856,52062109,1583410491,1635472600
2021-01-28,LG4,Total,871,2096,980315,313118401,20981811692,21294930093
2021-01-28,LG4,UG,308,696,395546,140529064,13835341424,13975870488
2021-01-29,1,Alumni,4,18,5659,3992722,56663771,60656493
2021-01-29,1,Non-HKUST,14,96,157470,120150636,5920613711,6040764347
2021-01-29,1,Others(HKUST),2,7,56996,659614,2545450,3205064
2021-01-29,1,RPG,10,22,49184,35723177,892353311,928076488
2021-01-29,1,Staff,48,947,935289,355533908,16461074886,16816608794
2021-01-29,1,TPG,31,445,964652,1373138685,49696374177,51069512862
2021-01-29,1,Total,130,1660,2355084,2037106727,77559039670,79596146397
2021-01-29,1,UG,21,125,185834,147907985,4529414364,4677322349
2021-01-29,All-Floors,Alumni,18,418,370953,262304046,10010126681,10272430727
2021-01-29,All-Floors,Non-HKUST,98,874,696735,607432951,31860554450,32467987401
2021-01-29,All-Floors,Others(HKUST),21,201,521001,88656471,876227356,964883827
2021-01-29,All-Floors,RPG,401,2098,1378216,1685093600,37704713632,39389807232
2021-01-29,All-Floors,Staff,365,4263,2158086,979197341,30732094258,31711291599
2021-01-29,All-Floors,TPG,106,2456,2679955,2778552504,106668189061,109446741565
2021-01-29,All-Floors,Total,1535,14764,10762836,14168660520,331676770626,345845431146
2021-01-29,All-Floors,UG,526,4454,2957890,7767423607,113824865188,121592288795
2021-01-29,G,Alumni,11,245,88935,73830415,542073645,615904060
2021-01-29,G,Non-HKUST,47,283,226431,157508694,8036843842,8194352536
2021-01-29,G,Others(HKUST),8,40,63339,4182655,132450293,136632948
2021-01-29,G,RPG,81,725,546081,447154367,12626145530,13073299897
2021-01-29,G,Staff,124,1099,506867,200569189,4402268180,4602837369
2021-01-29,G,TPG,90,975,445223,308272683,19768551264,20076823947
2021-01-29,G,Total,520,4832,2399593,1738080491,62639724400,64377804891
2021-01-29,G,UG,159,1465,522717,546562488,17131391646,17677954134
2021-01-29,LG1,Alumni,3,51,92682,76807522,2587453261,2664260783
2021-01-29,LG1,Non-HKUST,32,191,167391,230959077,10401470097,10632429174
2021-01-29,LG1,Others(HKUST),7,19,236789,65151591,602748687,667900278
2021-01-29,LG1,RPG,42,347,345943,991524849,15048180080,16039704929
2021-01-29,LG1,Staff,69,621,332046,315706459,5106037990,5421744449
2021-01-29,LG1,TPG,41,590,733005,788115784,24506600682,25294716466
2021-01-29,LG1,Total,318,2999,3301413,8547720805,124911110039,133458830844
2021-01-29,LG1,UG,124,1180,1393557,6079455523,66658619242,72738074765
2021-01-29,LG3,Alumni,11,54,147942,90053662,6062188934,6152242596
2021-01-29,LG3,Non-HKUST,34,260,114290,79438414,5855986661,5935425075
2021-01-29,LG3,Others(HKUST),10,75,51009,14232224,104913039,119145263
2021-01-29,LG3,RPG,253,495,231717,144101744,5548699497,5692801241
2021-01-29,LG3,Staff,247,918,187253,65809841,3247262420,3313072261
2021-01-29,LG3,TPG,42,367,456099,262971900,11370609139,11633581039
2021-01-29,LG3,Total,948,3058,1623415,1362679612,50479617255,51842296867
2021-01-29,LG3,UG,351,889,435105,706071827,18289957565,18996029392
2021-01-29,LG4,Alumni,9,50,35735,17619725,761747070,779366795
2021-01-29,LG4,Non-HKUST,30,44,31153,19376130,1645640139,1665016269
2021-01-29,LG4,Others(HKUST),13,60,112868,4430387,33569887,38000274
2021-01-29,LG4,RPG,273,509,205291,66589463,3589335214,3655924677
2021-01-29,LG4,Staff,207,678,196631,41577944,1515450782,1557028726
2021-01-29,LG4,TPG,39,79,80976,46053452,1326053799,1372107251
2021-01-29,LG4,Total,898,2215,1083331,483072885,16087279262,16570352147
2021-01-29,LG4,UG,327,795,420677,287425784,7215482371,7502908155
2021-01-30,1,Alumni,4,41,34983,39394319,15848876512,15888270831
2021-01-30,1,Non-HKUST,4,22,21672,15006338,1142342345,1157348683
2021-01-30,1,Others(HKUST),1,1,36498,447126,1849349,2296475
2021-01-30,1,RPG,7,34,62490,141499243,2349299407,2490798650
2021-01-30,1,Staff,7,89,55876,21557740,167667394,189225134
2021-01-30,1,TPG,11,115,238897,122602907,5627901839,5750504746
2021-01-30,1,Total,38,334,498645,361621838,26365295681,26726917519
2021-01-30,1,UG,4,32,48229,21114165,1227358835,1248473000
2021-01-30,All-Floors,Alumni,12,190,109897,91224094,18036893881,18128117975
2021-01-30,All-Floors,Non-HKUST,73,634,367352,225892724,18282101582,18507994306
2021-01-30,All-Floors,Others(HKUST),9,65,376328,14040848,68204277,82245125
2021-01-30,All-Floors,RPG,233,1049,560259,581795286,16396483175,16978278461
2021-01-30,All-Floors,Staff,132,848,325823,97009455,3560774332,3657783787
2021-01-30,All-Floors,TPG,57,750,712100,436064052,17696391869,18132455921
2021-01-30,All-Floors,Total,851,4910,3348925,1890877825,93663545792,95554423617
2021-01-30,All-Floors,UG,335,1374,897166,444851366,19622696676,20067548042
2021-01-30,G,Alumni,8,72,11177,11488261,272063489,283551750
2021-01-30,G,Non-HKUST,35,153,93541,57400920,6424175384,6481576304
2021-01-30,G,Others(HKUST),1,1,27267,854321,13448966,14303287
2021-01-30,G,RPG,35,297,211740,122019828,4962444152,5084463980
2021-01-30,G,Staff,32,187,80557,35392605,1676472135,1711864740
2021-01-30,G,TPG,38,301,153756,66690505,3232233876,3298924381
2021-01-30,G,Total,203,1400,754953,387260949,20151531485,20538792434
2021-01-30,G,UG,54,389,176915,93414509,3570693483,3664107992
2021-01-30,LG1,Alumni,3,18,387,7469,198748,206217
2021-01-30,LG1,Non-HKUST,23,246,140838,96815756,6006763696,6103579452
2021-01-30,LG1,Others(HKUST),3,6,201641,8809997,23466509,32276506
2021-01-30,LG1,RPG,23,102,48019,14856306,976062908,990919214
2021-01-30,LG1,Staff,16,71,54168,28431935,1477152623,1505584558
2021-01-30,LG1,TPG,21,168,175260,148832353,4863227685,5012060038
2021-01-30,LG1,Total,126,779,797290,456493755,21675944148,22132437903
2021-01-30,LG1,UG,37,168,176977,158739939,8329071979,8487811918
2021-01-30,LG3,Alumni,6,28,39388,23557045,1230616301,1254173346
2021-01-30,LG3,Non-HKUST,34,168,83055,53353990,4615231304,4668585294
2021-01-30,LG3,Others(HKUST),6,28,9789,380281,11617888,11998169
2021-01-30,LG3,RPG,133,229,75055,225324129,5622830054,5848154183
2021-01-30,LG3,Staff,75,286,99407,7125278,81244662,88369940
2021-01-30,LG3,TPG,23,110,109670,57992048,3503327319,3561319367
2021-01-30,LG3,Total,481,1201,517532,400002953,16063034226,16463037179
2021-01-30,LG3,UG,204,352,101168,32270182,998166698,1030436880
2021-01-30,LG4,Alumni,8,31,23962,16777000,685138831,701915831
2021-01-30,LG4,Non-HKUST,24,45,28246,3315720,93588853,96904573
2021-01-30,LG4,Others(HKUST),8,29,101133,3549123,17821565,21370688
2021-01-30,LG4,RPG,161,387,162955,78095780,2485846654,2563942434
2021-01-30,LG4,Staff,74,215,35815,4501897,158237518,162739415
2021-01-30,LG4,TPG,27,56,34517,39946239,469701150,509647389
2021-01-30,LG4,Total,531,1196,780505,285498330,9407740252,9693238582
2021-01-30,LG4,UG,229,433,393877,139312571,5497405681,5636718252
2021-01-31,1,Alumni,0,0,0,0,0,0
2021-01-31,1,Non-HKUST,5,34,18610,11648773,354753303,366402076
2021-01-31,1,Others(HKUST),0,0,0,0,0,0
2021-01-31,1,RPG,5,5,277,0,0,0
2021-01-31,1,Staff,7,18,4530,1400776,61513123,62913899
2021-01-31,1,TPG,10,85,209117,115084626,9497443923,9612528549
2021-01-31,1,Total,29,147,249874,138429462,10342771269,10481200731
2021-01-31,1,UG,2,5,17340,10295287,429060920,439356207
2021-01-31,All-Floors,Alumni,8,222,120189,100559743,7803590163,7904149906
2021-01-31,All-Floors,Non-HKUST,77,508,323922,292012386,15324318736,15616331122
2021-01-31,All-Floors,Others(HKUST),7,49,334811,11912922,76664281,88577203
2021-01-31,All-Floors,RPG,229,636,384234,226733389,5620797868,5847531257
2021-01-31,All-Floors,Staff,118,739,338377,75760617,3238871279,3314631896
2021-01-31,All-Floors,TPG,59,953,943228,882521012,34019975269,34902496281
2021-01-31,All-Floors,Total,897,4895,3540096,2558409434,90945816992,93504226426
2021-01-31,All-Floors,UG,399,1788,1095335,968909365,24861599396,25830508761
2021-01-31,G,Alumni,5,65,7368,2476835,96834179,99311014
2021-01-31,G,Non-HKUST,37,165,96161,123015829,2642016387,2765032216
2021-01-31,G,Others(HKUST),3,10,27868,21198,813023,834221
2021-01-31,G,RPG,28,149,115176,46211499,2283566621,2329778120
2021-01-31,G,Staff,37,208,82155,22344035,789254794,811598829
2021-01-31,G,TPG,46,428,231838,106536954,10859477081,10966014035
2021-01-31,G,Total,216,1388,724941,426876774,20930874166,21357750940
2021-01-31,G,UG,60,363,164375,126270424,4258912081,4385182505
2021-01-31,LG1,Alumni,3,35,43753,13855742,2259277674,2273133416
2021-01-31,LG1,Non-HKUST,22,127,126325,82939442,10092787981,10175727423
2021-01-31,LG1,Others(HKUST),2,5,201131,5807616,23002769,28810385
2021-01-31,LG1,RPG,13,47,28467,75681563,1480768197,1556449760
2021-01-31,LG1,Staff,25,114,79986,39166063,711494711,750660774
2021-01-31,LG1,TPG,23,320,385364,566211053,8873931628,9440142681
2021-01-31,LG1,Total,137,935,1144453,1351116585,35409558032,36760674617
2021-01-31,LG1,UG,49,287,279427,567455106,11968295072,12535750178
2021-01-31,LG3,Alumni,7,89,41119,61959841,2693109817,2755069658
2021-01-31,LG3,Non-HKUST,33,117,53967,66421575,1992105031,2058526606
2021-01-31,LG3,Others(HKUST),4,20,7713,272591,730478,1003069
2021-01-31,LG3,RPG,140,220,133271,86378111,1302074716,1388452827
2021-01-31,LG3,Staff,71,256,123762,3481517,46423381,49904898
2021-01-31,LG3,TPG,20,93,109089,92590129,4603394430,4695984559
2021-01-31,LG3,Total,516,1297,608739,388905579,12546214327,12935119906
2021-01-31,LG3,UG,241,502,139818,77801815,1908376474,1986178289
2021-01-31,LG4,Alumni,6,33,27949,22267325,2754368493,2776635818
2021-01-31,LG4,Non-HKUST,30,65,28859,7986767,242656034,250642801
2021-01-31,LG4,Others(HKUST),4,14,98099,5811517,52118011,57929528
2021-01-31,LG4,RPG,153,215,107043,18462216,554388334,572850550
2021-01-31,LG4,Staff,60,143,47944,9368226,1630185270,1639553496
2021-01-31,LG4,TPG,15,27,7820,2098250,185728207,187826457
2021-01-31,LG4,Total,559,1128,812089,253081034,11716399198,11969480232
2021-01-31,LG4,UG,291,631,494375,187086733,6296954849,6484041582
