Date,Floor,User-Group,User-Count,WiFi-Conn,Duration-Sec,Traffic-In-Byte,Traffic-Out-Byte,Traffic-Both-Byte
2021-07-01,1,Alumni,0,0,0,0,0,0
2021-07-01,1,Non-HKUST,1,3,316,15184,24899,40083
2021-07-01,1,Others(HKUST),2,3,89496,3012816,113414293,116427109
2021-07-01,1,RPG,4,4,480,15189,28216,43405
2021-07-01,1,Staff,4,40,68825,30633050,753225546,783858596
2021-07-01,1,TPG,0,0,0,0,0,0
2021-07-01,1,Total,21,60,166009,38993405,868840498,907833903
2021-07-01,1,UG,10,10,6892,5317166,2147544,7464710
2021-07-01,All-Floors,Alumni,9,23,12417,6288735,314434336,320723071
2021-07-01,All-Floors,Non-HKUST,36,201,92118,23275502,1199157194,1222432696
2021-07-01,All-Floors,Others(HKUST),14,34,202273,9402495,187438065,196840560
2021-07-01,All-Floors,RPG,406,709,106330,68070363,1567556206,1635626569
2021-07-01,All-Floors,Staff,205,473,176743,54599914,1370759116,1425359030
2021-07-01,All-Floors,TPG,20,52,11110,3450298,122031407,125481705
2021-07-01,All-Floors,Total,1119,2469,895302,289496602,9453405949,9742902551
2021-07-01,All-Floors,UG,429,977,294311,124409295,4692029625,4816438920
2021-07-01,G,Alumni,0,0,0,0,0,0
2021-07-01,G,Non-HKUST,5,32,4792,500764,135589540,136090304
2021-07-01,G,Others(HKUST),2,2,205,8429,36535,44964
2021-07-01,G,RPG,5,5,105,52,432,484
2021-07-01,G,Staff,6,17,2591,1358075,32576537,33934612
2021-07-01,G,TPG,0,0,0,0,0,0
2021-07-01,G,Total,20,58,7738,1887226,168204336,170091562
2021-07-01,G,UG,2,2,45,19906,1292,21198
2021-07-01,LG1,Alumni,4,6,510,37981,144900,182881
2021-07-01,LG1,Non-HKUST,6,84,25803,1556008,68399342,69955350
2021-07-01,LG1,Others(HKUST),5,7,94730,5945322,25015152,30960474
2021-07-01,LG1,RPG,87,106,9872,1288212,2908749,4196961
2021-07-01,LG1,Staff,52,106,32909,1832289,84443662,86275951
2021-07-01,LG1,TPG,1,2,575,8004,17930,25934
2021-07-01,LG1,Total,398,619,193593,13814297,260917801,274732098
2021-07-01,LG1,UG,243,308,29194,3146481,79988066,83134547
2021-07-01,LG3,Alumni,4,8,10307,5453298,307690921,313144219
2021-07-01,LG3,Non-HKUST,25,45,10453,4323776,128680614,133004390
2021-07-01,LG3,Others(HKUST),7,16,5637,132404,384168,516572
2021-07-01,LG3,RPG,313,481,69054,55344740,1114525537,1169870277
2021-07-01,LG3,Staff,133,244,33265,15018506,391599568,406618074
2021-07-01,LG3,TPG,19,33,7087,1641360,75755147,77396507
2021-07-01,LG3,Total,744,1281,214058,140098884,4087269773,4227368657
2021-07-01,LG3,UG,243,454,78255,58184800,2068633818,2126818618
2021-07-01,LG4,Alumni,3,9,1600,797456,6598515,7395971
2021-07-01,LG4,Non-HKUST,17,37,50754,16879770,866462799,883342569
2021-07-01,LG4,Others(HKUST),5,6,12205,303524,48587917,48891441
2021-07-01,LG4,RPG,98,113,26819,11422170,450093272,461515442
2021-07-01,LG4,Staff,53,66,39153,5757994,108913803,114671797
2021-07-01,LG4,TPG,8,17,3448,1800934,46258330,48059264
2021-07-01,LG4,Total,293,451,313904,94702790,4068173541,4162876331
2021-07-01,LG4,UG,109,203,179925,57740942,2541258905,2598999847
2021-07-02,1,Alumni,3,57,26548,42472035,2254419427,2296891462
2021-07-02,1,Non-HKUST,8,27,48820,19857652,1447665673,1467523325
2021-07-02,1,Others(HKUST),1,7,88581,141379,500057,641436
2021-07-02,1,RPG,11,69,65423,56382703,3340340419,3396723122
2021-07-02,1,Staff,63,1199,1090133,355067893,9936739059,10291806952
2021-07-02,1,TPG,11,185,158337,137589382,6018187391,6155776773
2021-07-02,1,Total,129,1862,1915747,975230918,38029207916,39004438834
2021-07-02,1,UG,32,318,437905,363719874,15031355890,15395075764
2021-07-02,All-Floors,Alumni,27,550,364335,715113076,31079463650,31794576726
2021-07-02,All-Floors,Non-HKUST,126,757,568285,533474643,21845440297,22378914940
2021-07-02,All-Floors,Others(HKUST),25,172,396045,44473823,1776623501,1821097324
2021-07-02,All-Floors,RPG,577,3758,2399892,4914156748,95400233135,100314389883
2021-07-02,All-Floors,Staff,702,6024,2553706,1251850566,34174996754,35426847320
2021-07-02,All-Floors,TPG,77,2070,1851939,5583228445,84246978329,89830206774
2021-07-02,All-Floors,Total,2097,21572,13936210,20479433609,601999552005,622478985614
2021-07-02,All-Floors,UG,563,8241,5802008,7437136308,333475816339,340912952647
2021-07-02,G,Alumni,15,199,100933,287052567,9596615625,9883668192
2021-07-02,G,Non-HKUST,45,238,128879,140466256,2625892667,2766358923
2021-07-02,G,Others(HKUST),4,15,3760,532284,54341760,54874044
2021-07-02,G,RPG,100,1314,509008,499306950,17893135550,18392442500
2021-07-02,G,Staff,155,1527,536637,335326764,8315587082,8650913846
2021-07-02,G,TPG,59,855,637582,4384094040,31557605843,35941699883
2021-07-02,G,Total,613,6926,2484304,6381561905,94694202300,101075764205
2021-07-02,G,UG,235,2778,567505,734783044,24651023773,25385806817
2021-07-02,LG1,Alumni,12,125,87572,204139525,3606854977,3810994502
2021-07-02,LG1,Non-HKUST,34,209,157658,160893214,5487140806,5648034020
2021-07-02,LG1,Others(HKUST),7,22,97344,281204,2750387,3031591
2021-07-02,LG1,RPG,155,914,982700,3369792012,54847672566,58217464578
2021-07-02,LG1,Staff,132,810,358614,305400631,9663071276,9968471907
2021-07-02,LG1,TPG,32,526,575027,687799078,20256368689,20944167767
2021-07-02,LG1,Total,684,5014,4950860,8594178175,256228175418,264822353593
2021-07-02,LG1,UG,312,2408,2691945,3865872511,162364316717,166230189228
2021-07-02,LG3,Alumni,16,50,29985,55125568,2197360064,2252485632
2021-07-02,LG3,Non-HKUST,71,190,125071,157533917,6465895462,6623429379
2021-07-02,LG3,Others(HKUST),21,108,143469,43039953,1717186104,1760226057
2021-07-02,LG3,RPG,462,1067,592647,724889129,12239970839,12964859968
2021-07-02,LG3,Staff,547,1530,376861,168493327,3920000651,4088493978
2021-07-02,LG3,TPG,45,214,169864,91803946,5562870906,5654674852
2021-07-02,LG3,Total,1510,4722,2654281,2895621093,104011825668,106907446761
2021-07-02,LG3,UG,348,1563,1216384,1654735253,71908541642,73563276895
2021-07-02,LG4,Alumni,10,119,119297,126323381,13424213557,13550536938
2021-07-02,LG4,Non-HKUST,37,93,107857,54723604,5818845689,5873569293
2021-07-02,LG4,Others(HKUST),9,20,62891,479003,1845193,2324196
2021-07-02,LG4,RPG,185,394,250114,263785954,7079113761,7342899715
2021-07-02,LG4,Staff,238,958,191461,87561951,2339598686,2427160637
2021-07-02,LG4,TPG,30,290,311129,281941999,20851945500,21133887499
2021-07-02,LG4,Total,718,3048,1931018,1632841518,109036140703,110668982221
2021-07-02,LG4,UG,209,1174,888269,818025626,59520578317,60338603943
2021-07-03,1,Alumni,1,1,0,0,0,0
2021-07-03,1,Non-HKUST,3,3,20123,9347133,251841636,261188769
2021-07-03,1,Others(HKUST),3,13,116693,23439959,1371410961,1394850920
2021-07-03,1,RPG,6,14,14332,6912571,171858398,178770969
2021-07-03,1,Staff,14,90,133608,81137142,1587401377,1668538519
2021-07-03,1,TPG,8,31,48713,42811036,3861504387,3904315423
2021-07-03,1,Total,51,208,467851,713295377,15038394643,15751690020
2021-07-03,1,UG,16,56,134382,549647536,7794377884,8344025420
2021-07-03,All-Floors,Alumni,28,454,341644,206051537,14905864974,15111916511
2021-07-03,All-Floors,Non-HKUST,71,254,277979,254361121,7028139007,7282500128
2021-07-03,All-Floors,Others(HKUST),22,172,339514,69627292,4160929824,4230557116
2021-07-03,All-Floors,RPG,417,1748,1023566,942206740,64867405512,65809612252
2021-07-03,All-Floors,Staff,240,1105,555042,409351453,11632698734,12042050187
2021-07-03,All-Floors,TPG,50,870,839006,832057206,37988686818,38820744024
2021-07-03,All-Floors,Total,1234,8125,5682074,5911816148,250737403073,256649219221
2021-07-03,All-Floors,UG,406,3522,2305323,3198160799,110153678204,113351839003
2021-07-03,G,Alumni,19,190,90160,30996821,2275339590,2306336411
2021-07-03,G,Non-HKUST,24,86,99477,29103665,1815556352,1844660017
2021-07-03,G,Others(HKUST),2,16,476,237631,736243,973874
2021-07-03,G,RPG,53,490,236161,194168118,7890820728,8084988846
2021-07-03,G,Staff,37,280,135835,73383265,4634881964,4708265229
2021-07-03,G,TPG,34,458,325566,263788498,9811301689,10075090187
2021-07-03,G,Total,293,2584,1130709,826159931,36385307212,37211467143
2021-07-03,G,UG,124,1064,243034,234481933,9956670646,10191152579
2021-07-03,LG1,Alumni,11,109,90174,70786816,6545741673,6616528489
2021-07-03,LG1,Non-HKUST,13,48,54043,26012997,965612900,991625897
2021-07-03,LG1,Others(HKUST),8,15,95433,6000289,25463245,31463534
2021-07-03,LG1,RPG,126,420,377020,362648563,43192295809,43554944372
2021-07-03,LG1,Staff,61,138,112565,139037015,2568206226,2707243241
2021-07-03,LG1,TPG,27,148,197841,320114566,12836141737,13156256303
2021-07-03,LG1,Total,506,2077,2012270,2256790359,129982510714,132239301073
2021-07-03,LG1,UG,260,1199,1085194,1332190113,63849049124,65181239237
2021-07-03,LG3,Alumni,16,63,82005,49915543,1996414929,2046330472
2021-07-03,LG3,Non-HKUST,42,85,57315,180902263,3595003729,3775905992
2021-07-03,LG3,Others(HKUST),16,88,35515,12306658,171919975,184226633
2021-07-03,LG3,RPG,311,606,285653,268945651,11629942766,11898888417
2021-07-03,LG3,Staff,161,405,101611,49807531,2251237217,2301044748
2021-07-03,LG3,TPG,31,166,186848,114044516,8784369342,8898413858
2021-07-03,LG3,Total,813,2140,1143537,988021560,36785510992,37773532552
2021-07-03,LG3,UG,236,727,394590,312099398,8356623034,8668722432
2021-07-03,LG4,Alumni,15,91,79305,54352357,4088368782,4142721139
2021-07-03,LG4,Non-HKUST,20,32,47021,8995063,400124390,409119453
2021-07-03,LG4,Others(HKUST),12,40,91397,27642755,2591399400,2619042155
2021-07-03,LG4,RPG,111,218,110400,109531837,1982487811,2092019648
2021-07-03,LG4,Staff,84,192,71423,65986500,590971950,656958450
2021-07-03,LG4,TPG,16,67,80038,91298590,2695369663,2786668253
2021-07-03,LG4,Total,379,1116,927707,1127548921,32545679512,33673228433
2021-07-03,LG4,UG,121,476,448123,769741819,20196957516,20966699335
2021-07-04,1,Alumni,0,0,0,0,0,0
2021-07-04,1,Non-HKUST,2,7,31052,21370916,1093024181,1114395097
2021-07-04,1,Others(HKUST),2,3,87174,486218,9702940,10189158
2021-07-04,1,RPG,28,63,50896,22065488,611072199,633137687
2021-07-04,1,Staff,14,86,50154,7349527,281430281,288779808
2021-07-04,1,TPG,7,17,38731,51992403,3674588553,3726580956
2021-07-04,1,Total,66,245,372409,169646022,10344705291,10514351313
2021-07-04,1,UG,13,69,114402,66381470,4674887137,4741268607
2021-07-04,All-Floors,Alumni,19,263,138877,153710571,8614533629,8768244200
2021-07-04,All-Floors,Non-HKUST,60,307,328940,239561036,11270223102,11509784138
2021-07-04,All-Floors,Others(HKUST),10,51,306943,10583291,61439544,72022835
2021-07-04,All-Floors,RPG,342,1581,795839,614186337,24593838019,25208024356
2021-07-04,All-Floors,Staff,183,979,417639,458228088,9288537119,9746765207
2021-07-04,All-Floors,TPG,43,667,660235,724272120,32610277285,33334549405
2021-07-04,All-Floors,Total,1135,7524,5184795,4544875421,189622979385,194167854806
2021-07-04,All-Floors,UG,478,3676,2536322,2344333978,103184130687,105528464665
2021-07-04,G,Alumni,10,95,12144,21999978,88464416,110464394
2021-07-04,G,Non-HKUST,25,116,115713,89573251,2868272446,2957845697
2021-07-04,G,Others(HKUST),0,0,0,0,0,0
2021-07-04,G,RPG,47,453,233138,99973298,7512679394,7612652692
2021-07-04,G,Staff,38,294,109231,75768462,2302848930,2378617392
2021-07-04,G,TPG,30,366,192304,146911779,9360365297,9507277076
2021-07-04,G,Total,291,2406,904936,804088748,35917032708,36721121456
2021-07-04,G,UG,141,1082,242406,369861980,13784402225,14154264205
2021-07-04,LG1,Alumni,9,79,25868,27554197,1837326544,1864880741
2021-07-04,LG1,Non-HKUST,13,54,82778,61733566,3236081487,3297815053
2021-07-04,LG1,Others(HKUST),3,6,160252,8289171,40145530,48434701
2021-07-04,LG1,RPG,99,369,286762,369117536,9331752395,9700869931
2021-07-04,LG1,Staff,51,155,88445,91779500,2120115051,2211894551
2021-07-04,LG1,TPG,18,183,346136,459720776,17877339464,18337060240
2021-07-04,LG1,Total,463,1958,2011181,2144800275,82871766332,85016566607
2021-07-04,LG1,UG,270,1112,1020940,1126605529,48429005861,49555611390
2021-07-04,LG3,Alumni,11,64,59746,78138506,2171947403,2250085909
2021-07-04,LG3,Non-HKUST,28,48,36989,26764542,868847911,895612453
2021-07-04,LG3,Others(HKUST),6,28,8059,549318,6869863,7419181
2021-07-04,LG3,RPG,257,517,139657,76927820,5501530597,5578458417
2021-07-04,LG3,Staff,131,305,68930,155410893,2357753501,2513164394
2021-07-04,LG3,TPG,24,54,11646,5953122,206095139,212048261
2021-07-04,LG3,Total,766,2029,1016421,836044153,33450741487,34286785640
2021-07-04,LG3,UG,309,1013,691394,492299952,22337697073,22829997025
2021-07-04,LG4,Alumni,3,25,41119,26017890,4516795266,4542813156
2021-07-04,LG4,Non-HKUST,19,82,62408,40118761,3203997077,3244115838
2021-07-04,LG4,Others(HKUST),5,14,51458,1258584,4721211,5979795
2021-07-04,LG4,RPG,88,179,85386,46102195,1636803434,1682905629
2021-07-04,LG4,Staff,53,139,100879,127919706,2226389356,2354309062
2021-07-04,LG4,TPG,16,47,71418,59694040,1491888832,1551582872
2021-07-04,LG4,Total,312,886,879848,590296223,27038733567,27629029790
2021-07-04,LG4,UG,128,400,467180,289185047,13958138391,14247323438
2021-07-05,1,Alumni,2,54,77141,90437473,2211279872,2301717345
2021-07-05,1,Non-HKUST,14,75,112089,67819197,2464919598,2532738795
2021-07-05,1,Others(HKUST),3,30,102646,4118918,386623996,390742914
2021-07-05,1,RPG,31,128,124272,64424156,5940171579,6004595735
2021-07-05,1,Staff,81,1262,1319620,330080568,9172892358,9502972926
2021-07-05,1,TPG,14,184,182417,165791518,8801790418,8967581936
2021-07-05,1,Total,196,2141,2675466,1581516223,59895802497,61477318720
2021-07-05,1,UG,51,408,757281,858844393,30918124676,31776969069
2021-07-05,All-Floors,Alumni,18,286,343080,323353801,11657975489,11981329290
2021-07-05,All-Floors,Non-HKUST,108,717,643835,3927484764,21513103114,25440587878
2021-07-05,All-Floors,Others(HKUST),32,238,293333,40737323,1153847209,1194584532
2021-07-05,All-Floors,RPG,515,4075,3414141,6460265880,81620402228,88080668108
2021-07-05,All-Floors,Staff,717,5868,3036306,1679053437,38190065034,39869118471
2021-07-05,All-Floors,TPG,57,1129,1496838,5192525236,70482059304,75674584540
2021-07-05,All-Floors,Total,1914,19386,15469623,31315452317,520489333484,551804785801
2021-07-05,All-Floors,UG,467,7073,6242090,13692031876,295871881106,309563912982
2021-07-05,G,Alumni,9,136,141634,148247777,3193302693,3341550470
2021-07-05,G,Non-HKUST,49,275,202079,3559379287,3902491102,7461870389
2021-07-05,G,Others(HKUST),11,45,23964,4614230,88038846,92653076
2021-07-05,G,RPG,136,1391,595625,581250073,14421976643,15003226716
2021-07-05,G,Staff,175,1605,669862,245209176,9180829911,9426039087
2021-07-05,G,TPG,46,614,790539,1089168615,43682617706,44771786321
2021-07-05,G,Total,643,6287,3045584,6576208198,112384172183,118960380381
2021-07-05,G,UG,217,2221,621881,948339040,37914915282,38863254322
2021-07-05,LG1,Alumni,4,8,340,17251,26314,43565
2021-07-05,LG1,Non-HKUST,27,103,184161,158078109,9886479044,10044557153
2021-07-05,LG1,Others(HKUST),8,22,120053,16087200,424248531,440335731
2021-07-05,LG1,RPG,141,1298,1597183,4135444667,41269643860,45405088527
2021-07-05,LG1,Staff,117,567,304010,472835158,8509089009,8981924167
2021-07-05,LG1,TPG,15,132,233803,3373420534,8765423260,12138843794
2021-07-05,LG1,Total,566,4223,4973442,18099398231,205161411557,223260809788
2021-07-05,LG1,UG,254,2093,2533892,9943515312,136306501539,146250016851
2021-07-05,LG3,Alumni,7,27,32937,16466079,464867070,481333149
2021-07-05,LG3,Non-HKUST,61,200,125674,131773085,4841772130,4973545215
2021-07-05,LG3,Others(HKUST),19,106,33901,4411403,41230805,45642208
2021-07-05,LG3,RPG,388,904,667959,1201518991,9203181450,10404700441
2021-07-05,LG3,Staff,548,1542,410522,271721294,4657272153,4928993447
2021-07-05,LG3,TPG,28,152,215304,282399009,6015788206,6298187215
2021-07-05,LG3,Total,1347,4501,3021516,3248908054,83775883351,87024791405
2021-07-05,LG3,UG,296,1570,1535219,1340618193,58551771537,59892389730
2021-07-05,LG4,Alumni,4,61,91028,68185221,5788499540,5856684761
2021-07-05,LG4,Non-HKUST,20,64,19832,10435086,417441240,427876326
2021-07-05,LG4,Others(HKUST),11,35,12769,11505572,213705031,225210603
2021-07-05,LG4,RPG,131,354,429102,477627993,10785428696,11263056689
2021-07-05,LG4,Staff,208,892,332292,359207241,6669981603,7029188844
2021-07-05,LG4,TPG,13,47,74775,281745560,3216439714,3498185274
2021-07-05,LG4,Total,522,2234,1753615,1809421611,59272063896,61081485507
2021-07-05,LG4,UG,135,781,793817,600714938,32180568072,32781283010
2021-07-06,1,Alumni,2,34,78849,128761241,2805212262,2933973503
2021-07-06,1,Non-HKUST,7,27,54135,39825614,385964131,425789745
2021-07-06,1,Others(HKUST),5,50,164625,50987695,9608926465,9659914160
2021-07-06,1,RPG,34,158,220450,206752367,7066718840,7273471207
2021-07-06,1,Staff,75,1369,1188690,370943266,7675976049,8046919315
2021-07-06,1,TPG,13,144,276596,270817733,17739668239,18010485972
2021-07-06,1,Total,200,2416,2983662,1980218542,84257075163,86237293705
2021-07-06,1,UG,64,634,1000317,912130626,38974609177,39886739803
2021-07-06,All-Floors,Alumni,25,282,254245,244926459,7542293668,7787220127
2021-07-06,All-Floors,Non-HKUST,111,818,552925,623472457,46436188550,47059661007
2021-07-06,All-Floors,Others(HKUST),28,317,579668,73509837,9767112853,9840622690
2021-07-06,All-Floors,RPG,583,4081,3000768,5231012931,168513426073,173744439004
2021-07-06,All-Floors,Staff,739,6288,2650298,1234619972,38523171615,39757791587
2021-07-06,All-Floors,TPG,75,1866,1976783,4327230538,65688735648,70015966186
2021-07-06,All-Floors,Total,2172,22619,15642710,28461643057,663376577749,691838220806
2021-07-06,All-Floors,UG,611,8967,6628023,16726870863,326905649342,343632520205
2021-07-06,G,Alumni,11,94,35907,34942493,618672996,653615489
2021-07-06,G,Non-HKUST,32,185,99350,258778562,4475908012,4734686574
2021-07-06,G,Others(HKUST),9,42,4724,736743,10853112,11589855
2021-07-06,G,RPG,140,1551,941879,995671382,40996902980,41992574362
2021-07-06,G,Staff,172,1631,526581,267417849,15690071456,15957489305
2021-07-06,G,TPG,59,727,544619,375344698,12530816328,12906161026
2021-07-06,G,Total,672,7175,2904323,2739846911,112166933613,114906780524
2021-07-06,G,UG,249,2945,751263,806955184,37843708729,38650663913
2021-07-06,LG1,Alumni,8,71,57071,28450928,848784625,877235553
2021-07-06,LG1,Non-HKUST,29,185,137239,74086001,2336535279,2410621280
2021-07-06,LG1,Others(HKUST),11,70,260924,8618915,95639697,104258612
2021-07-06,LG1,RPG,140,927,914107,2311917934,98552220601,100864138535
2021-07-06,LG1,Staff,132,638,337424,319631496,6724506828,7044138324
2021-07-06,LG1,TPG,32,481,654806,3263652549,17451000910,20714653459
2021-07-06,LG1,Total,659,4629,4669244,10992748107,253315843932,264308592039
2021-07-06,LG1,UG,307,2257,2307673,4986390284,127307155992,132293546276
2021-07-06,LG3,Alumni,17,56,23423,16269512,989611200,1005880712
2021-07-06,LG3,Non-HKUST,79,279,167688,172036419,7516929650,7688966069
2021-07-06,LG3,Others(HKUST),21,103,18965,11397880,26633648,38031528
2021-07-06,LG3,RPG,444,1025,529106,1048051662,14144398574,15192450236
2021-07-06,LG3,Staff,571,1798,385480,163866359,5166367289,5330233648
2021-07-06,LG3,TPG,44,220,195882,133896950,7882073838,8015970788
2021-07-06,LG3,Total,1579,5392,2872236,10289176635,115403640849,125692817484
2021-07-06,LG3,UG,403,1911,1551692,8743657853,79677626650,88421284503
2021-07-06,LG4,Alumni,8,27,58995,36502285,2280012585,2316514870
2021-07-06,LG4,Non-HKUST,39,142,94513,78745861,31720851478,31799597339
2021-07-06,LG4,Others(HKUST),12,52,130430,1768604,25059931,26828535
2021-07-06,LG4,RPG,150,420,395226,668619586,7753185078,8421804664
2021-07-06,LG4,Staff,259,852,212123,112761002,3266249993,3379010995
2021-07-06,LG4,TPG,33,294,304880,283518608,10085176333,10368694941
2021-07-06,LG4,Total,714,3007,2213245,2459652862,98233084192,100692737054
2021-07-06,LG4,UG,213,1220,1017078,1277736916,43102548794,44380285710
2021-07-07,1,Alumni,4,28,64996,85252908,2600587067,2685839975
2021-07-07,1,Non-HKUST,11,148,109798,136347739,4354266644,4490614383
2021-07-07,1,Others(HKUST),8,54,172617,228606569,9579301095,9807907664
2021-07-07,1,RPG,20,72,79793,80995883,3360352032,3441347915
2021-07-07,1,Staff,75,1293,946152,476283219,36935849195,37412132414
2021-07-07,1,TPG,15,102,167590,253858129,15776753428,16030611557
2021-07-07,1,Total,167,2074,2111377,6236919135,115292000975,121528920110
2021-07-07,1,UG,34,377,570431,4975574688,42684891514,47660466202
2021-07-07,All-Floors,Alumni,25,390,434536,461943835,30301976939,30763920774
2021-07-07,All-Floors,Non-HKUST,115,923,772704,1346252111,33267930873,34614182984
2021-07-07,All-Floors,Others(HKUST),24,336,793027,329251282,13248539083,13577790365
2021-07-07,All-Floors,RPG,569,3880,2641002,3644481375,82924642965,86569124340
2021-07-07,All-Floors,Staff,741,6709,3296989,4056273118,80110123316,84166396434
2021-07-07,All-Floors,TPG,75,1974,1708216,3587844136,86701977826,90289821962
2021-07-07,All-Floors,Total,2106,21482,15268995,28086890917,724692490526,752779381443
2021-07-07,All-Floors,UG,557,7270,5622521,14660845060,398137299524,412798144584
2021-07-07,G,Alumni,16,162,124287,189124587,12554860442,12743985029
2021-07-07,G,Non-HKUST,37,264,157482,292880261,9555233139,9848113400
2021-07-07,G,Others(HKUST),10,67,52327,7383060,113466368,120849428
2021-07-07,G,RPG,113,1392,798625,1085452371,29259330567,30344782938
2021-07-07,G,Staff,174,1711,563959,2042254658,10057401957,12099656615
2021-07-07,G,TPG,58,769,436568,461256812,14032006210,14493263022
2021-07-07,G,Total,609,6491,2794209,5406839482,119377014594,124783854076
2021-07-07,G,UG,201,2126,660961,1328487733,43804715911,45133203644
2021-07-07,LG1,Alumni,7,75,94735,73784357,6301656054,6375440411
2021-07-07,LG1,Non-HKUST,29,243,268629,749311494,7096494164,7845805658
2021-07-07,LG1,Others(HKUST),12,66,324758,54405623,3270127415,3324533038
2021-07-07,LG1,RPG,179,1074,1005032,1484019408,29089593163,30573612571
2021-07-07,LG1,Staff,189,1165,846266,749034504,11602858355,12351892859
2021-07-07,LG1,TPG,35,374,411091,723562205,19445275374,20168837579
2021-07-07,LG1,Total,785,5071,5333610,9984931991,283061806683,293046738674
2021-07-07,LG1,UG,334,2074,2383099,6150814400,206255802158,212406616558
2021-07-07,LG3,Alumni,11,53,48698,38573345,3579153269,3617726614
2021-07-07,LG3,Non-HKUST,70,180,151036,97094248,6529442420,6626536668
2021-07-07,LG3,Others(HKUST),17,107,32368,18425105,59773973,78199078
2021-07-07,LG3,RPG,410,994,508656,780315304,14805593488,15585908792
2021-07-07,LG3,Staff,586,1603,330613,459911108,9826175127,10286086235
2021-07-07,LG3,TPG,46,277,203417,1390558000,9316622119,10707180119
2021-07-07,LG3,Total,1471,4921,2580377,4241596022,110007914472,114249510494
2021-07-07,LG3,UG,331,1707,1305589,1456718912,65891154076,67347872988
2021-07-07,LG4,Alumni,8,72,101820,75208638,5265720107,5340928745
2021-07-07,LG4,Non-HKUST,23,88,85759,70618369,5732494506,5803112875
2021-07-07,LG4,Others(HKUST),10,42,210957,20430925,225870232,246301157
2021-07-07,LG4,RPG,159,348,248896,213698409,6409773715,6623472124
2021-07-07,LG4,Staff,242,937,609999,328789629,11687838682,12016628311
2021-07-07,LG4,TPG,37,452,489550,758608990,28131320695,28889929685
2021-07-07,LG4,Total,656,2925,2449422,2216604287,96953753802,99170358089
2021-07-07,LG4,UG,177,986,702441,749249327,39500735865,40249985192
2021-07-08,1,Alumni,1,7,28355,47528329,2228014767,2275543096
2021-07-08,1,Non-HKUST,12,96,94298,299364865,7037254277,7336619142
2021-07-08,1,Others(HKUST),7,66,213373,51944304,9939411462,9991355766
2021-07-08,1,RPG,17,85,134492,141411916,5341231087,5482643003
2021-07-08,1,Staff,81,1212,1008402,352244047,15498888898,15851132945
2021-07-08,1,TPG,5,92,115424,94501317,10748452187,10842953504
2021-07-08,1,Total,171,1939,2162934,4432820709,118085499958,122518320667
2021-07-08,1,UG,48,381,568590,3445825931,67292247280,70738073211
2021-07-08,All-Floors,Alumni,24,341,351407,464738385,32849924024,33314662409
2021-07-08,All-Floors,Non-HKUST,119,984,648036,1045816331,48662619250,49708435581
2021-07-08,All-Floors,Others(HKUST),32,392,754701,118415988,12777265819,12895681807
2021-07-08,All-Floors,RPG,573,3877,3155947,6159114187,112011320974,118170435161
2021-07-08,All-Floors,Staff,759,6899,3182538,1413455149,54693639020,56107094169
2021-07-08,All-Floors,TPG,73,1389,1556193,4175757430,171919933781,176095691211
2021-07-08,All-Floors,Total,2192,21830,15709037,26144373362,876760690507,902905063869
2021-07-08,All-Floors,UG,612,7948,6060215,12767075892,443845987639,456613063531
2021-07-08,G,Alumni,12,99,84110,130980579,12240891875,12371872454
2021-07-08,G,Non-HKUST,41,260,100120,181798305,3701248088,3883046393
2021-07-08,G,Others(HKUST),10,100,36959,11824414,172656755,184481169
2021-07-08,G,RPG,124,1261,1009772,1615447235,43922816165,45538263400
2021-07-08,G,Staff,163,1677,377874,236279933,6531153804,6767433737
2021-07-08,G,TPG,55,598,589697,932278252,19781668719,20713946971
2021-07-08,G,Total,649,6323,2847146,3897627817,121766400247,125664028064
2021-07-08,G,UG,244,2328,648614,789019099,35415964841,36204983940
2021-07-08,LG1,Alumni,8,123,153880,231001946,12889414495,13120416441
2021-07-08,LG1,Non-HKUST,28,195,168190,199346758,6145457331,6344804089
2021-07-08,LG1,Others(HKUST),12,50,329847,40925192,2341294020,2382219212
2021-07-08,LG1,RPG,176,915,950389,2282499486,34137441200,36419940686
2021-07-08,LG1,Staff,186,1285,780069,307653488,16929820119,17237473607
2021-07-08,LG1,TPG,27,382,532732,2292914891,127662023292,129954938183
2021-07-08,LG1,Total,792,5535,5742499,11884415542,454626931833,466511347375
2021-07-08,LG1,UG,355,2585,2827392,6530073781,254521481376,261051555157
2021-07-08,LG3,Alumni,12,85,64711,30791671,3135651754,3166443425
2021-07-08,LG3,Non-HKUST,74,244,166192,173837472,27148264624,27322102096
2021-07-08,LG3,Others(HKUST),24,137,35870,7145464,219449262,226594726
2021-07-08,LG3,RPG,438,1059,583600,1639372861,16471037427,18110410288
2021-07-08,LG3,Staff,597,1770,477440,248276077,11958331573,12206607650
2021-07-08,LG3,TPG,40,201,174016,591375246,7451469161,8042844407
2021-07-08,LG3,Total,1571,5228,2721459,4087312993,128031754332,132119067325
2021-07-08,LG3,UG,386,1732,1219630,1396514202,61647550531,63044064733
2021-07-08,LG4,Alumni,6,27,20351,24435860,2355951133,2380386993
2021-07-08,LG4,Non-HKUST,29,189,119236,191468931,4630394930,4821863861
2021-07-08,LG4,Others(HKUST),10,39,138652,6576614,104454320,111030934
2021-07-08,LG4,RPG,143,557,477694,480382689,12138795095,12619177784
2021-07-08,LG4,Staff,257,955,538753,269001604,3775444626,4044446230
2021-07-08,LG4,TPG,19,116,144324,264687724,6276320422,6541008146
2021-07-08,LG4,Total,648,2805,2234999,1842196301,54250104137,56092300438
2021-07-08,LG4,UG,184,922,795989,605642879,24968743611,25574386490
2021-07-09,1,Alumni,2,6,25586,67032822,7038295806,7105328628
2021-07-09,1,Non-HKUST,5,18,26283,5077079,62004603,67081682
2021-07-09,1,Others(HKUST),5,42,209858,141049732,9345205238,9486254970
2021-07-09,1,RPG,16,78,128248,251412456,9985355768,10236768224
2021-07-09,1,Staff,80,1086,1010018,293538908,10493771973,10787310881
2021-07-09,1,TPG,10,48,111841,99584811,5025467551,5125052362
2021-07-09,1,Total,149,1530,1849584,1199428663,58410496299,59609924962
2021-07-09,1,UG,31,252,337750,341732855,16460395360,16802128215
2021-07-09,All-Floors,Alumni,25,570,485180,546411659,28728697862,29275109521
2021-07-09,All-Floors,Non-HKUST,120,753,657242,531905215,26843523832,27375429047
2021-07-09,All-Floors,Others(HKUST),31,229,599628,210691532,12679865183,12890556715
2021-07-09,All-Floors,RPG,570,3567,2701798,5333828041,379105303350,384439131391
2021-07-09,All-Floors,Staff,696,5742,2629324,1590772211,65599102060,67189874271
2021-07-09,All-Floors,TPG,69,1171,1427415,1730482050,75432433493,77162915543
2021-07-09,All-Floors,Total,2047,18437,13375623,16160942855,846653426102,862814368957
2021-07-09,All-Floors,UG,536,6405,4875036,6216852147,258264500322,264481352469
2021-07-09,G,Alumni,14,129,93536,165148497,4651238994,4816387491
2021-07-09,G,Non-HKUST,37,186,158572,90644205,2747313290,2837957495
2021-07-09,G,Others(HKUST),7,39,4541,16306791,634553287,650860078
2021-07-09,G,RPG,120,1214,620017,1008128540,299487184550,300495313090
2021-07-09,G,Staff,167,1407,491099,272491669,13140780500,13413272169
2021-07-09,G,TPG,52,552,686074,1021928690,33313779930,34335708620
2021-07-09,G,Total,586,5361,2562306,3278663242,381050032173,384328695415
2021-07-09,G,UG,189,1834,508467,704014850,27075181622,27779196472
2021-07-09,LG1,Alumni,9,116,59451,68155694,834013991,902169685
2021-07-09,LG1,Non-HKUST,25,237,228503,222212480,6889388071,7111600551
2021-07-09,LG1,Others(HKUST),11,35,288481,25608948,844799187,870408135
2021-07-09,LG1,RPG,161,933,1119326,1922838640,49129317699,51052156339
2021-07-09,LG1,Staff,143,708,478580,389831352,28536736448,28926567800
2021-07-09,LG1,TPG,22,227,241436,174263882,7122451724,7296715606
2021-07-09,LG1,Total,664,4271,4632701,6391086912,234673181418,241064268330
2021-07-09,LG1,UG,293,2015,2216924,3588175916,141316474298,144904650214
2021-07-09,LG3,Alumni,14,193,191694,153883096,12190179299,12344062395
2021-07-09,LG3,Non-HKUST,80,203,166335,173603996,11779166558,11952770554
2021-07-09,LG3,Others(HKUST),21,81,29307,22861023,1838283746,1861144769
2021-07-09,LG3,RPG,444,1011,517182,1202833818,12067017603,13269851421
2021-07-09,LG3,Staff,541,1775,362385,282397182,6384953125,6667350307
2021-07-09,LG3,TPG,45,161,137974,95055142,5957572562,6052627704
2021-07-09,LG3,Total,1478,4922,2433499,2867683864,97142627547,100010311411
2021-07-09,LG3,UG,333,1498,1028622,937049607,46925454654,47862504261
2021-07-09,LG4,Alumni,11,126,114913,92191550,4014969772,4107161322
2021-07-09,LG4,Non-HKUST,32,109,77549,40367455,5365651310,5406018765
2021-07-09,LG4,Others(HKUST),14,32,67441,4865038,17023725,21888763
2021-07-09,LG4,RPG,162,331,317025,948614587,8436427730,9385042317
2021-07-09,LG4,Staff,222,766,287242,352513100,7042860014,7395373114
2021-07-09,LG4,TPG,22,183,250090,339649525,24013161726,24352811251
2021-07-09,LG4,Total,617,2353,1897533,2424080174,75377088665,77801168839
2021-07-09,LG4,UG,154,806,783273,645878919,26486994388,27132873307
2021-07-10,1,Alumni,4,17,15852,37533806,919601299,957135105
2021-07-10,1,Non-HKUST,9,58,30286,15310298,920030745,935341043
2021-07-10,1,Others(HKUST),2,9,29441,4309704,52149385,56459089
2021-07-10,1,RPG,14,82,82178,50022371,7272101050,7322123421
2021-07-10,1,Staff,17,84,77672,21433048,382460995,403894043
2021-07-10,1,TPG,4,10,12642,22821784,553507544,576329328
2021-07-10,1,Total,72,397,366792,266834828,20896233059,21163067887
2021-07-10,1,UG,22,137,118721,115403817,10796382041,10911785858
2021-07-10,All-Floors,Alumni,25,370,190225,230090353,18866702241,19096792594
2021-07-10,All-Floors,Non-HKUST,77,562,286558,466862326,11721158491,12188020817
2021-07-10,All-Floors,Others(HKUST),13,126,110138,15120468,218587410,233707878
2021-07-10,All-Floors,RPG,320,1188,476456,569129220,19067856434,19636985654
2021-07-10,All-Floors,Staff,224,1133,327869,145570958,4584499500,4730070458
2021-07-10,All-Floors,TPG,41,758,455294,1507048529,11406828976,12913877505
2021-07-10,All-Floors,Total,1153,7991,3728231,9579414916,161072742171,170652157087
2021-07-10,All-Floors,UG,453,3854,1881691,6645593062,95207109119,101852702181
2021-07-10,G,Alumni,15,128,35111,16137477,1195567890,1211705367
2021-07-10,G,Non-HKUST,23,152,34652,128031317,1401428200,1529459517
2021-07-10,G,Others(HKUST),3,8,6443,3677,2468,6145
2021-07-10,G,RPG,49,313,146975,393515197,6087857042,6481372239
2021-07-10,G,Staff,38,247,52631,30720656,764604930,795325586
2021-07-10,G,TPG,27,255,118048,73534160,3618232989,3691767149
2021-07-10,G,Total,303,2344,712871,1063279619,30066823841,31130103460
2021-07-10,G,UG,148,1241,319011,421337135,16999130322,17420467457
2021-07-10,LG1,Alumni,13,66,27342,39903610,1004650058,1044553668
2021-07-10,LG1,Non-HKUST,19,128,81311,223398654,3524125813,3747524467
2021-07-10,LG1,Others(HKUST),6,22,29440,30152,692636,722788
2021-07-10,LG1,RPG,92,262,130170,37071313,1693569677,1730640990
2021-07-10,LG1,Staff,67,190,45148,8621673,612335278,620956951
2021-07-10,LG1,TPG,19,172,159805,1279947943,3642726537,4922674480
2021-07-10,LG1,Total,488,2273,1427046,7383803912,59906181268,67289985180
2021-07-10,LG1,UG,272,1433,953830,5794830567,49428081269,55222911836
2021-07-10,LG3,Alumni,14,74,58813,61150649,7604890751,7666041400
2021-07-10,LG3,Non-HKUST,41,134,87114,77407796,3559823136,3637230932
2021-07-10,LG3,Others(HKUST),10,66,28915,7570047,147061761,154631808
2021-07-10,LG3,RPG,223,395,79532,69581005,2417556890,2487137895
2021-07-10,LG3,Staff,153,397,99381,56772566,1493616039,1550388605
2021-07-10,LG3,TPG,22,89,68993,49758101,1086312202,1136070303
2021-07-10,LG3,Total,700,1834,640123,514976165,23107937106,23622913271
2021-07-10,LG3,UG,237,679,217375,192736001,6798676327,6991412328
2021-07-10,LG4,Alumni,8,85,53107,75364811,8141992243,8217357054
2021-07-10,LG4,Non-HKUST,23,90,53195,22714261,2315750597,2338464858
2021-07-10,LG4,Others(HKUST),6,21,15899,3206888,18681160,21888048
2021-07-10,LG4,RPG,88,136,37601,18939334,1596771775,1615711109
2021-07-10,LG4,Staff,62,215,53037,28023015,1331482258,1359505273
2021-07-10,LG4,TPG,15,232,95806,80986541,2506049704,2587036245
2021-07-10,LG4,Total,314,1143,581399,350520392,27095566897,27446087289
2021-07-10,LG4,UG,112,364,272754,121285542,11184839160,11306124702
2021-07-11,1,Alumni,2,4,12683,189570544,2192267687,2381838231
2021-07-11,1,Non-HKUST,2,11,11680,2851813,278400077,281251890
2021-07-11,1,Others(HKUST),3,25,40832,12537457,254355194,266892651
2021-07-11,1,RPG,10,36,49363,37345310,3794530858,3831876168
2021-07-11,1,Staff,8,36,40085,32575168,446319156,478894324
2021-07-11,1,TPG,2,19,33880,57732962,436848255,494581217
2021-07-11,1,Total,58,308,343810,454478394,13013351485,13467829879
2021-07-11,1,UG,31,177,155287,121865140,5610630258,5732495398
2021-07-11,All-Floors,Alumni,34,450,189632,285222187,11008853570,11294075757
2021-07-11,All-Floors,Non-HKUST,59,351,229802,330091493,10933943887,11264035380
2021-07-11,All-Floors,Others(HKUST),16,111,107728,52069899,2099994889,2152064788
2021-07-11,All-Floors,RPG,328,1404,674039,1150804348,29554817443,30705621791
2021-07-11,All-Floors,Staff,172,858,297004,132306545,3544914350,3677220895
2021-07-11,All-Floors,TPG,39,619,400497,298180194,11450353257,11748533451
2021-07-11,All-Floors,Total,1121,7306,3725050,3901000786,145992304492,149893305278
2021-07-11,All-Floors,UG,473,3513,1826348,1652326120,77399427096,79051753216
2021-07-11,G,Alumni,14,112,15940,9122301,443946817,453069118
2021-07-11,G,Non-HKUST,20,110,61230,36129187,2408520846,2444650033
2021-07-11,G,Others(HKUST),3,11,170,6948,2582877,2589825
2021-07-11,G,RPG,50,378,145965,190519563,5209222839,5399742402
2021-07-11,G,Staff,22,210,51160,4952838,244276559,249229397
2021-07-11,G,TPG,25,250,119107,65310703,5408769213,5474079916
2021-07-11,G,Total,256,2014,667379,570625383,34840406204,35411031587
2021-07-11,G,UG,122,943,273807,264583843,21123087053,21387670896
2021-07-11,LG1,Alumni,10,39,14961,12458180,794694076,807152256
2021-07-11,LG1,Non-HKUST,14,77,46799,25530284,1267711697,1293241981
2021-07-11,LG1,Others(HKUST),7,24,33453,5464039,1805023436,1810487475
2021-07-11,LG1,RPG,84,392,281317,119381372,4401096978,4520478350
2021-07-11,LG1,Staff,51,176,60822,15268230,174066139,189334369
2021-07-11,LG1,TPG,12,122,100333,50110361,2076959552,2127069913
2021-07-11,LG1,Total,439,1851,1201304,713645351,34998202056,35711847407
2021-07-11,LG1,UG,261,1021,663619,485432885,24478650178,24964083063
2021-07-11,LG3,Alumni,22,178,69552,31809682,2123607755,2155417437
2021-07-11,LG3,Non-HKUST,28,63,40247,43203516,599471391,642674907
2021-07-11,LG3,Others(HKUST),11,30,8244,33587689,33712542,67300231
2021-07-11,LG3,RPG,246,459,153333,766474997,13876091600,14642566597
2021-07-11,LG3,Staff,121,316,94352,44027669,1978686906,2022714575
2021-07-11,LG3,TPG,27,123,45058,28434124,973086726,1001520850
2021-07-11,LG3,Total,727,2026,770965,1561180323,36083624406,37644804729
2021-07-11,LG3,UG,272,857,360179,613642646,16498967486,17112610132
2021-07-11,LG4,Alumni,14,117,76496,42261480,5454337235,5496598715
2021-07-11,LG4,Non-HKUST,17,90,69846,222376693,6379839876,6602216569
2021-07-11,LG4,Others(HKUST),7,21,25029,473766,4320840,4794606
2021-07-11,LG4,RPG,80,139,44061,37083106,2273875168,2310958274
2021-07-11,LG4,Staff,50,120,50585,35482640,701565590,737048230
2021-07-11,LG4,TPG,14,105,102119,96592044,2554689511,2651281555
2021-07-11,LG4,Total,323,1107,741592,601071335,27056720341,27657791676
2021-07-11,LG4,UG,141,515,373456,166801606,9688092121,9854893727
2021-07-12,1,Alumni,2,3,12874,48540906,2771331953,2819872859
2021-07-12,1,Non-HKUST,4,104,46171,102051022,964398435,1066449457
2021-07-12,1,Others(HKUST),4,93,99418,30090092,1196101922,1226192014
2021-07-12,1,RPG,16,80,84407,38276560,1208228051,1246504611
2021-07-12,1,Staff,67,1252,793673,138720104,3706797260,3845517364
2021-07-12,1,TPG,11,175,145237,121904793,7230317063,7352221856
2021-07-12,1,Total,130,1869,1361667,628280446,21840360981,22468641427
2021-07-12,1,UG,26,162,179887,148696969,4763186297,4911883266
2021-07-12,All-Floors,Alumni,26,406,291346,320371986,17739056537,18059428523
2021-07-12,All-Floors,Non-HKUST,96,922,532070,856330754,81282032302,82138363056
2021-07-12,All-Floors,Others(HKUST),26,379,273629,67076267,3045012071,3112088338
2021-07-12,All-Floors,RPG,547,4077,1975245,10655812385,68083840497,78739652882
2021-07-12,All-Floors,Staff,686,5945,2033820,965012322,26737605824,27702618146
2021-07-12,All-Floors,TPG,67,1539,971411,749359719,32636252012,33385611731
2021-07-12,All-Floors,Total,1941,19408,9362356,17081891488,342962179658,360044071146
2021-07-12,All-Floors,UG,493,6140,3284835,3467928055,113438380415,116906308470
2021-07-12,G,Alumni,15,112,43614,70696957,3456386675,3527083632
2021-07-12,G,Non-HKUST,32,269,117536,118151247,3847710753,3965862000
2021-07-12,G,Others(HKUST),8,80,30880,18695155,820376581,839071736
2021-07-12,G,RPG,138,1262,431430,484715015,15637850886,16122565901
2021-07-12,G,Staff,173,1519,484830,163485325,5352675172,5516160497
2021-07-12,G,TPG,51,643,333376,378112973,12641306274,13019419247
2021-07-12,G,Total,614,5613,1847148,1540320755,53038446515,54578767270
2021-07-12,G,UG,197,1728,405482,306464083,11282140174,11588604257
2021-07-12,LG1,Alumni,12,176,143388,152752347,8033945423,8186697770
2021-07-12,LG1,Non-HKUST,26,183,181054,386159475,11311975564,11698135039
2021-07-12,LG1,Others(HKUST),11,42,28825,3981122,116297821,120278943
2021-07-12,LG1,RPG,152,1311,849741,6076730783,35306509424,41383240207
2021-07-12,LG1,Staff,140,907,313999,66650031,3687940600,3754590631
2021-07-12,LG1,TPG,27,333,213278,142224884,7063782531,7206007415
2021-07-12,LG1,Total,647,4951,3290197,8832031376,118493970331,127326001707
2021-07-12,LG1,UG,279,1999,1559912,2003532734,52973518968,54977051702
2021-07-12,LG3,Alumni,12,91,89620,48281952,3477272238,3525554190
2021-07-12,LG3,Non-HKUST,65,232,106813,158923600,13271221668,13430145268
2021-07-12,LG3,Others(HKUST),19,90,18094,9202444,265993196,275195640
2021-07-12,LG3,RPG,419,950,300632,3730873553,9283081836,13013955389
2021-07-12,LG3,Staff,524,1546,280993,425212606,8126933577,8552146183
2021-07-12,LG3,TPG,33,202,111448,30193442,1760590211,1790783653
2021-07-12,LG3,Total,1366,4621,1605063,5037223581,64904580470,69941804051
2021-07-12,LG3,UG,294,1510,697463,634535984,28719487744,29354023728
2021-07-12,LG4,Alumni,6,24,1850,99824,120248,220072
2021-07-12,LG4,Non-HKUST,29,134,80496,91045410,51886725882,51977771292
2021-07-12,LG4,Others(HKUST),12,74,96412,5107454,646242551,651350005
2021-07-12,LG4,RPG,172,474,309035,325216474,6648170300,6973386774
2021-07-12,LG4,Staff,238,721,160325,170944256,5863259215,6034203471
2021-07-12,LG4,TPG,28,186,168072,76923627,3940255933,4017179560
2021-07-12,LG4,Total,650,2354,1258281,1044035330,84684821361,85728856691
2021-07-12,LG4,UG,165,741,442091,374698285,15700047232,16074745517
2021-07-13,1,Alumni,2,10,18597,37508457,2921652726,2959161183
2021-07-13,1,Non-HKUST,10,63,34133,35441737,866894096,902335833
2021-07-13,1,Others(HKUST),3,86,87543,43282469,1091275325,1134557794
2021-07-13,1,RPG,13,83,86739,32152215,1306104276,1338256491
2021-07-13,1,Staff,88,1341,804772,172693975,4667958571,4840652546
2021-07-13,1,TPG,12,152,185038,144479354,11573217907,11717697261
2021-07-13,1,Total,163,2036,1495642,624342261,29798997689,30423339950
2021-07-13,1,UG,35,301,278820,158784054,7371894788,7530678842
2021-07-13,All-Floors,Alumni,28,490,392526,1024747147,35311334103,36336081250
2021-07-13,All-Floors,Non-HKUST,108,1066,580733,851697606,25165888284,26017585890
2021-07-13,All-Floors,Others(HKUST),31,330,242804,62705850,3061562940,3124268790
2021-07-13,All-Floors,RPG,575,3832,1972779,3421052015,83924664624,87345716639
2021-07-13,All-Floors,Staff,718,6131,2053923,1828788795,29861549208,31690338003
2021-07-13,All-Floors,TPG,67,1510,1042168,2061797919,53682554258,55744352177
2021-07-13,All-Floors,Total,2098,21377,10407922,13778489886,399973924918,413752414804
2021-07-13,All-Floors,UG,571,8018,4122989,4527700554,168966371501,173494072055
2021-07-13,G,Alumni,13,219,134484,188051393,8302563807,8490615200
2021-07-13,G,Non-HKUST,38,320,145954,162940284,3950057835,4112998119
2021-07-13,G,Others(HKUST),6,38,10114,1212636,6795234,8007870
2021-07-13,G,RPG,114,1175,399208,378691879,11275064017,11653755896
2021-07-13,G,Staff,185,1535,419608,380436534,6999669216,7380105750
2021-07-13,G,TPG,52,665,275048,720713345,16195907474,16916620819
2021-07-13,G,Total,655,6346,1945973,2363330977,61593072166,63956403143
2021-07-13,G,UG,247,2394,561557,531284906,14863014583,15394299489
2021-07-13,LG1,Alumni,11,126,131913,754675263,20858656527,21613331790
2021-07-13,LG1,Non-HKUST,32,326,215062,467623644,11511482972,11979106616
2021-07-13,LG1,Others(HKUST),9,39,41781,306326,2464633,2770959
2021-07-13,LG1,RPG,148,1202,840858,1386956053,48690839123,50077795176
2021-07-13,LG1,Staff,131,974,382697,183105965,3985696894,4168802859
2021-07-13,LG1,TPG,29,326,285209,1034803064,9213222131,10248025195
2021-07-13,LG1,Total,658,5552,3697047,6208765732,174185880623,180394646355
2021-07-13,LG1,UG,298,2559,1799527,2381295417,79923518343,82304813760
2021-07-13,LG3,Alumni,14,114,76145,19496080,530129411,549625491
2021-07-13,LG3,Non-HKUST,61,240,159520,152120641,6577989322,6730109963
2021-07-13,LG3,Others(HKUST),24,108,29062,15413394,1892503985,1907917379
2021-07-13,LG3,RPG,463,956,314172,1370520382,14810366282,16180886664
2021-07-13,LG3,Staff,549,1565,272447,474842399,9933710954,10408553353
2021-07-13,LG3,TPG,37,169,92010,28408737,510581887,538990624
2021-07-13,LG3,Total,1496,4915,1873184,2901610136,72399506261,75301116397
2021-07-13,LG3,UG,348,1763,929828,840808503,38144224420,38985032923
2021-07-13,LG4,Alumni,8,21,31387,25015954,2698331632,2723347586
2021-07-13,LG4,Non-HKUST,28,117,26064,33571300,2259464059,2293035359
2021-07-13,LG4,Others(HKUST),14,59,74304,2491025,68523763,71014788
2021-07-13,LG4,RPG,136,416,331802,252731486,7842290926,8095022412
2021-07-13,LG4,Staff,228,716,174399,617709922,4274513573,4892223495
2021-07-13,LG4,TPG,28,198,204863,133393419,16189624859,16323018278
2021-07-13,LG4,Total,654,2528,1396076,1680440780,61996468179,63676908959
2021-07-13,LG4,UG,212,1001,553257,615527674,28663719367,29279247041
2021-07-14,1,Alumni,1,6,17109,40470087,1402206251,1442676338
2021-07-14,1,Non-HKUST,4,119,36558,8104532,456888983,464993515
2021-07-14,1,Others(HKUST),4,56,70704,24074216,2444998529,2469072745
2021-07-14,1,RPG,12,64,67951,52229199,3083771508,3136000707
2021-07-14,1,Staff,80,1279,796493,294415148,9330119649,9624534797
2021-07-14,1,TPG,6,188,127039,74960766,5210183750,5285144516
2021-07-14,1,Total,134,1939,1399996,655412895,37273595048,37929007943
2021-07-14,1,UG,27,227,284142,161158947,15345426378,15506585325
2021-07-14,All-Floors,Alumni,20,399,284106,443829597,14890942042,15334771639
2021-07-14,All-Floors,Non-HKUST,113,1034,586404,1220272614,52964234591,54184507205
2021-07-14,All-Floors,Others(HKUST),27,376,199984,71734563,4088927117,4160661680
2021-07-14,All-Floors,RPG,546,4091,2042840,6364227379,81863399991,88227627370
2021-07-14,All-Floors,Staff,721,6273,2146817,1392817534,40011428655,41404246189
2021-07-14,All-Floors,TPG,61,1483,960842,1388116355,48818414583,50206530938
2021-07-14,All-Floors,Total,2043,22063,10347850,19045963678,536631306305,555677269983
2021-07-14,All-Floors,UG,555,8407,4126857,8164965636,293993959326,302158924962
2021-07-14,G,Alumni,12,141,50103,38021742,2517104373,2555126115
2021-07-14,G,Non-HKUST,37,257,119978,312961718,6212184776,6525146494
2021-07-14,G,Others(HKUST),8,49,11131,6164165,80290556,86454721
2021-07-14,G,RPG,128,1302,502188,3785125349,30768255874,34553381223
2021-07-14,G,Staff,185,1672,454714,291445871,7996139512,8287585383
2021-07-14,G,TPG,44,646,372983,845461226,12551900456,13397361682
2021-07-14,G,Total,659,6586,2096773,6537120889,91665564576,98202685465
2021-07-14,G,UG,245,2519,585676,1257940818,31539689029,32797629847
2021-07-14,LG1,Alumni,6,116,61969,238468553,1119972017,1358440570
2021-07-14,LG1,Non-HKUST,26,207,201653,596177697,12181663382,12777841079
2021-07-14,LG1,Others(HKUST),10,51,56034,12091097,137389829,149480926
2021-07-14,LG1,RPG,151,1246,813947,1006180634,23172088734,24178269368
2021-07-14,LG1,Staff,133,924,353575,226691365,6591568480,6818259845
2021-07-14,LG1,TPG,26,290,224078,278108337,11353444582,11631552919
2021-07-14,LG1,Total,664,5321,3381178,6893819409,244357004389,251250823798
2021-07-14,LG1,UG,312,2487,1669922,4536101726,189800877365,194336979091
2021-07-14,LG3,Alumni,13,46,43873,45908208,5099599355,5145507563
2021-07-14,LG3,Non-HKUST,70,313,149884,188541476,9168998779,9357540255
2021-07-14,LG3,Others(HKUST),20,175,32348,24856223,1029125844,1053982067
2021-07-14,LG3,RPG,418,1031,394784,1199268604,13168053175,14367321779
2021-07-14,LG3,Staff,567,1632,345086,391308219,12188543906,12579852125
2021-07-14,LG3,TPG,37,188,102761,90041386,4812747229,4902788615
2021-07-14,LG3,Total,1438,5247,1890551,3426617641,75717473879,79144091520
2021-07-14,LG3,UG,313,1862,821815,1486693525,30250405591,31737099116
2021-07-14,LG4,Alumni,10,90,111052,80961007,4752060046,4833021053
2021-07-14,LG4,Non-HKUST,43,138,78331,114487191,24944498671,25058985862
2021-07-14,LG4,Others(HKUST),13,45,29767,4548862,397122359,401671221
2021-07-14,LG4,RPG,153,448,263970,321423593,11671230700,11992654293
2021-07-14,LG4,Staff,267,766,196949,188956931,3905057108,4094014039
2021-07-14,LG4,TPG,31,171,133981,99544640,14890138566,14989683206
2021-07-14,LG4,Total,726,2970,1579352,1532992844,87617668413,89150661257
2021-07-14,LG4,UG,209,1312,765302,723070620,27057560963,27780631583
2021-07-15,1,Alumni,1,5,17371,57620422,2939519862,2997140284
2021-07-15,1,Non-HKUST,12,46,43532,243643191,1982993523,2226636714
2021-07-15,1,Others(HKUST),5,150,84865,22638097,752419463,775057560
2021-07-15,1,RPG,21,112,139134,257004510,5185694487,5442698997
2021-07-15,1,Staff,87,1342,891860,341588840,8864932663,9206521503
2021-07-15,1,TPG,10,118,130815,67077794,2887143673,2954221467
2021-07-15,1,Total,174,2108,1566680,1636559037,36473965217,38110524254
2021-07-15,1,UG,38,335,259103,646986183,13861261546,14508247729
2021-07-15,All-Floors,Alumni,29,530,324101,504051745,16939762792,17443814537
2021-07-15,All-Floors,Non-HKUST,113,705,427675,872228454,26460639284,27332867738
2021-07-15,All-Floors,Others(HKUST),27,441,183650,34213245,931130385,965343630
2021-07-15,All-Floors,RPG,548,3744,1948125,4399597138,77411419363,81811016501
2021-07-15,All-Floors,Staff,673,5837,2018053,1683207910,67375928752,69059136662
2021-07-15,All-Floors,TPG,50,1373,928366,2193379404,31431200578,33624579982
2021-07-15,All-Floors,Total,1999,21126,10027763,18091397247,438655106823,456746504070
2021-07-15,All-Floors,UG,559,8496,4197793,8404719351,218105025669,226509745020
2021-07-15,G,Alumni,16,128,35335,39404177,880003675,919407852
2021-07-15,G,Non-HKUST,40,181,81167,70111817,7347892463,7418004280
2021-07-15,G,Others(HKUST),7,67,24668,1183455,38965195,40148650
2021-07-15,G,RPG,115,1044,435955,555713178,8785619544,9341332722
2021-07-15,G,Staff,168,1518,348614,425036269,5554892421,5979928690
2021-07-15,G,TPG,40,602,289748,200078650,7009880872,7209959522
2021-07-15,G,Total,639,6113,1966445,1976335901,57181679837,59158015738
2021-07-15,G,UG,253,2573,750958,684808355,27564425667,28249234022
2021-07-15,LG1,Alumni,10,140,117718,215434777,8307303363,8522738140
2021-07-15,LG1,Non-HKUST,27,128,107060,288517780,5008559394,5297077174
2021-07-15,LG1,Others(HKUST),8,27,24969,76987,272348,349335
2021-07-15,LG1,RPG,131,1146,712502,2892747562,48098456952,50991204514
2021-07-15,LG1,Staff,119,599,247367,116949785,4262496215,4379446000
2021-07-15,LG1,TPG,22,350,243245,1662621398,8469809621,10132431019
2021-07-15,LG1,Total,621,5257,3396870,9826163980,197804580130,207630744110
2021-07-15,LG1,UG,304,2867,1944009,4649815691,123657682237,128307497928
2021-07-15,LG3,Alumni,15,131,55193,68245244,1697534491,1765779735
2021-07-15,LG3,Non-HKUST,63,265,148647,244532575,7902884194,8147416769
2021-07-15,LG3,Others(HKUST),20,99,24202,9034407,116971713,126006120
2021-07-15,LG3,RPG,425,896,308803,426005441,7633391065,8059396506
2021-07-15,LG3,Staff,523,1673,335559,712637602,46481342987,47193980589
2021-07-15,LG3,TPG,26,204,174997,231378351,5164639930,5396018281
2021-07-15,LG3,Total,1401,4963,1782217,3598941596,97779315933,101378257529
2021-07-15,LG3,UG,329,1695,734816,1907107976,28782551553,30689659529
2021-07-15,LG4,Alumni,13,126,98484,123347125,3115401401,3238748526
2021-07-15,LG4,Non-HKUST,40,85,47269,25423091,4218309710,4243732801
2021-07-15,LG4,Others(HKUST),11,98,24946,1280299,22501666,23781965
2021-07-15,LG4,RPG,185,546,351731,268126447,7708257315,7976383762
2021-07-15,LG4,Staff,237,705,194653,86995414,2212264466,2299259880
2021-07-15,LG4,TPG,21,99,89561,32223211,7899726482,7931949693
2021-07-15,LG4,Total,725,2685,1315551,1053396733,49415565706,50468962439
2021-07-15,LG4,UG,218,1026,508907,516001146,24239104666,24755105812
2021-07-16,1,Alumni,4,28,39602,52948385,2403524046,2456472431
2021-07-16,1,Non-HKUST,7,14,6436,414161,5747659,6161820
2021-07-16,1,Others(HKUST),3,32,41387,1720584,83463424,85184008
2021-07-16,1,RPG,11,99,83386,53471230,1828336393,1881807623
2021-07-16,1,Staff,71,1032,632889,142892956,4935848756,5078741712
2021-07-16,1,TPG,6,56,58499,25143499,3790143324,3815286823
2021-07-16,1,Total,132,1505,1121293,526794506,30397301127,30924095633
2021-07-16,1,UG,30,244,259094,250203691,17350237525,17600441216
2021-07-16,All-Floors,Alumni,19,430,329036,511136352,41366678350,41877814702
2021-07-16,All-Floors,Non-HKUST,92,1048,584731,1475665872,27102446662,28578112534
2021-07-16,All-Floors,Others(HKUST),27,291,136263,111888203,2420554255,2532442458
2021-07-16,All-Floors,RPG,495,3500,1735842,1720878084,49433764034,51154642118
2021-07-16,All-Floors,Staff,616,5309,1668900,2893633174,26202843377,29096476551
2021-07-16,All-Floors,TPG,46,997,736796,589626479,36716256999,37305883478
2021-07-16,All-Floors,Total,1741,18148,8685478,13045574180,396222385179,409267959359
2021-07-16,All-Floors,UG,446,6573,3493910,5742746016,212979841502,218722587518
2021-07-16,G,Alumni,13,147,61311,226190551,5085192919,5311383470
2021-07-16,G,Non-HKUST,41,228,132545,256499083,2364709780,2621208863
2021-07-16,G,Others(HKUST),6,33,11711,46988424,80058047,127046471
2021-07-16,G,RPG,108,1192,479472,430439745,15605048943,16035488688
2021-07-16,G,Staff,148,1311,380065,396082182,5474389578,5870471760
2021-07-16,G,TPG,36,452,223192,136307256,8820641329,8956948585
2021-07-16,G,Total,537,5415,1883307,2719477136,86301395349,89020872485
2021-07-16,G,UG,185,2052,595011,1226969895,48871354753,50098324648
2021-07-16,LG1,Alumni,10,84,46822,119180996,21351432523,21470613519
2021-07-16,LG1,Non-HKUST,33,270,205524,557489420,15467921991,16025411411
2021-07-16,LG1,Others(HKUST),9,33,35774,2435136,98292805,100727941
2021-07-16,LG1,RPG,118,901,577662,404055190,16385689077,16789744267
2021-07-16,LG1,Staff,120,822,256932,469531873,5404616979,5874148852
2021-07-16,LG1,TPG,19,237,212212,167053217,7882858435,8049911652
2021-07-16,LG1,Total,572,4428,2867906,4653340256,153846034457,158499374713
2021-07-16,LG1,UG,263,2081,1532980,2933594424,87255222647,90188817071
2021-07-16,LG3,Alumni,10,65,61908,22989607,2888949822,2911939429
2021-07-16,LG3,Non-HKUST,57,404,196247,619317998,6177072887,6796390885
2021-07-16,LG3,Others(HKUST),20,153,27804,60461612,2156368665,2216830277
2021-07-16,LG3,RPG,368,907,395609,686734117,12852582769,13539316886
2021-07-16,LG3,Staff,466,1334,233504,1737743907,7329236094,9066980001
2021-07-16,LG3,TPG,25,187,192926,58558915,1913386740,1971945655
2021-07-16,LG3,Total,1202,4249,1662027,3822863994,76986952434,80809816428
2021-07-16,LG3,UG,256,1199,554029,637057838,43669355457,44306413295
2021-07-16,LG4,Alumni,9,106,119393,89826813,9637579040,9727405853
2021-07-16,LG4,Non-HKUST,29,132,43979,41945210,3086994345,3128939555
2021-07-16,LG4,Others(HKUST),10,40,19587,282447,2371314,2653761
2021-07-16,LG4,RPG,139,401,199713,146177802,2762106852,2908284654
2021-07-16,LG4,Staff,215,810,165510,147382256,3058751970,3206134226
2021-07-16,LG4,TPG,23,65,49967,202563592,14309227171,14511790763
2021-07-16,LG4,Total,583,2551,1150945,1323098288,48690701812,50013800100
2021-07-16,LG4,UG,158,997,552796,694920168,15833671120,16528591288
2021-07-17,1,Alumni,4,18,19350,706363,11573373,12279736
2021-07-17,1,Non-HKUST,2,11,7001,1339826,10146269,11486095
2021-07-17,1,Others(HKUST),2,21,27627,16271049,471044993,487316042
2021-07-17,1,RPG,9,50,58283,16363882,1662491432,1678855314
2021-07-17,1,Staff,10,48,41049,44117572,244528397,288645969
2021-07-17,1,TPG,2,2,59,1243631,61747452,62991083
2021-07-17,1,Total,46,269,249928,130720017,4522909681,4653629698
2021-07-17,1,UG,17,119,96559,50677694,2061377765,2112055459
2021-07-17,All-Floors,Alumni,29,434,203441,83538773,4329348479,4412887252
2021-07-17,All-Floors,Non-HKUST,68,445,257823,510946831,8157408659,8668355490
2021-07-17,All-Floors,Others(HKUST),14,128,88060,34504438,1046566901,1081071339
2021-07-17,All-Floors,RPG,312,1288,576657,610996833,21630559160,22241555993
2021-07-17,All-Floors,Staff,205,946,273523,750729288,3895142623,4645871911
2021-07-17,All-Floors,TPG,26,202,141542,69237332,3641422144,3710659476
2021-07-17,All-Floors,Total,1110,6952,2980332,4366930108,106116675142,110483605250
2021-07-17,All-Floors,UG,456,3509,1439286,2306976613,63416227176,65723203789
2021-07-17,G,Alumni,19,156,48972,30722789,1146465122,1177187911
2021-07-17,G,Non-HKUST,23,115,56277,86484933,1787285638,1873770571
2021-07-17,G,Others(HKUST),2,15,6523,7654,15749,23403
2021-07-17,G,RPG,51,409,152172,102922700,2462217369,2565140069
2021-07-17,G,Staff,24,214,45007,6973491,102274710,109248201
2021-07-17,G,TPG,10,95,65514,30872510,1138484043,1169356553
2021-07-17,G,Total,253,1861,499367,388181223,9238045124,9626226347
2021-07-17,G,UG,124,857,124902,130197146,2601302493,2731499639
2021-07-17,LG1,Alumni,10,91,25219,11169026,743586709,754755735
2021-07-17,LG1,Non-HKUST,16,73,53925,193356886,3009747272,3203104158
2021-07-17,LG1,Others(HKUST),4,14,20575,3531665,216263384,219795049
2021-07-17,LG1,RPG,81,312,199418,134484939,9290192800,9424677739
2021-07-17,LG1,Staff,49,97,15857,26823066,162159386,188982452
2021-07-17,LG1,TPG,8,42,17766,1961167,757557514,759518681
2021-07-17,LG1,Total,407,1910,1111415,1750931261,48618049629,50368980890
2021-07-17,LG1,UG,239,1281,778655,1379604512,34438542564,35818147076
2021-07-17,LG3,Alumni,18,128,81828,22129356,546354466,568483822
2021-07-17,LG3,Non-HKUST,43,146,63420,158113495,2366173543,2524287038
2021-07-17,LG3,Others(HKUST),12,54,9940,10056006,189571394,199627400
2021-07-17,LG3,RPG,222,373,112099,52755630,1715841716,1768597346
2021-07-17,LG3,Staff,154,415,86569,651728437,2876959454,3528687891
2021-07-17,LG3,TPG,13,32,19492,10274350,651039673,661314023
2021-07-17,LG3,Total,739,2022,639560,1504695014,28095128352,29599823366
2021-07-17,LG3,UG,277,874,266212,599637740,19749188106,20348825846
2021-07-17,LG4,Alumni,10,41,28072,18811239,1881368809,1900180048
2021-07-17,LG4,Non-HKUST,24,100,77200,71651691,984055937,1055707628
2021-07-17,LG4,Others(HKUST),6,24,23395,4638064,169671381,174309445
2021-07-17,LG4,RPG,72,144,54685,304469682,6499815843,6804285525
2021-07-17,LG4,Staff,52,172,85041,21086722,509220676,530307398
2021-07-17,LG4,TPG,7,31,38711,24885674,1032593462,1057479136
2021-07-17,LG4,Total,301,890,480062,592402593,15642542356,16234944949
2021-07-17,LG4,UG,130,378,172958,146859521,4565816248,4712675769
2021-07-18,1,Alumni,4,19,25949,13606533,1843343698,1856950231
2021-07-18,1,Non-HKUST,2,4,21522,11390312,686391473,697781785
2021-07-18,1,Others(HKUST),2,24,85458,46854,431955,478809
2021-07-18,1,RPG,10,41,70442,31330045,1230782519,1262112564
2021-07-18,1,Staff,5,29,44091,22210869,603916148,626127017
2021-07-18,1,TPG,1,6,8128,5173121,1071143097,1076316218
2021-07-18,1,Total,34,164,337394,122276479,9386493917,9508770396
2021-07-18,1,UG,10,41,81804,38518745,3950485027,3989003772
2021-07-18,All-Floors,Alumni,37,598,367934,375087035,33968412492,34343499527
2021-07-18,All-Floors,Non-HKUST,65,341,412527,618985661,30255569576,30874555237
2021-07-18,All-Floors,Others(HKUST),11,380,377907,48660489,5252882748,5301543237
2021-07-18,All-Floors,RPG,309,1412,912626,1180881368,27418928335,28599809703
2021-07-18,All-Floors,Staff,138,923,255589,716462730,11152692118,11869154848
2021-07-18,All-Floors,TPG,25,194,235171,142755128,5364092853,5506847981
2021-07-18,All-Floors,Total,995,7093,4701109,5996109497,228727395617,234723505114
2021-07-18,All-Floors,UG,410,3245,2139355,2913277086,115314817495,118228094581
2021-07-18,G,Alumni,20,178,100148,85151367,21025229118,21110380485
2021-07-18,G,Non-HKUST,20,106,97924,291994659,8307189928,8599184587
2021-07-18,G,Others(HKUST),3,19,50005,3315581,13870482,17186063
2021-07-18,G,RPG,43,381,217666,144063437,3650868467,3794931904
2021-07-18,G,Staff,14,237,50425,42287098,1205316514,1247603612
2021-07-18,G,TPG,12,83,106218,81862728,2605118354,2686981082
2021-07-18,G,Total,209,1744,914852,963892436,66283586030,67247478466
2021-07-18,G,UG,97,740,292466,315217566,29475993167,29791210733
2021-07-18,LG1,Alumni,9,55,16999,69181953,4315378054,4384560007
2021-07-18,LG1,Non-HKUST,12,36,65482,91482047,7374653369,7466135416
2021-07-18,LG1,Others(HKUST),5,43,202456,6990031,43560606,50550637
2021-07-18,LG1,RPG,79,355,311397,629471115,6574313905,7203785020
2021-07-18,LG1,Staff,33,84,19558,95536208,813216939,908753147
2021-07-18,LG1,TPG,3,20,49188,9207539,92978440,102185979
2021-07-18,LG1,Total,311,1624,1655620,2159720363,53646085590,55805805953
2021-07-18,LG1,UG,170,1031,990540,1257851470,34431984277,35689835747
2021-07-18,LG3,Alumni,26,224,68586,55489129,1408020012,1463509141
2021-07-18,LG3,Non-HKUST,40,93,114820,108730607,6759391170,6868121777
2021-07-18,LG3,Others(HKUST),6,131,9840,4157462,16795728,20953190
2021-07-18,LG3,RPG,252,478,230195,327920531,14288419215,14616339746
2021-07-18,LG3,Staff,106,403,104735,529961046,8176725922,8706686968
2021-07-18,LG3,TPG,15,35,13954,10342197,630548977,640891174
2021-07-18,LG3,Total,724,2171,864653,2013003373,66275679430,68288682803
2021-07-18,LG3,UG,279,807,322523,976402401,34995778406,35972180807
2021-07-18,LG4,Alumni,19,122,156252,151658053,5376441610,5528099663
2021-07-18,LG4,Non-HKUST,25,102,112779,115388036,7127943636,7243331672
2021-07-18,LG4,Others(HKUST),8,163,30148,34150561,5178223977,5212374538
2021-07-18,LG4,RPG,87,157,82926,48096240,1674544229,1722640469
2021-07-18,LG4,Staff,52,170,36780,26467509,353516595,379984104
2021-07-18,LG4,TPG,12,50,57683,36169543,964303985,1000473528
2021-07-18,LG4,Total,336,1390,928590,737216846,33135550650,33872767496
2021-07-18,LG4,UG,133,626,452022,325286904,12460576618,12785863522
2021-07-19,1,Alumni,1,140,54167,53222629,995266002,1048488631
2021-07-19,1,Non-HKUST,7,144,68913,39277058,1775120350,1814397408
2021-07-19,1,Others(HKUST),3,27,138605,40753416,1424958566,1465711982
2021-07-19,1,RPG,16,131,275848,192580483,6769750884,6962331367
2021-07-19,1,Staff,73,1340,1258806,434097116,7690812344,8124909460
2021-07-19,1,TPG,8,196,137502,267251228,5858281472,6125532700
2021-07-19,1,Total,144,2578,2805032,3304975744,61299787269,64604763013
2021-07-19,1,UG,36,600,871191,2277793814,36785597651,39063391465
2021-07-19,All-Floors,Alumni,16,480,333446,608482037,16219651470,16828133507
2021-07-19,All-Floors,Non-HKUST,82,707,507557,404015808,13114847777,13518863585
2021-07-19,All-Floors,Others(HKUST),19,277,552934,160122384,7275714462,7435836846
2021-07-19,All-Floors,RPG,497,3626,2678701,6631885021,86826598145,93458483166
2021-07-19,All-Floors,Staff,669,6132,2394905,1988576904,35088985832,37077562736
2021-07-19,All-Floors,TPG,46,1086,1053107,1326468952,66211976736,67538445688
2021-07-19,All-Floors,Total,1807,19329,12956461,21387266282,501462650168,522849916450
2021-07-19,All-Floors,UG,478,7021,5435811,10267715176,276724875746,286992590922
2021-07-19,G,Alumni,8,110,29117,75477589,2057798170,2133275759
2021-07-19,G,Non-HKUST,25,124,129656,83514497,1404107330,1487621827
2021-07-19,G,Others(HKUST),5,46,89232,38224148,1489097505,1527321653
2021-07-19,G,RPG,112,1097,539610,546488796,18700905497,19247394293
2021-07-19,G,Staff,149,1461,412766,168154098,7380373732,7548527830
2021-07-19,G,TPG,33,395,386319,362658002,34221569104,34584227106
2021-07-19,G,Total,539,5250,2037630,2388434820,104331153380,106719588200
2021-07-19,G,UG,207,2017,450930,1113917690,39077302042,40191219732
2021-07-19,LG1,Alumni,6,88,80955,86024260,6484574691,6570598951
2021-07-19,LG1,Non-HKUST,19,130,163665,186254167,4542377669,4728631836
2021-07-19,LG1,Others(HKUST),6,22,200277,18681917,1882339815,1901021732
2021-07-19,LG1,RPG,85,956,1002489,4090240066,31481289797,35571529863
2021-07-19,LG1,Staff,97,652,235973,78541038,5801511991,5880053029
2021-07-19,LG1,TPG,13,241,245795,284458480,10322014710,10606473190
2021-07-19,LG1,Total,453,4269,4361728,10093650987,198060760161,208154411148
2021-07-19,LG1,UG,227,2180,2432574,5349451059,137546651488,142896102547
2021-07-19,LG3,Alumni,12,78,95242,341179509,3593289740,3934469249
2021-07-19,LG3,Non-HKUST,47,182,108805,52207268,4755344260,4807551528
2021-07-19,LG3,Others(HKUST),12,135,42117,37967633,2210255961,2248223594
2021-07-19,LG3,RPG,407,981,461137,1552310888,20550391567,22102702455
2021-07-19,LG3,Staff,530,1711,261948,1060509252,7955673273,9016182525
2021-07-19,LG3,TPG,25,88,108824,75249987,4832522583,4907772570
2021-07-19,LG3,Total,1354,4486,2068399,4049878672,82987299986,87037178658
2021-07-19,LG3,UG,321,1311,990326,930454135,39089822602,40020276737
2021-07-19,LG4,Alumni,9,64,73965,52578050,3088722867,3141300917
2021-07-19,LG4,Non-HKUST,28,127,36518,42762818,637898168,680660986
2021-07-19,LG4,Others(HKUST),13,47,82703,24495270,269062615,293557885
2021-07-19,LG4,RPG,164,461,399617,250264788,9324260400,9574525188
2021-07-19,LG4,Staff,250,968,225412,247275400,6260614492,6507889892
2021-07-19,LG4,TPG,20,166,174667,336851255,10977588867,11314440122
2021-07-19,LG4,Total,676,2746,1683672,1550326059,54783649372,56333975431
2021-07-19,LG4,UG,192,913,690790,596098478,24225501963,24821600441
2021-07-20,1,Alumni,3,44,54254,54152450,748672747,802825197
2021-07-20,1,Non-HKUST,7,34,47766,15651482,369481622,385133104
2021-07-20,1,Others(HKUST),5,49,149924,43436876,561973486,605410362
2021-07-20,1,RPG,26,130,219460,256774595,4915310531,5172085126
2021-07-20,1,Staff,77,1671,1139226,278601578,6448912538,6727514116
2021-07-20,1,TPG,7,113,70536,71703381,7723787472,7795490853
2021-07-20,1,Total,182,2403,2249033,1143164173,35042231054,36185395227
2021-07-20,1,UG,57,362,567867,422843811,14274092658,14696936469
2021-07-20,All-Floors,Alumni,20,555,489104,381712651,11145106487,11526819138
2021-07-20,All-Floors,Non-HKUST,84,645,434025,1711290672,29223134101,30934424773
2021-07-20,All-Floors,Others(HKUST),21,620,468948,87821264,2229715655,2317536919
2021-07-20,All-Floors,RPG,492,3620,2090225,4177847448,79274530083,83452377531
2021-07-20,All-Floors,Staff,633,6014,2509362,1578974878,36401864306,37980839184
2021-07-20,All-Floors,TPG,34,894,763910,884486605,30534039294,31418525899
2021-07-20,All-Floors,Total,1766,19623,11764956,15414342405,391223369671,406637712076
2021-07-20,All-Floors,UG,482,7275,5009382,6592208887,202414979745,209007188632
2021-07-20,G,Alumni,13,181,95150,79846922,2289471983,2369318905
2021-07-20,G,Non-HKUST,30,143,104869,76738123,2187826072,2264564195
2021-07-20,G,Others(HKUST),5,104,124320,15419294,550690743,566110037
2021-07-20,G,RPG,96,1076,392506,568639140,17672526510,18241165650
2021-07-20,G,Staff,151,1695,548928,191238127,9710792165,9902030292
2021-07-20,G,TPG,22,361,307060,252279942,12926048139,13178328081
2021-07-20,G,Total,510,5602,2171847,2387406014,73707661103,76095067117
2021-07-20,G,UG,193,2042,599014,1203244466,28370305491,29573549957
2021-07-20,LG1,Alumni,10,115,108110,133859441,2758542326,2892401767
2021-07-20,LG1,Non-HKUST,19,147,101502,175215578,3976558020,4151773598
2021-07-20,LG1,Others(HKUST),6,118,68100,2228692,40090950,42319642
2021-07-20,LG1,RPG,78,849,723145,1439406523,34148375002,35587781525
2021-07-20,LG1,Staff,84,586,256593,222403831,3888800914,4111204745
2021-07-20,LG1,TPG,15,212,209505,467281876,4647146328,5114428204
2021-07-20,LG1,Total,358,4201,3854991,6290461839,147240150681,153530612520
2021-07-20,LG1,UG,146,2174,2388036,3850065898,97780637141,101630703039
2021-07-20,LG3,Alumni,10,57,51454,20665172,1284571233,1305236405
2021-07-20,LG3,Non-HKUST,50,240,110943,1315260466,4924652921,6239913387
2021-07-20,LG3,Others(HKUST),14,149,49015,623562,6425237,7048799
2021-07-20,LG3,RPG,347,895,422796,1112489027,9085246692,10197735719
2021-07-20,LG3,Staff,404,1123,275162,497080495,7520881735,8017962230
2021-07-20,LG3,TPG,20,132,163684,86343506,5054588087,5140931593
2021-07-20,LG3,Total,1166,4113,1925835,3749536978,65629608587,69379145565
2021-07-20,LG3,UG,321,1517,852781,717074750,37753242682,38470317432
2021-07-20,LG4,Alumni,9,158,180136,93188666,4063848198,4157036864
2021-07-20,LG4,Non-HKUST,34,81,68945,128425023,17764615466,17893040489
2021-07-20,LG4,Others(HKUST),15,200,77589,26112840,1070535239,1096648079
2021-07-20,LG4,RPG,290,670,332318,800538163,13453071348,14253609511
2021-07-20,LG4,Staff,391,939,289453,389650847,8832476954,9222127801
2021-07-20,LG4,TPG,14,76,13125,6877900,182469268,189347168
2021-07-20,LG4,Total,1029,3304,1563250,1843773401,69603718246,71447491647
2021-07-20,LG4,UG,276,1180,601684,398979962,24236701773,24635681735
2021-07-21,1,Alumni,2,4,25785,66145581,5609140820,5675286401
2021-07-21,1,Non-HKUST,8,134,43907,18345408,3079736102,3098081510
2021-07-21,1,Others(HKUST),7,44,237206,58162812,2864754080,2922916892
2021-07-21,1,RPG,35,165,202062,147137070,5850524854,5997661924
2021-07-21,1,Staff,97,1507,1152772,379826581,12169815234,12549641815
2021-07-21,1,TPG,10,112,116893,117886671,7428868767,7546755438
2021-07-21,1,Total,222,2165,2164472,1125767714,55409403831,56535171545
2021-07-21,1,UG,63,199,385847,338263591,18406563974,18744827565
2021-07-21,All-Floors,Alumni,16,224,260531,361068295,11248079834,11609148129
2021-07-21,All-Floors,Non-HKUST,96,725,513825,502874019,31926818329,32429692348
2021-07-21,All-Floors,Others(HKUST),29,432,534684,193861804,8272486520,8466348324
2021-07-21,All-Floors,RPG,504,3589,2375168,5726054597,110803012240,116529066837
2021-07-21,All-Floors,Staff,642,5866,2563560,1472194058,43092425977,44564620035
2021-07-21,All-Floors,TPG,37,799,851932,627475578,30820672369,31448147947
2021-07-21,All-Floors,Total,1747,17933,11804502,16101479112,499057015650,515158494762
2021-07-21,All-Floors,UG,423,6298,4704802,7217950761,262893520381,270111471142
2021-07-21,G,Alumni,6,58,33885,81980511,1346208471,1428188982
2021-07-21,G,Non-HKUST,26,100,71294,49700785,909206729,958907514
2021-07-21,G,Others(HKUST),12,112,70094,30630264,472280616,502910880
2021-07-21,G,RPG,98,1130,564657,864657864,20862886247,21727544111
2021-07-21,G,Staff,161,1402,469699,248275913,6972260683,7220536596
2021-07-21,G,TPG,28,345,287624,208524899,7678858351,7887383250
2021-07-21,G,Total,513,4860,2056806,2363280873,75289526147,77652807020
2021-07-21,G,UG,182,1713,559553,879510637,37047825050,37927335687
2021-07-21,LG1,Alumni,5,68,72748,160736765,1288708008,1449444773
2021-07-21,LG1,Non-HKUST,15,56,60208,68598187,1753428629,1822026816
2021-07-21,LG1,Others(HKUST),9,59,79320,4272598,70743336,75015934
2021-07-21,LG1,RPG,61,995,994610,3287726575,51214293336,54502019911
2021-07-21,LG1,Staff,86,595,403246,200442919,9211072778,9411515697
2021-07-21,LG1,TPG,14,156,228735,162466635,8657228545,8819695180
2021-07-21,LG1,Total,340,4035,4372271,8619051653,221255239557,229874291210
2021-07-21,LG1,UG,150,2106,2533404,4734807974,149059764925,153794572899
2021-07-21,LG3,Alumni,8,41,33171,25145422,2167873067,2193018489
2021-07-21,LG3,Non-HKUST,62,303,190018,158706336,10885668323,11044374659
2021-07-21,LG3,Others(HKUST),17,113,64002,53029112,2164718979,2217748091
2021-07-21,LG3,RPG,370,834,327963,1153306750,22682257350,23835564100
2021-07-21,LG3,Staff,477,1524,304012,314698789,10163151013,10477849802
2021-07-21,LG3,TPG,18,125,142211,69823820,4485899846,4555723666
2021-07-21,LG3,Total,1237,4218,1702671,2464294470,84213122512,86677416982
2021-07-21,LG3,UG,285,1278,641294,689584241,31663553934,32353138175
2021-07-21,LG4,Alumni,5,53,94942,27060016,836149468,863209484
2021-07-21,LG4,Non-HKUST,43,132,148398,207523303,15298778546,15506301849
2021-07-21,LG4,Others(HKUST),14,104,84062,47767018,2699989509,2747756527
2021-07-21,LG4,RPG,259,465,285876,273226338,10193050453,10466276791
2021-07-21,LG4,Staff,297,838,233831,328949856,4576126269,4905076125
2021-07-21,LG4,TPG,12,61,76469,68773553,2569816860,2638590413
2021-07-21,LG4,Total,844,2655,1508282,1529084402,62889723603,64418808005
2021-07-21,LG4,UG,214,1002,584704,575784318,26715812498,27291596816
2021-07-22,1,Alumni,4,12,28535,84252078,7390432507,7474684585
2021-07-22,1,Non-HKUST,5,26,49073,7466316,116441018,123907334
2021-07-22,1,Others(HKUST),7,103,199533,73321387,2104946613,2178268000
2021-07-22,1,RPG,52,90,73027,728114253,11977903589,12706017842
2021-07-22,1,Staff,95,1369,1042547,406027394,8672859286,9078886680
2021-07-22,1,TPG,11,76,274273,217690182,14209815625,14427505807
2021-07-22,1,Total,245,1983,2078263,1798668635,59086630215,60885298850
2021-07-22,1,UG,71,307,411275,281797025,14614231577,14896028602
2021-07-22,All-Floors,Alumni,19,358,363763,390395950,28245269467,28635665417
2021-07-22,All-Floors,Non-HKUST,88,530,481041,1042451327,45286499099,46328950426
2021-07-22,All-Floors,Others(HKUST),27,354,597990,116368960,3908512230,4024881190
2021-07-22,All-Floors,RPG,512,3051,1960800,4107956350,74967483026,79075439376
2021-07-22,All-Floors,Staff,610,6428,2769825,2765205108,58004910215,60770115323
2021-07-22,All-Floors,TPG,45,1215,1349651,2708056212,57366932031,60074988243
2021-07-22,All-Floors,Total,1812,19301,12934673,20179456430,647200844638,667380301068
2021-07-22,All-Floors,UG,511,7365,5411603,9049022523,379421238570,388470261093
2021-07-22,G,Alumni,9,108,26711,25842752,930581491,956424243
2021-07-22,G,Non-HKUST,27,135,119246,96953226,5289802881,5386756107
2021-07-22,G,Others(HKUST),6,93,308440,18883695,882312950,901196645
2021-07-22,G,RPG,135,945,372538,446513800,9942907281,10389421081
2021-07-22,G,Staff,176,1698,660228,461705451,6341575052,6803280503
2021-07-22,G,TPG,32,612,575365,2023696499,25531993361,27555689860
2021-07-22,G,Total,652,5967,3061123,4339294372,111240558473,115579852845
2021-07-22,G,UG,267,2376,998595,1265698949,62321385457,63587084406
2021-07-22,LG1,Alumni,7,89,119182,155470711,4887227030,5042697741
2021-07-22,LG1,Non-HKUST,10,44,83174,101555906,4117132980,4218688886
2021-07-22,LG1,Others(HKUST),3,36,11583,2035486,125756742,127792228
2021-07-22,LG1,RPG,77,688,814615,1674868431,26849871891,28524740322
2021-07-22,LG1,Staff,87,802,547696,865215517,24730640747,25595856264
2021-07-22,LG1,TPG,22,297,260060,354406958,10026255485,10380662443
2021-07-22,LG1,Total,405,4113,4132552,8620595480,267020676913,275641272393
2021-07-22,LG1,UG,199,2157,2296242,5467042471,196283792038,201750834509
2021-07-22,LG3,Alumni,9,42,40266,30737315,2630034791,2660772106
2021-07-22,LG3,Non-HKUST,53,153,90777,144486335,3254811039,3399297374
2021-07-22,LG3,Others(HKUST),19,86,18029,12625893,709029753,721655646
2021-07-22,LG3,RPG,370,838,405498,980828936,15805547850,16786376786
2021-07-22,LG3,Staff,455,1588,279129,771765043,12773242359,13545007402
2021-07-22,LG3,TPG,26,121,129912,50826702,2950322123,3001148825
2021-07-22,LG3,Total,1252,4354,1955855,3518293178,104655447528,108173740706
2021-07-22,LG3,UG,320,1526,992244,1527022954,66532459613,68059482567
2021-07-22,LG4,Alumni,9,107,149069,94093094,12406993648,12501086742
2021-07-22,LG4,Non-HKUST,42,172,138771,691989544,32508311181,33200300725
2021-07-22,LG4,Others(HKUST),12,36,60405,9502499,86466172,95968671
2021-07-22,LG4,RPG,228,490,295122,277630930,10391252415,10668883345
2021-07-22,LG4,Staff,270,971,240225,260491703,5486592771,5747084474
2021-07-22,LG4,TPG,18,109,110041,61435871,4648545437,4709981308
2021-07-22,LG4,Total,836,2884,1706880,1902604765,105197531509,107100136274
2021-07-22,LG4,UG,257,999,713247,507461124,39669369885,40176831009
2021-07-23,1,Alumni,2,6,23854,55267419,3013910887,3069178306
2021-07-23,1,Non-HKUST,9,37,36111,14764507,1682429577,1697194084
2021-07-23,1,Others(HKUST),4,15,74896,552183,11994971,12547154
2021-07-23,1,RPG,42,167,250871,211600659,14765726693,14977327352
2021-07-23,1,Staff,95,1581,929070,314325663,11785726557,12100052220
2021-07-23,1,TPG,12,206,274439,238265429,19913848446,20152113875
2021-07-23,1,Total,224,2354,2085964,1191023547,66853879587,68044903134
2021-07-23,1,UG,60,342,496723,356247687,15680242456,16036490143
2021-07-23,All-Floors,Alumni,20,381,317004,321131427,12497255642,12818387069
2021-07-23,All-Floors,Non-HKUST,99,726,505847,467953244,12222675100,12690628344
2021-07-23,All-Floors,Others(HKUST),26,191,296401,35993811,914558783,950552594
2021-07-23,All-Floors,RPG,552,3812,2327859,4068272083,82990689830,87058961913
2021-07-23,All-Floors,Staff,612,6227,2409470,3904965276,68486577165,72391542441
2021-07-23,All-Floors,TPG,43,1298,1071522,2156696808,51091676525,53248373333
2021-07-23,All-Floors,Total,1772,19002,11437054,24457718997,451025909526,475483628523
2021-07-23,All-Floors,UG,420,6367,4508951,13502706348,222822476481,236325182829
2021-07-23,G,Alumni,13,122,64959,95831958,3769516121,3865348079
2021-07-23,G,Non-HKUST,40,208,160467,173967207,1834456242,2008423449
2021-07-23,G,Others(HKUST),9,42,91058,18802667,536091783,554894450
2021-07-23,G,RPG,150,1019,216359,391643189,9677159608,10068802797
2021-07-23,G,Staff,174,1738,613940,296981809,13996609465,14293591274
2021-07-23,G,TPG,32,509,328359,314338636,11276881506,11591220142
2021-07-23,G,Total,612,5438,2021829,6712094929,75162255937,81874350866
2021-07-23,G,UG,194,1800,546687,5420529463,34071541212,39492070675
2021-07-23,LG1,Alumni,7,40,18783,19221448,405557706,424779154
2021-07-23,LG1,Non-HKUST,22,169,163542,130611462,2570966974,2701578436
2021-07-23,LG1,Others(HKUST),2,4,11556,2281546,7167834,9449380
2021-07-23,LG1,RPG,77,924,886187,2003556094,19076453269,21080009363
2021-07-23,LG1,Staff,84,762,306989,318608027,7745446510,8064054537
2021-07-23,LG1,TPG,17,336,252664,1440369174,6440533525,7880902699
2021-07-23,LG1,Total,350,4060,3622193,8915532553,156202811034,165118343587
2021-07-23,LG1,UG,141,1825,1982472,5000884802,119956685216,124957570018
2021-07-23,LG3,Alumni,10,91,91473,69580912,3023676568,3093257480
2021-07-23,LG3,Non-HKUST,59,144,55760,54174172,1025786805,1079960977
2021-07-23,LG3,Others(HKUST),17,90,20198,11969896,270368194,282338090
2021-07-23,LG3,RPG,430,1116,632460,1232692889,30732233410,31964926299
2021-07-23,LG3,Staff,459,1281,320655,2269818837,16451444819,18721263656
2021-07-23,LG3,TPG,33,133,141529,129980441,10583900118,10713880559
2021-07-23,LG3,Total,1295,3907,2098351,4809373972,92415150985,97224524957
2021-07-23,LG3,UG,287,1052,836276,1041156825,30327741071,31368897896
2021-07-23,LG4,Alumni,10,122,117935,81229690,2284594360,2365824050
2021-07-23,LG4,Non-HKUST,37,168,89967,94435896,5109035502,5203471398
2021-07-23,LG4,Others(HKUST),12,40,98693,2387519,88936001,91323520
2021-07-23,LG4,RPG,240,586,341982,228779252,8739116850,8967896102
2021-07-23,LG4,Staff,256,865,238816,705230940,18507349814,19212580754
2021-07-23,LG4,TPG,19,114,74531,33743128,2876512930,2910256058
2021-07-23,LG4,Total,748,3243,1608717,2829693996,60391811983,63221505979
2021-07-23,LG4,UG,174,1348,646793,1683887571,22786266526,24470154097
2021-07-24,1,Alumni,1,1,20,0,0,0
2021-07-24,1,Non-HKUST,4,9,17677,28123145,854141882,882265027
2021-07-24,1,Others(HKUST),2,12,38592,16278288,923009460,939287748
2021-07-24,1,RPG,8,35,127276,149202798,9685413109,9834615907
2021-07-24,1,Staff,10,53,43406,17665938,603858767,621524705
2021-07-24,1,TPG,3,208,88957,74716633,21115009184,21189725817
2021-07-24,1,Total,48,447,530038,509966532,41870734175,42380700707
2021-07-24,1,UG,20,129,214110,223979730,8689301773,8913281503
2021-07-24,All-Floors,Alumni,28,348,242840,151783098,24984393798,25136176896
2021-07-24,All-Floors,Non-HKUST,68,431,266071,261867265,9757372253,10019239518
2021-07-24,All-Floors,Others(HKUST),18,124,183625,30172487,1087582382,1117754869
2021-07-24,All-Floors,RPG,368,1663,1021617,1792461313,49136087812,50928549125
2021-07-24,All-Floors,Staff,182,959,287236,186957450,7483777390,7670734840
2021-07-24,All-Floors,TPG,29,557,265954,411328798,29832419564,30243748362
2021-07-24,All-Floors,Total,1076,7370,4657140,6587800202,283687475234,290275275436
2021-07-24,All-Floors,UG,383,3288,2389797,3753229791,161405842035,165159071826
2021-07-24,G,Alumni,16,94,27189,24510476,6799360503,6823870979
2021-07-24,G,Non-HKUST,18,107,31196,7123750,312120474,319244224
2021-07-24,G,Others(HKUST),3,12,33786,33976,63888,97864
2021-07-24,G,RPG,52,425,153519,384897632,6864645521,7249543153
2021-07-24,G,Staff,29,284,82717,23899672,746537567,770437239
2021-07-24,G,TPG,14,122,89060,48311482,2537508062,2585819544
2021-07-24,G,Total,256,1936,704996,903535754,68721685637,69625221391
2021-07-24,G,UG,124,892,287529,414758766,51461449622,51876208388
2021-07-24,LG1,Alumni,8,42,7349,9205962,690673137,699879099
2021-07-24,LG1,Non-HKUST,13,105,80014,84945650,3435005488,3519951138
2021-07-24,LG1,Others(HKUST),4,6,10306,5416316,26418161,31834477
2021-07-24,LG1,RPG,24,336,388735,699615362,17850803731,18550419093
2021-07-24,LG1,Staff,11,35,1566,236877,4342069,4578946
2021-07-24,LG1,TPG,5,39,15576,219614712,1278752520,1498367232
2021-07-24,LG1,Total,145,1297,1469751,3359180089,80526952131,83886132220
2021-07-24,LG1,UG,80,734,966205,2340145210,57240957025,59581102235
2021-07-24,LG3,Alumni,21,130,100518,47255812,11825373103,11872628915
2021-07-24,LG3,Non-HKUST,52,114,46412,44298382,2640302237,2684600619
2021-07-24,LG3,Others(HKUST),16,71,9821,4137429,119694527,123831956
2021-07-24,LG3,RPG,340,656,179348,246172776,9716163761,9962336537
2021-07-24,LG3,Staff,153,437,92245,79657474,5309043501,5388700975
2021-07-24,LG3,TPG,23,77,42670,26092715,2594695722,2620788437
2021-07-24,LG3,Total,925,2394,882964,784078879,60860104932,61644183811
2021-07-24,LG3,UG,320,909,411950,336464291,28654832081,28991296372
2021-07-24,LG4,Alumni,8,81,107764,70810848,5668987055,5739797903
2021-07-24,LG4,Non-HKUST,19,96,90772,97376338,2515802172,2613178510
2021-07-24,LG4,Others(HKUST),7,23,91120,4306478,18396346,22702824
2021-07-24,LG4,RPG,75,211,172739,312572745,5019061690,5331634435
2021-07-24,LG4,Staff,43,150,67302,65497489,819995486,885492975
2021-07-24,LG4,TPG,7,111,29691,42593256,2306454076,2349047332
2021-07-24,LG4,Total,253,1296,1069391,1031038948,31707998359,32739037307
2021-07-24,LG4,UG,94,624,510003,437881794,15359301534,15797183328
2021-07-25,1,Alumni,4,28,32836,17100203,2549959100,2567059303
2021-07-25,1,Non-HKUST,3,8,21020,21745349,340782552,362527901
2021-07-25,1,Others(HKUST),1,14,27842,19703808,679706695,699410503
2021-07-25,1,RPG,10,45,107090,185514807,7492826779,7678341586
2021-07-25,1,Staff,8,33,55691,33257481,1368710111,1401967592
2021-07-25,1,TPG,5,23,82410,71500878,5788959691,5860460569
2021-07-25,1,Total,44,190,443789,427512512,21330928700,21758441212
2021-07-25,1,UG,13,39,116900,78689986,3109983772,3188673758
2021-07-25,All-Floors,Alumni,29,606,307508,500407250,17578852050,18079259300
2021-07-25,All-Floors,Non-HKUST,72,276,261143,186924246,6963893144,7150817390
2021-07-25,All-Floors,Others(HKUST),14,79,167456,106177697,826683481,932861178
2021-07-25,All-Floors,RPG,392,1509,798513,1660096735,45347661894,47007758629
2021-07-25,All-Floors,Staff,168,982,328796,182089158,10237696934,10419786092
2021-07-25,All-Floors,TPG,36,516,362780,341612620,16314671057,16656283677
2021-07-25,All-Floors,Total,1123,6937,4453718,6687164603,248806204182,255493368785
2021-07-25,All-Floors,UG,412,2969,2227522,3709856897,151536745622,155246602519
2021-07-25,G,Alumni,18,176,27078,19401339,711846838,731248177
2021-07-25,G,Non-HKUST,18,91,59650,24944746,1379910288,1404855034
2021-07-25,G,Others(HKUST),4,13,34129,3542060,10783378,14325438
2021-07-25,G,RPG,44,378,144120,173651744,5291209671,5464861415
2021-07-25,G,Staff,29,265,82758,23089163,716312658,739401821
2021-07-25,G,TPG,20,287,177236,195536929,4247536470,4443073399
2021-07-25,G,Total,268,2154,1033144,2005279625,59799217425,61804497050
2021-07-25,G,UG,135,944,508173,1565113644,47441618122,49006731766
2021-07-25,LG1,Alumni,11,73,6718,5124287,617370176,622494463
2021-07-25,LG1,Non-HKUST,9,38,40375,58414112,1158376735,1216790847
2021-07-25,LG1,Others(HKUST),1,1,10191,3026205,13944649,16970854
2021-07-25,LG1,RPG,27,248,310326,570722486,24654839277,25225561763
2021-07-25,LG1,Staff,15,97,42691,26699896,765668470,792368366
2021-07-25,LG1,TPG,6,49,24496,5508528,85053270,90561798
2021-07-25,LG1,Total,145,1101,1342993,2243747405,113094785679,115338533084
2021-07-25,LG1,UG,76,595,908196,1574251891,85799533102,87373784993
2021-07-25,LG3,Alumni,21,229,166057,292778836,5795122046,6087900882
2021-07-25,LG3,Non-HKUST,52,102,44855,44999572,2972864033,3017863605
2021-07-25,LG3,Others(HKUST),9,35,9829,73544124,80360977,153905101
2021-07-25,LG3,RPG,356,716,179351,711477286,6943907567,7655384853
2021-07-25,LG3,Staff,149,359,70334,39673341,5784296150,5823969491
2021-07-25,LG3,TPG,27,108,34246,31176301,2834678320,2865854621
2021-07-25,LG3,Total,967,2652,945707,1615613143,36910935045,38526548188
2021-07-25,LG3,UG,353,1103,441035,421963683,12499705952,12921669635
2021-07-25,LG4,Alumni,9,100,74819,166002585,7904553890,8070556475
2021-07-25,LG4,Non-HKUST,14,37,95243,36820467,1111959536,1148780003
2021-07-25,LG4,Others(HKUST),7,16,85465,6361500,41887782,48249282
2021-07-25,LG4,RPG,74,122,57626,18730412,964878600,983609012
2021-07-25,LG4,Staff,41,228,77322,59369277,1602709545,1662078822
2021-07-25,LG4,TPG,5,49,44392,37889984,3358443306,3396333290
2021-07-25,LG4,Total,237,840,688085,395011918,17670337333,18065349251
2021-07-25,LG4,UG,87,288,253218,69837693,2685904674,2755742367
2021-07-26,1,Alumni,3,7,26534,1010208524,7901372172,8911580696
2021-07-26,1,Non-HKUST,8,222,90952,36758346,1166480110,1203238456
2021-07-26,1,Others(HKUST),2,37,124634,42010533,1128740168,1170750701
2021-07-26,1,RPG,25,150,255460,443734859,9254555481,9698290340
2021-07-26,1,Staff,63,1324,1041778,702967560,10831606920,11534574480
2021-07-26,1,TPG,6,50,68017,48310527,4164134037,4212444564
2021-07-26,1,Total,152,2113,2164265,3561568061,61030312989,64591881050
2021-07-26,1,UG,45,323,556890,1277577712,26583424101,27861001813
2021-07-26,All-Floors,Alumni,25,601,384719,1480503355,34483800652,35964304007
2021-07-26,All-Floors,Non-HKUST,108,1017,650468,1505372056,30266245039,31771617095
2021-07-26,All-Floors,Others(HKUST),24,237,361035,375628914,3232608327,3608237241
2021-07-26,All-Floors,RPG,637,4159,2893905,9348273092,109910884900,119259157992
2021-07-26,All-Floors,Staff,740,5641,2743532,2258180433,54741681540,56999861973
2021-07-26,All-Floors,TPG,42,981,882499,855540437,40380837871,41236378308
2021-07-26,All-Floors,Total,2029,20494,13688771,24452942564,594743985894,619196928458
2021-07-26,All-Floors,UG,453,7858,5772613,8629444277,321727927565,330357371842
2021-07-26,G,Alumni,13,154,47557,154985166,5640214970,5795200136
2021-07-26,G,Non-HKUST,39,267,189104,142546566,3519553567,3662100133
2021-07-26,G,Others(HKUST),7,50,79744,311194454,1660031761,1971226215
2021-07-26,G,RPG,142,1161,382109,1636074420,19017616549,20653690969
2021-07-26,G,Staff,175,1647,748269,471521721,8553382647,9024904368
2021-07-26,G,TPG,26,533,386199,309967640,14913044832,15223012472
2021-07-26,G,Total,644,6168,2620394,4213287293,111500932605,115714219898
2021-07-26,G,UG,242,2356,787412,1186997326,58197088279,59384085605
2021-07-26,LG1,Alumni,7,86,145406,222666896,15469888114,15692555010
2021-07-26,LG1,Non-HKUST,25,153,145531,221275252,5424886349,5646161601
2021-07-26,LG1,Others(HKUST),3,11,45734,4291225,17833032,22124257
2021-07-26,LG1,RPG,74,1064,1192432,4968035215,55080548023,60048583238
2021-07-26,LG1,Staff,70,532,367439,680071707,25939570396,26619642103
2021-07-26,LG1,TPG,16,151,168663,310487319,15032760477,15343247796
2021-07-26,LG1,Total,346,4086,4535545,10815051478,259511361500,270326412978
2021-07-26,LG1,UG,151,2089,2470340,4408223864,142545875109,146954098973
2021-07-26,LG3,Alumni,16,101,79965,19732481,302683127,322415608
2021-07-26,LG3,Non-HKUST,73,197,137601,1039639882,3496288191,4535928073
2021-07-26,LG3,Others(HKUST),22,94,16236,6753337,195902723,202656060
2021-07-26,LG3,RPG,575,1442,734660,1843812803,19313711932,21157524735
2021-07-26,LG3,Staff,612,1513,385890,291645551,7437390337,7729035888
2021-07-26,LG3,TPG,30,101,119191,91264823,3543706358,3634971181
2021-07-26,LG3,Total,1677,5070,2522117,4400017682,86538944412,90938962094
2021-07-26,LG3,UG,349,1622,1048574,1107168805,52249261744,53356430549
2021-07-26,LG4,Alumni,7,253,85257,72910288,5169642269,5242552557
2021-07-26,LG4,Non-HKUST,27,178,87280,65152010,16659036822,16724188832
2021-07-26,LG4,Others(HKUST),12,45,94687,11379365,230100643,241480008
2021-07-26,LG4,RPG,131,342,329244,456615795,7244452915,7701068710
2021-07-26,LG4,Staff,175,625,200156,111973894,1979731240,2091705134
2021-07-26,LG4,TPG,8,146,140429,95510128,2727192167,2822702295
2021-07-26,LG4,Total,464,3057,1846450,1463018050,76162434388,77625452438
2021-07-26,LG4,UG,104,1468,909397,649476570,42152278332,42801754902
2021-07-27,1,Alumni,3,7,28284,64643342,4503081954,4567725296
2021-07-27,1,Non-HKUST,5,49,75306,27301814,9779881860,9807183674
2021-07-27,1,Others(HKUST),3,21,107743,57527881,1528945373,1586473254
2021-07-27,1,RPG,19,93,171862,149418783,2910157735,3059576518
2021-07-27,1,Staff,72,1462,1147383,373566285,19772707134,20146273419
2021-07-27,1,TPG,9,178,229617,151318801,8538558773,8689877574
2021-07-27,1,Total,153,2103,2310893,1306811635,64395524880,65702336515
2021-07-27,1,UG,42,293,550698,483034729,17362192051,17845226780
2021-07-27,All-Floors,Alumni,30,780,482138,885195791,44129040038,45014235829
2021-07-27,All-Floors,Non-HKUST,133,764,654502,694850509,39398518075,40093368584
2021-07-27,All-Floors,Others(HKUST),22,172,269582,81248446,2421802268,2503050714
2021-07-27,All-Floors,RPG,633,3615,2341111,3693938457,100091096391,103785034848
2021-07-27,All-Floors,Staff,741,6067,2717961,2642828694,59563315793,62206144487
2021-07-27,All-Floors,TPG,43,915,900323,929780120,53822511924,54752292044
2021-07-27,All-Floors,Total,2097,19795,12699155,15692237513,589843073736,605535311249
2021-07-27,All-Floors,UG,495,7482,5333538,6764395496,290416789247,297181184743
2021-07-27,G,Alumni,14,139,15504,9724538,437253746,446978284
2021-07-27,G,Non-HKUST,42,202,133066,136403386,6484822284,6621225670
2021-07-27,G,Others(HKUST),4,24,38326,7368752,45028200,52396952
2021-07-27,G,RPG,123,938,501997,468737826,22320131045,22788868871
2021-07-27,G,Staff,178,1740,720910,311853058,15060692043,15372545101
2021-07-27,G,TPG,29,418,290215,260773433,15167238239,15428011672
2021-07-27,G,Total,620,5641,2391445,1963312770,99436164664,101399477434
2021-07-27,G,UG,230,2180,691427,768451777,39920999107,40689450884
2021-07-27,LG1,Alumni,10,229,168739,597004279,14509712953,15106717232
2021-07-27,LG1,Non-HKUST,19,128,125941,214129133,8089796590,8303925723
2021-07-27,LG1,Others(HKUST),3,11,14809,5011388,744864042,749875430
2021-07-27,LG1,RPG,65,888,800874,1899766548,25864208947,27763975495
2021-07-27,LG1,Staff,69,638,314515,220989611,11525342937,11746332548
2021-07-27,LG1,TPG,9,104,135999,188221795,10282209197,10470430992
2021-07-27,LG1,Total,316,4598,4113930,6982556942,233946032135,240928589077
2021-07-27,LG1,UG,141,2600,2553053,3857434188,162929897469,166787331657
2021-07-27,LG3,Alumni,17,125,113575,58156509,4056896998,4115053507
2021-07-27,LG3,Non-HKUST,93,254,136278,81801880,4113817652,4195619532
2021-07-27,LG3,Others(HKUST),16,76,16909,2542255,48576415,51118670
2021-07-27,LG3,RPG,562,1354,630514,966834744,43098929088,44065763832
2021-07-27,LG3,Staff,606,1503,297331,1634271295,11106585795,12740857090
2021-07-27,LG3,TPG,28,96,69967,160927879,605462576,766390455
2021-07-27,LG3,Total,1717,4783,2163196,4092670544,101691602796,105784273340
2021-07-27,LG3,UG,395,1375,898622,1188135982,38661334272,39849470254
2021-07-27,LG4,Alumni,6,280,156036,155667123,20622094387,20777761510
2021-07-27,LG4,Non-HKUST,34,131,183911,235214296,10930199689,11165413985
2021-07-27,LG4,Others(HKUST),11,40,91795,8798170,54388238,63186408
2021-07-27,LG4,RPG,152,342,235864,209180556,5897669576,6106850132
2021-07-27,LG4,Staff,200,724,237822,102148445,2097987884,2200136329
2021-07-27,LG4,TPG,9,119,174525,168538212,19229043139,19397581351
2021-07-27,LG4,Total,545,2670,1719691,1346885622,90373749261,91720634883
2021-07-27,LG4,UG,133,1034,639738,467338820,31542366348,32009705168
2021-07-28,1,Alumni,3,11,27611,89935373,4561337578,4651272951
2021-07-28,1,Non-HKUST,8,121,66185,60255343,19863684076,19923939419
2021-07-28,1,Others(HKUST),2,34,55249,36070748,1897009359,1933080107
2021-07-28,1,RPG,30,134,239779,259426621,4499404757,4758831378
2021-07-28,1,Staff,79,1357,973858,425952111,10418778829,10844730940
2021-07-28,1,TPG,8,47,150030,81530559,6798081339,6879611898
2021-07-28,1,Total,172,1965,2036756,1465702118,69003905167,70469607285
2021-07-28,1,UG,42,261,524044,512531363,20965609229,21478140592
2021-07-28,All-Floors,Alumni,29,489,324109,578781775,28964193881,29542975656
2021-07-28,All-Floors,Non-HKUST,108,880,585650,546432480,36936970274,37483402754
2021-07-28,All-Floors,Others(HKUST),25,248,372757,134327048,8100856875,8235183923
2021-07-28,All-Floors,RPG,696,3802,2469897,3910916323,68551115385,72462031708
2021-07-28,All-Floors,Staff,821,6312,2509368,2005978414,44616686568,46622664982
2021-07-28,All-Floors,TPG,49,1028,1027932,1232915106,44685311077,45918226183
2021-07-28,All-Floors,Total,2232,20381,13274119,16645371998,596597208806,613242580804
2021-07-28,All-Floors,UG,504,7622,5984406,8236020852,364742074746,372978095598
2021-07-28,G,Alumni,17,174,57362,82080225,6832578140,6914658365
2021-07-28,G,Non-HKUST,35,232,108180,80288106,3413881729,3494169835
2021-07-28,G,Others(HKUST),7,69,90174,57858619,2409678383,2467537002
2021-07-28,G,RPG,113,1131,589249,777341871,18901196382,19678538253
2021-07-28,G,Staff,187,1682,686235,515364817,12482143508,12997508325
2021-07-28,G,TPG,25,367,268338,670234175,11979519500,12649753675
2021-07-28,G,Total,607,5916,2534400,3203064545,100029220878,103232285423
2021-07-28,G,UG,223,2261,734862,1019896732,44010223236,45030119968
2021-07-28,LG1,Alumni,10,176,131476,268806558,14437052154,14705858712
2021-07-28,LG1,Non-HKUST,19,123,92134,128592922,4309920569,4438513491
2021-07-28,LG1,Others(HKUST),4,23,118285,22634530,3540836930,3563471460
2021-07-28,LG1,RPG,63,761,895348,1660156992,22234381751,23894538743
2021-07-28,LG1,Staff,82,690,375928,299030560,12385317358,12684347918
2021-07-28,LG1,TPG,11,300,227633,190457638,10631920048,10822377686
2021-07-28,LG1,Total,339,4594,4577709,6131662108,218941234394,225072896502
2021-07-28,LG1,UG,150,2521,2736905,3561982908,151401805584,154963788492
2021-07-28,LG3,Alumni,20,74,34455,93047392,1970394392,2063441784
2021-07-28,LG3,Non-HKUST,72,238,161207,167213165,5025553940,5192767105
2021-07-28,LG3,Others(HKUST),18,84,12270,10631420,218427470,229058890
2021-07-28,LG3,RPG,634,1503,555153,1103611402,17822181457,18925792859
2021-07-28,LG3,Staff,688,1726,294777,707410717,7385193499,8092604216
2021-07-28,LG3,TPG,35,156,183586,170769633,8857465620,9028235253
2021-07-28,LG3,Total,1905,5407,2523454,4046763562,132957142213,137003905775
2021-07-28,LG3,UG,438,1626,1282006,1794079833,91677925835,93472005668
2021-07-28,LG4,Alumni,8,54,73205,44912227,1162831617,1207743844
2021-07-28,LG4,Non-HKUST,29,166,157944,110082944,4323929960,4434012904
2021-07-28,LG4,Others(HKUST),11,38,96779,7131731,34904733,42036464
2021-07-28,LG4,RPG,145,273,190368,110379437,5093951038,5204330475
2021-07-28,LG4,Staff,196,857,178570,58220209,1945253374,2003473583
2021-07-28,LG4,TPG,9,158,198345,119923101,6418324570,6538247671
2021-07-28,LG4,Total,529,2499,1601800,1798179665,75665706154,77463885819
2021-07-28,LG4,UG,131,953,706589,1347530016,56686510862,58034040878
2021-07-29,1,Alumni,4,12,33246,66184168,2664435526,2730619694
2021-07-29,1,Non-HKUST,8,19,49744,25274070,8368555066,8393829136
2021-07-29,1,Others(HKUST),5,42,161914,50222292,3713722219,3763944511
2021-07-29,1,RPG,39,142,170039,194162545,5102364664,5296527209
2021-07-29,1,Staff,81,1268,1046386,296261040,9464383375,9760644415
2021-07-29,1,TPG,9,43,86603,122411725,1583347288,1705759013
2021-07-29,1,Total,204,1870,1973432,1113692112,44563798056,45677490168
2021-07-29,1,UG,58,344,425500,359176272,13666989918,14026166190
2021-07-29,All-Floors,Alumni,25,371,342176,581969925,17134515860,17716485785
2021-07-29,All-Floors,Non-HKUST,127,655,645827,601676143,31005802191,31607478334
2021-07-29,All-Floors,Others(HKUST),27,252,484463,80506292,4260366338,4340872630
2021-07-29,All-Floors,RPG,706,4017,2465465,3917102237,104020865300,107937967537
2021-07-29,All-Floors,Staff,777,6472,2535485,1250580441,73138678973,74389259414
2021-07-29,All-Floors,TPG,54,909,891012,1631566770,35011599689,36643166459
2021-07-29,All-Floors,Total,2256,20396,12348293,14012282996,556659217059,570671500055
2021-07-29,All-Floors,UG,540,7720,4983865,5948881188,292087388708,298036269896
2021-07-29,G,Alumni,11,163,30737,47892596,816631357,864523953
2021-07-29,G,Non-HKUST,38,255,205219,248403215,8531930749,8780333964
2021-07-29,G,Others(HKUST),6,34,61519,2690113,7859760,10549873
2021-07-29,G,RPG,120,1256,604469,1300457885,18533708175,19834166060
2021-07-29,G,Staff,164,1555,628631,492109552,47439917597,47932027149
2021-07-29,G,TPG,31,415,361306,676083763,13624664134,14300747897
2021-07-29,G,Total,613,5849,2636431,3819897272,125008263537,128828160809
2021-07-29,G,UG,243,2171,744550,1052260148,36053551765,37105811913
2021-07-29,LG1,Alumni,9,83,115811,347646574,3954015836,4301662410
2021-07-29,LG1,Non-HKUST,17,108,138525,117957338,5936621867,6054579205
2021-07-29,LG1,Others(HKUST),5,23,148947,19132498,416964672,436097170
2021-07-29,LG1,RPG,51,695,671690,1431971028,23930835051,25362806079
2021-07-29,LG1,Staff,77,578,275490,89173446,3932062204,4021235650
2021-07-29,LG1,TPG,14,198,211643,228154919,8383868595,8612023514
2021-07-29,LG1,Total,324,4057,3690174,4815581207,184749760753,189565341960
2021-07-29,LG1,UG,151,2372,2128068,2581545404,138195392528,140776937932
2021-07-29,LG3,Alumni,20,88,112128,59324943,4597517618,4656842561
2021-07-29,LG3,Non-HKUST,86,223,172398,143681836,5457568605,5601250441
2021-07-29,LG3,Others(HKUST),20,114,19281,1280995,23638061,24919056
2021-07-29,LG3,RPG,643,1563,596540,595682303,38270617143,38866299446
2021-07-29,LG3,Staff,653,1910,313127,224536132,9034670843,9259206975
2021-07-29,LG3,TPG,43,175,101806,85597912,5559722035,5645319947
2021-07-29,LG3,Total,1909,5967,2382027,2435559341,122148153065,124583712406
2021-07-29,LG3,UG,444,1894,1066747,1325455220,59204418760,60529873980
2021-07-29,LG4,Alumni,5,25,50254,60921644,5101915523,5162837167
2021-07-29,LG4,Non-HKUST,27,50,79941,66359684,2711125904,2777485588
2021-07-29,LG4,Others(HKUST),7,39,92802,7180394,98181626,105362020
2021-07-29,LG4,RPG,140,361,422727,394828476,18183340267,18578168743
2021-07-29,LG4,Staff,227,1161,271851,148500271,3267644954,3416145225
2021-07-29,LG4,TPG,16,78,129654,519318451,5859997637,6379316088
2021-07-29,LG4,Total,580,2653,1666229,1827553064,80189241648,82016794712
2021-07-29,LG4,UG,158,939,619000,630444144,44967035737,45597479881
2021-07-30,1,Alumni,3,4,115,1636,5533,7169
2021-07-30,1,Non-HKUST,7,19,51218,40281933,9054355938,9094637871
2021-07-30,1,Others(HKUST),6,32,109491,29795881,1395727614,1425523495
2021-07-30,1,RPG,29,105,157711,172551995,9109963682,9282515677
2021-07-30,1,Staff,80,1733,1037835,311767891,10673631278,10985399169
2021-07-30,1,TPG,5,14,30147,13989830,660955216,674945046
2021-07-30,1,Total,178,2180,1931941,919996020,49663996900,50583992920
2021-07-30,1,UG,48,273,545424,351606854,18769357639,19120964493
2021-07-30,All-Floors,Alumni,26,339,302741,646675127,12206300602,12852975729
2021-07-30,All-Floors,Non-HKUST,110,787,676121,737630299,32137033924,32874664223
2021-07-30,All-Floors,Others(HKUST),32,230,398463,64965857,3117388334,3182354191
2021-07-30,All-Floors,RPG,624,3273,2300944,3658006026,103915786686,107573792712
2021-07-30,All-Floors,Staff,761,6711,2567642,2038780623,55598008886,57636789509
2021-07-30,All-Floors,TPG,42,809,848994,951122358,25949273343,26900395701
2021-07-30,All-Floors,Total,2046,18526,11890133,14683400579,528678851326,543362251905
2021-07-30,All-Floors,UG,451,6377,4795228,6586220289,295755059551,302341279840
2021-07-30,G,Alumni,14,100,33138,39696678,672332603,712029281
2021-07-30,G,Non-HKUST,39,237,251768,165631317,6566585740,6732217057
2021-07-30,G,Others(HKUST),8,46,36786,18779118,1517215860,1535994978
2021-07-30,G,RPG,125,966,563216,843493162,19197568413,20041061575
2021-07-30,G,Staff,180,1743,641541,292489455,12172373274,12464862729
2021-07-30,G,TPG,25,335,348657,308224458,7695810607,8004035065
2021-07-30,G,Total,586,5102,2318872,2550395938,72692875245,75243271183
2021-07-30,G,UG,195,1675,443766,882081750,24870988748,25753070498
2021-07-30,LG1,Alumni,8,124,108538,482559857,3277657218,3760217075
2021-07-30,LG1,Non-HKUST,29,160,166035,433298255,7692961628,8126259883
2021-07-30,LG1,Others(HKUST),4,14,145214,8785322,27513029,36298351
2021-07-30,LG1,RPG,56,573,664247,1086990031,22903205111,23990195142
2021-07-30,LG1,Staff,68,649,276068,252177764,10335721744,10587899508
2021-07-30,LG1,TPG,13,238,213311,284602132,7491701800,7776303932
2021-07-30,LG1,Total,309,3702,3794822,6272578435,205986569161,212259147596
2021-07-30,LG1,UG,131,1944,2221409,3724165074,154257808631,157981973705
2021-07-30,LG3,Alumni,17,95,128315,85320319,4067119925,4152440244
2021-07-30,LG3,Non-HKUST,55,134,132679,77775522,6863785424,6941560946
2021-07-30,LG3,Others(HKUST),26,105,13909,968276,155386927,156355203
2021-07-30,LG3,RPG,555,1342,707831,1406812695,48136996080,49543808775
2021-07-30,LG3,Staff,636,1674,337097,1018163860,17185675117,18203838977
2021-07-30,LG3,TPG,33,146,159215,301312538,8581802919,8883115457
2021-07-30,LG3,Total,1687,4948,2384644,3882434213,126693095589,130575529802
2021-07-30,LG3,UG,365,1452,905598,992081003,41702329197,42694410200
2021-07-30,LG4,Alumni,5,16,32635,39096637,4189185323,4228281960
2021-07-30,LG4,Non-HKUST,30,237,74421,20643272,1959345194,1979988466
2021-07-30,LG4,Others(HKUST),12,33,93063,6637260,21544904,28182164
2021-07-30,LG4,RPG,125,287,207939,148158143,4568053400,4716211543
2021-07-30,LG4,Staff,190,912,275101,164181653,5230607473,5394789126
2021-07-30,LG4,TPG,10,76,97664,42993400,1519002801,1561996201
2021-07-30,LG4,Total,484,2594,1459854,1057995973,73642314431,74700310404
2021-07-30,LG4,UG,112,1033,679031,636285608,56154575336,56790860944
2021-07-31,1,Alumni,4,28,40633,31291765,3085726846,3117018611
2021-07-31,1,Non-HKUST,3,19,15795,2525964,60010780,62536744
2021-07-31,1,Others(HKUST),3,22,87401,22279873,594334276,616614149
2021-07-31,1,RPG,28,108,108777,159653256,2582349152,2742002408
2021-07-31,1,Staff,14,110,101521,79797426,1191871741,1271669167
2021-07-31,1,TPG,5,21,41869,52801199,2976031648,3028832847
2021-07-31,1,Total,78,413,522563,505382290,31066983515,31572365805
2021-07-31,1,UG,21,105,126567,157032807,20576659072,20733691879
2021-07-31,All-Floors,Alumni,31,384,242910,192156217,15427678616,15619834833
2021-07-31,All-Floors,Non-HKUST,74,373,374559,320927612,10237839277,10558766889
2021-07-31,All-Floors,Others(HKUST),15,139,325752,40923486,676249881,717173367
2021-07-31,All-Floors,RPG,351,1495,793880,1612362742,38360039223,39972401965
2021-07-31,All-Floors,Staff,197,1007,378563,399144440,19529588418,19928732858
2021-07-31,All-Floors,TPG,44,371,350563,256808608,12477264639,12734073247
2021-07-31,All-Floors,Total,1069,6607,4668506,5560169269,233061451068,238621620337
2021-07-31,All-Floors,UG,357,2838,2202279,2737846164,136352791014,139090637178
2021-07-31,G,Alumni,15,107,28903,17107492,294932542,312040034
2021-07-31,G,Non-HKUST,17,59,59748,18242488,835702455,853944943
2021-07-31,G,Others(HKUST),3,7,33523,3198457,11367462,14565919
2021-07-31,G,RPG,51,344,183347,302497035,13807725127,14110222162
2021-07-31,G,Staff,33,213,102148,95540568,3604068766,3699609334
2021-07-31,G,TPG,15,97,150206,84907955,5373661713,5458569668
2021-07-31,G,Total,268,1623,793674,731480850,35498467403,36229948253
2021-07-31,G,UG,134,796,235799,209986855,11571009338,11780996193
2021-07-31,LG1,Alumni,9,71,71827,96106836,7586046624,7682153460
2021-07-31,LG1,Non-HKUST,12,93,91698,172371744,5265391464,5437763208
2021-07-31,LG1,Others(HKUST),2,4,100372,9139308,26161770,35301078
2021-07-31,LG1,RPG,24,284,166959,771630644,6229752609,7001383253
2021-07-31,LG1,Staff,26,94,37447,33283050,5668760882,5702043932
2021-07-31,LG1,TPG,8,37,30143,17620967,693469059,711090026
2021-07-31,LG1,Total,156,1420,1516236,2729734851,95456036379,98185771230
2021-07-31,LG1,UG,75,837,1017790,1629582302,69986453971,71616036273
2021-07-31,LG3,Alumni,21,101,59764,17374802,369195511,386570313
2021-07-31,LG3,Non-HKUST,40,104,63203,45267803,1215447061,1260714864
2021-07-31,LG3,Others(HKUST),10,60,6603,394775,1363632,1758407
2021-07-31,LG3,RPG,241,459,183466,219365617,10502344056,10721709673
2021-07-31,LG3,Staff,124,351,95325,148997224,8671941754,8820938978
2021-07-31,LG3,TPG,30,136,70875,77405070,2108414488,2185819558
2021-07-31,LG3,Total,694,1866,751253,797088153,36096540740,36893628893
2021-07-31,LG3,UG,228,655,272017,288282862,13227834238,13516117100
2021-07-31,LG4,Alumni,13,77,41783,30275322,4091777093,4122052415
2021-07-31,LG4,Non-HKUST,32,98,144115,82519613,2861287517,2943807130
2021-07-31,LG4,Others(HKUST),9,46,97853,5911073,43022741,48933814
2021-07-31,LG4,RPG,173,300,151331,159216190,5237868279,5397084469
2021-07-31,LG4,Staff,91,239,42122,41526172,392945275,434471447
2021-07-31,LG4,TPG,27,80,57470,24073417,1325687731,1349761148
2021-07-31,LG4,Total,513,1285,1084780,796483125,34943423031,35739906156
2021-07-31,LG4,UG,168,445,550106,452961338,20990834395,21443795733
