Date,Floor,User-Group,User-Count,WiFi-Conn,Duration-Sec,Traffic-In-Byte,Traffic-Out-Byte,Traffic-Both-Byte
2021-08-01,1,Alumni,3,35,43664,18078573,2192849480,2210928053
2021-08-01,1,Non-HKUST,5,13,19215,6919151,891597017,898516168
2021-08-01,1,Others(HKUST),2,16,86854,14340953,609603155,623944108
2021-08-01,1,RPG,17,130,145540,108588724,8785086153,8893674877
2021-08-01,1,Staff,15,72,69557,43016945,586723342,629740287
2021-08-01,1,TPG,7,60,61832,46492792,10533658708,10580151500
2021-08-01,1,Total,89,488,652387,418314148,41233925953,41652240101
2021-08-01,1,UG,40,162,225725,180877010,17634408098,17815285108
2021-08-01,All-Floors,Alumni,32,531,295412,4755004261,17142968624,21897972885
2021-08-01,All-Floors,Non-HKUST,69,364,314585,517903294,9452118602,9970021896
2021-08-01,All-Floors,Others(HKUST),12,89,296935,36767896,750804432,787572328
2021-08-01,All-Floors,RPG,363,1243,647802,746901494,26099577911,26846479405
2021-08-01,All-Floors,Staff,153,934,280080,226340628,6073352125,6299692753
2021-08-01,All-Floors,TPG,50,386,397926,516579910,30158091242,30674671152
2021-08-01,All-Floors,Total,1074,6592,4245491,9644067085,189315544577,198959611662
2021-08-01,All-Floors,UG,395,3045,2012751,2844569602,99638631641,102483201243
2021-08-01,G,Alumni,18,120,17207,14812016,1148488770,1163300786
2021-08-01,G,Non-HKUST,19,153,98484,116773130,1776367508,1893140638
2021-08-01,G,Others(HKUST),2,10,33562,7098175,85005114,92103289
2021-08-01,G,RPG,52,294,191823,173906946,6103421712,6277328658
2021-08-01,G,Staff,36,266,53537,57432203,882765039,940197242
2021-08-01,G,TPG,21,123,132949,77754951,6117259272,6195014223
2021-08-01,G,Total,263,1826,954616,1245150734,45085977509,46331128243
2021-08-01,G,UG,115,860,427054,797373313,28972670094,29770043407
2021-08-01,LG1,Alumni,13,75,40911,4561176778,4621937159,9183113937
2021-08-01,LG1,Non-HKUST,11,28,50409,288351745,4870388760,5158740505
2021-08-01,LG1,Others(HKUST),1,4,100342,7567553,27745450,35313003
2021-08-01,LG1,RPG,11,102,91244,44521661,1843914070,1888435731
2021-08-01,LG1,Staff,16,81,33364,11831114,737062775,748893889
2021-08-01,LG1,TPG,9,89,153887,366636415,12926312223,13292948638
2021-08-01,LG1,Total,123,1134,1164250,6583484397,60291157835,66874642232
2021-08-01,LG1,UG,62,755,694093,1303399131,35263797398,36567196529
2021-08-01,LG3,Alumni,19,154,99775,69352021,4560742253,4630094274
2021-08-01,LG3,Non-HKUST,28,89,43528,14443371,164168679,178612050
2021-08-01,LG3,Others(HKUST),5,19,1964,54131,188907,243038
2021-08-01,LG3,RPG,165,307,88308,301545064,5264563136,5566108200
2021-08-01,LG3,Staff,73,271,60687,53967259,2373634752,2427602011
2021-08-01,LG3,TPG,26,58,8574,2694135,127357373,130051508
2021-08-01,LG3,Total,502,1369,558713,703128346,22225837102,22928965448
2021-08-01,LG3,UG,186,471,255877,261072365,9735182002,9996254367
2021-08-01,LG4,Alumni,16,147,93855,91584873,4618950962,4710535835
2021-08-01,LG4,Non-HKUST,30,81,102949,91415897,1749596638,1841012535
2021-08-01,LG4,Others(HKUST),9,40,74213,7707084,28261806,35968890
2021-08-01,LG4,RPG,262,410,130887,118339099,4102592840,4220931939
2021-08-01,LG4,Staff,102,244,62935,60093107,1493166217,1553259324
2021-08-01,LG4,TPG,31,56,40684,23001617,453503666,476505283
2021-08-01,LG4,Total,724,1775,915525,693989460,20478646178,21172635638
2021-08-01,LG4,UG,274,797,410002,301847783,8032574049,8334421832
2021-08-02,1,Alumni,4,26,32022,39491329,2304058615,2343549944
2021-08-02,1,Non-HKUST,7,83,52469,26386285,5838876729,5865263014
2021-08-02,1,Others(HKUST),5,70,143402,85933999,1529916597,1615850596
2021-08-02,1,RPG,32,224,238053,218854989,7736745335,7955600324
2021-08-02,1,Staff,85,1217,820754,796052996,9227737518,10023790514
2021-08-02,1,TPG,5,126,106831,109074865,18858416021,18967490886
2021-08-02,1,Total,203,2058,1710483,1506216310,163083646690,164589863000
2021-08-02,1,UG,65,312,316952,230421847,117587895875,117818317722
2021-08-02,All-Floors,Alumni,32,409,335894,353536482,25290619213,25644155695
2021-08-02,All-Floors,Non-HKUST,103,814,577967,641864661,29352583070,29994447731
2021-08-02,All-Floors,Others(HKUST),24,228,429552,166598764,3542735711,3709334475
2021-08-02,All-Floors,RPG,647,4293,2716718,5084930916,113278914014,118363844930
2021-08-02,All-Floors,Staff,731,6014,2477511,2528171575,37060560557,39588732132
2021-08-02,All-Floors,TPG,59,1165,1080851,1649228494,56418181326,58067409820
2021-08-02,All-Floors,Total,2059,21106,12970572,23189787639,727554430034,750744217673
2021-08-02,All-Floors,UG,463,8183,5352079,12765456747,462610836143,475376292890
2021-08-02,G,Alumni,19,142,29233,60697641,2913596765,2974294406
2021-08-02,G,Non-HKUST,47,238,144986,113826756,1279183946,1393010702
2021-08-02,G,Others(HKUST),7,43,101277,27325237,1832498232,1859823469
2021-08-02,G,RPG,286,1542,603712,851482803,17098901223,17950384026
2021-08-02,G,Staff,266,1688,852610,323160469,7384621264,7707781733
2021-08-02,G,TPG,43,491,467626,467543282,16104859931,16572403213
2021-08-02,G,Total,923,6697,3063806,6085155959,101168748156,107253904115
2021-08-02,G,UG,255,2553,864362,4241119771,54555086795,58796206566
2021-08-02,LG1,Alumni,7,56,78165,113985180,3704515724,3818500904
2021-08-02,LG1,Non-HKUST,16,137,119276,270966868,4378934417,4649901285
2021-08-02,LG1,Others(HKUST),4,9,102610,6028918,20152946,26181864
2021-08-02,LG1,RPG,72,1036,923971,2421795234,46047453184,48469248418
2021-08-02,LG1,Staff,64,614,239067,328544579,3643157592,3971702171
2021-08-02,LG1,TPG,16,314,295012,899457624,15097986661,15997444285
2021-08-02,LG1,Total,316,4674,4243678,10758908834,248958196860,259717105694
2021-08-02,LG1,UG,137,2508,2485577,6718130431,176065996336,182784126767
2021-08-02,LG3,Alumni,11,98,117240,67735444,4371482381,4439217825
2021-08-02,LG3,Non-HKUST,33,175,152506,153915290,4655543224,4809458514
2021-08-02,LG3,Others(HKUST),8,26,3372,113417,1386927,1500344
2021-08-02,LG3,RPG,149,651,576869,861255046,26905116555,27766371601
2021-08-02,LG3,Staff,234,921,206930,363073300,9802117209,10165190509
2021-08-02,LG3,TPG,21,138,131600,151547174,3317763926,3469311100
2021-08-02,LG3,Total,605,3015,2121812,2714696691,106674819082,109389515773
2021-08-02,LG3,UG,149,1006,933295,1117057020,57621408860,58738465880
2021-08-02,LG4,Alumni,19,87,79234,71626888,11996965728,12068592616
2021-08-02,LG4,Non-HKUST,51,181,108730,76769462,13200044754,13276814216
2021-08-02,LG4,Others(HKUST),17,80,78891,47197193,158781009,205978202
2021-08-02,LG4,RPG,424,840,374113,731542844,15490697717,16222240561
2021-08-02,LG4,Staff,497,1574,358150,717340231,7002926974,7720267205
2021-08-02,LG4,TPG,28,96,79782,21605549,3039154787,3060760336
2021-08-02,LG4,Total,1343,4662,1830793,2124809845,107669019246,109793829091
2021-08-02,LG4,UG,307,1804,751893,458727678,56780448277,57239175955
2021-08-03,1,Alumni,4,16,36406,102360421,5612747545,5715107966
2021-08-03,1,Non-HKUST,4,15,49043,26307197,6602504693,6628811890
2021-08-03,1,Others(HKUST),6,72,159222,25848633,829955799,855804432
2021-08-03,1,RPG,32,204,311970,324493568,9052363598,9376857166
2021-08-03,1,Staff,79,1415,784606,264116169,6710352856,6974469025
2021-08-03,1,TPG,6,394,202461,115599663,9656177532,9771777195
2021-08-03,1,Total,199,2563,2101180,2302667490,58790835621,61093503111
2021-08-03,1,UG,68,447,557472,1443941839,20326733598,21770675437
2021-08-03,All-Floors,Alumni,19,396,407863,497043095,15870516464,16367559559
2021-08-03,All-Floors,Non-HKUST,110,746,743619,989459293,38923773762,39913233055
2021-08-03,All-Floors,Others(HKUST),30,263,458892,81464034,3148957295,3230421329
2021-08-03,All-Floors,RPG,720,4253,2634640,4889906417,122168505420,127058411837
2021-08-03,All-Floors,Staff,777,6246,2611264,1459749961,46756889284,48216639245
2021-08-03,All-Floors,TPG,51,1512,1131631,1290155980,49886580513,51176736493
2021-08-03,All-Floors,Total,2278,21890,13607612,30222834694,579267815510,609490650204
2021-08-03,All-Floors,UG,571,8474,5619703,21015055914,302512592772,323527648686
2021-08-03,G,Alumni,12,130,52368,68247858,1789956993,1858204851
2021-08-03,G,Non-HKUST,42,225,163667,121046313,3846238748,3967285061
2021-08-03,G,Others(HKUST),9,40,53814,8755350,88806692,97562042
2021-08-03,G,RPG,327,1488,558057,940407885,18813238443,19753646328
2021-08-03,G,Staff,283,1797,986545,571251083,16769970517,17341221600
2021-08-03,G,TPG,44,579,355594,286867305,11451532978,11738400283
2021-08-03,G,Total,1023,6699,2650285,3510609169,77125858240,80636467409
2021-08-03,G,UG,306,2440,480240,1514033375,24366113869,25880147244
2021-08-03,LG1,Alumni,6,135,108383,141601745,3203387639,3344989384
2021-08-03,LG1,Non-HKUST,27,169,154387,423437655,7369811275,7793248930
2021-08-03,LG1,Others(HKUST),5,22,163326,12032887,1663649913,1675682800
2021-08-03,LG1,RPG,67,1006,1004562,2085311526,56318818004,58404129530
2021-08-03,LG1,Staff,72,805,300782,215341018,4340199290,4555540308
2021-08-03,LG1,TPG,17,187,177301,471618001,7296712067,7768330068
2021-08-03,LG1,Total,357,5441,4823844,18238581829,259162786095,277401367924
2021-08-03,LG1,UG,163,3117,2915103,14889238997,178970207907,193859446904
2021-08-03,LG3,Alumni,8,87,114698,81613565,1648623960,1730237525
2021-08-03,LG3,Non-HKUST,34,134,134196,123761449,4761617974,4885379423
2021-08-03,LG3,Others(HKUST),9,20,650,23331938,29579361,52911299
2021-08-03,LG3,RPG,157,557,461165,912150774,15509519334,16421670108
2021-08-03,LG3,Staff,231,895,190037,122813098,5563408532,5686221630
2021-08-03,LG3,TPG,17,180,253822,254746330,11216040887,11470787217
2021-08-03,LG3,Total,659,3183,2331970,4265415039,93349448447,97614863486
2021-08-03,LG3,UG,203,1310,1177402,2746997885,54620658399,57367656284
2021-08-03,LG4,Alumni,10,28,96008,103219506,3615800327,3719019833
2021-08-03,LG4,Non-HKUST,58,203,242326,294906679,16343601072,16638507751
2021-08-03,LG4,Others(HKUST),24,109,81880,11495226,536965530,548460756
2021-08-03,LG4,RPG,484,998,298886,627542664,22474566041,23102108705
2021-08-03,LG4,Staff,534,1334,349294,286228593,13372958089,13659186682
2021-08-03,LG4,TPG,23,172,142453,161324681,10266117049,10427441730
2021-08-03,LG4,Total,1518,4004,1700333,1905561167,90838887107,92744448274
2021-08-03,LG4,UG,385,1160,489486,420843818,24228878999,24649722817
2021-08-04,1,Alumni,1,6,25558,51630917,4911512487,4963143404
2021-08-04,1,Non-HKUST,9,81,51575,21103538,5254242832,5275346370
2021-08-04,1,Others(HKUST),5,89,184423,65675937,2008094397,2073770334
2021-08-04,1,RPG,20,135,211625,145128030,3831031355,3976159385
2021-08-04,1,Staff,63,1385,733274,181925748,5972235548,6154161296
2021-08-04,1,TPG,5,100,171948,133937096,12939082512,13073019608
2021-08-04,1,Total,169,2268,1894703,1113181075,55775172862,56888353937
2021-08-04,1,UG,66,472,516300,513779809,20858973731,21372753540
2021-08-04,All-Floors,Alumni,23,538,377553,523022300,28504021767,29027044067
2021-08-04,All-Floors,Non-HKUST,124,1131,788165,1114739703,43274836569,44389576272
2021-08-04,All-Floors,Others(HKUST),27,358,566454,187271338,5422505734,5609777072
2021-08-04,All-Floors,RPG,614,4120,2497489,4120287614,96897548747,101017836361
2021-08-04,All-Floors,Staff,719,7011,2435511,1145355527,35955594395,37100949922
2021-08-04,All-Floors,TPG,57,1387,1165499,1399157087,73931335758,75330492845
2021-08-04,All-Floors,Total,2135,23536,13246804,16478846338,600003901814,616482748152
2021-08-04,All-Floors,UG,571,8991,5416133,7989012769,316018058844,324007071613
2021-08-04,G,Alumni,13,162,38391,66539538,1618784739,1685324277
2021-08-04,G,Non-HKUST,56,481,273322,121322157,5739960008,5861282165
2021-08-04,G,Others(HKUST),10,80,111398,34592919,650350732,684943651
2021-08-04,G,RPG,143,1367,583776,635097798,23619986336,24255084134
2021-08-04,G,Staff,216,2097,799830,347863588,11997123529,12344987117
2021-08-04,G,TPG,31,646,403866,285523967,13906468101,14191992068
2021-08-04,G,Total,725,7574,2804493,2137016948,80253163704,82390180652
2021-08-04,G,UG,256,2741,593910,646076981,22720490259,23366567240
2021-08-04,LG1,Alumni,7,142,89626,213933008,6439525541,6653458549
2021-08-04,LG1,Non-HKUST,29,105,148724,245980536,8509595834,8755576370
2021-08-04,LG1,Others(HKUST),4,26,129214,11861379,874025779,885887158
2021-08-04,LG1,RPG,61,738,595363,1542717943,19447748689,20990466632
2021-08-04,LG1,Staff,91,719,319070,169709029,6050385564,6220094593
2021-08-04,LG1,TPG,17,271,199752,541611997,6776752246,7318364243
2021-08-04,LG1,Total,351,4348,3547623,6278267979,214466948269,220745216248
2021-08-04,LG1,UG,142,2347,2065874,3552454087,166368914616,169921368703
2021-08-04,LG3,Alumni,10,103,79003,78984485,8714154683,8793139168
2021-08-04,LG3,Non-HKUST,51,221,170378,203152434,10465350188,10668502622
2021-08-04,LG3,Others(HKUST),6,53,53407,52011810,945217235,997229045
2021-08-04,LG3,RPG,141,640,630304,1255570582,28802281563,30057852145
2021-08-04,LG3,Staff,209,1073,286504,143547762,4215154823,4358702585
2021-08-04,LG3,TPG,17,217,332085,407685770,37563836944,37971522714
2021-08-04,LG3,Total,637,3589,2651054,4132746845,148808589804,152941336649
2021-08-04,LG3,UG,203,1282,1099373,1991794002,58102594368,60094388370
2021-08-04,LG4,Alumni,16,125,144975,111934352,6820044317,6931978669
2021-08-04,LG4,Non-HKUST,70,243,144166,523181038,13305687707,13828868745
2021-08-04,LG4,Others(HKUST),22,110,88012,23129293,944817591,967946884
2021-08-04,LG4,RPG,508,1240,476421,541773261,21196500804,21738274065
2021-08-04,LG4,Staff,569,1737,296833,302309400,7720694931,8023004331
2021-08-04,LG4,TPG,40,153,57848,30398257,2745195955,2775594212
2021-08-04,LG4,Total,1674,5757,2348931,2817633491,100700027175,103517660666
2021-08-04,LG4,UG,449,2149,1140676,1284907890,47967085870,49251993760
2021-08-05,1,Alumni,1,10,27269,132251957,6563131217,6695383174
2021-08-05,1,Non-HKUST,6,24,15080,15911717,471125338,487037055
2021-08-05,1,Others(HKUST),4,38,139480,35659674,3293026097,3328685771
2021-08-05,1,RPG,26,261,343479,283149606,11528313042,11811462648
2021-08-05,1,Staff,75,1489,1061373,646498648,11847167628,12493666276
2021-08-05,1,TPG,10,270,320582,286973654,13591060372,13878034026
2021-08-05,1,Total,158,2304,2122440,1615179723,53273827375,54889007098
2021-08-05,1,UG,36,212,215177,214734467,5980003681,6194738148
2021-08-05,All-Floors,Alumni,21,389,374861,656900748,31545310704,32202211452
2021-08-05,All-Floors,Non-HKUST,117,1042,836944,1108040342,35946378100,37054418442
2021-08-05,All-Floors,Others(HKUST),25,185,312184,56092981,5748731872,5804824853
2021-08-05,All-Floors,RPG,529,3831,2599805,2903844401,84607662591,87511506992
2021-08-05,All-Floors,Staff,726,6554,2554787,2545075388,49390924642,51936000030
2021-08-05,All-Floors,TPG,44,1433,1377100,1699465736,62608276583,64307742319
2021-08-05,All-Floors,Total,1941,21082,12651455,13629434091,420985681958,434615116049
2021-08-05,All-Floors,UG,479,7648,4595774,4660014495,151138397466,155798411961
2021-08-05,G,Alumni,12,112,22874,21392881,5077683054,5099075935
2021-08-05,G,Non-HKUST,45,349,188724,170931537,7695407733,7866339270
2021-08-05,G,Others(HKUST),6,22,63043,176236,6577401,6753637
2021-08-05,G,RPG,121,1340,602025,740066015,17339264678,18079330693
2021-08-05,G,Staff,173,1744,817368,537195002,11539135908,12076330910
2021-08-05,G,TPG,32,564,280270,521399650,18580095490,19101495140
2021-08-05,G,Total,619,6719,2698737,2495091717,83442055898,85937147615
2021-08-05,G,UG,230,2588,724433,503930396,23203891634,23707822030
2021-08-05,LG1,Alumni,11,174,157450,392980196,12704115921,13097096117
2021-08-05,LG1,Non-HKUST,29,200,239766,620568143,15046512859,15667081002
2021-08-05,LG1,Others(HKUST),4,15,62908,8753364,2153714916,2162468280
2021-08-05,LG1,RPG,68,679,700867,697402472,16322362241,17019764713
2021-08-05,LG1,Staff,76,835,360856,203797018,13233057771,13436854789
2021-08-05,LG1,TPG,19,320,391033,624640467,15319727310,15944367777
2021-08-05,LG1,Total,367,4973,4343344,5535404348,164067911132,169603315480
2021-08-05,LG1,UG,160,2750,2430464,2987262688,89288420114,92275682802
2021-08-05,LG3,Alumni,6,67,123186,62046010,5881201292,5943247302
2021-08-05,LG3,Non-HKUST,42,159,189050,151160298,7069737548,7220897846
2021-08-05,LG3,Others(HKUST),9,19,2545,5057038,96549135,101606173
2021-08-05,LG3,RPG,185,676,638769,508762711,23680191340,24188954051
2021-08-05,LG3,Staff,237,1059,161425,436246023,4976346220,5412592243
2021-08-05,LG3,TPG,20,119,157869,171650248,5672880284,5844530532
2021-08-05,LG3,Total,698,3214,2096256,2054483444,70112838012,72167321456
2021-08-05,LG3,UG,199,1115,823412,719561116,22735932193,23455493309
2021-08-05,LG4,Alumni,9,26,44082,48229704,1319179220,1367408924
2021-08-05,LG4,Non-HKUST,70,310,204324,149468647,5663594622,5813063269
2021-08-05,LG4,Others(HKUST),20,91,44208,6446669,198864323,205310992
2021-08-05,LG4,RPG,411,875,314665,674463597,15737531290,16411994887
2021-08-05,LG4,Staff,564,1427,153765,721338697,7795217115,8516555812
2021-08-05,LG4,TPG,26,160,227346,94801717,9444513127,9539314844
2021-08-05,LG4,Total,1414,3872,1390678,1929274859,50089049541,52018324400
2021-08-05,LG4,UG,314,983,402288,234525828,9930149844,10164675672
2021-08-06,1,Alumni,2,7,21818,47986883,2615366508,2663353391
2021-08-06,1,Non-HKUST,3,21,27375,16111114,594882108,610993222
2021-08-06,1,Others(HKUST),5,67,92254,29569596,1333924955,1363494551
2021-08-06,1,RPG,20,174,223930,215924376,20977475525,21193399901
2021-08-06,1,Staff,89,1407,1089252,309169826,8234105748,8543275574
2021-08-06,1,TPG,4,83,58765,60577201,7872542935,7933120136
2021-08-06,1,Total,179,2121,1948318,945554914,52662150602,53607705516
2021-08-06,1,UG,56,362,434924,266215918,11033852823,11300068741
2021-08-06,All-Floors,Alumni,20,322,322991,555315040,21380875179,21936190219
2021-08-06,All-Floors,Non-HKUST,82,600,485143,508689892,18096579193,18605269085
2021-08-06,All-Floors,Others(HKUST),29,262,154172,61180255,5819592862,5880773117
2021-08-06,All-Floors,RPG,400,2736,1842582,3906021530,97712894586,101618916116
2021-08-06,All-Floors,Staff,542,5632,2495097,1638525452,48410927403,50049452855
2021-08-06,All-Floors,TPG,39,961,922308,1358597055,59918046398,61276643453
2021-08-06,All-Floors,Total,1508,16898,10610250,23666093211,527444029535,551110122746
2021-08-06,All-Floors,UG,396,6385,4387957,15637763987,276105113914,291742877901
2021-08-06,G,Alumni,9,89,50165,76173686,1741426214,1817599900
2021-08-06,G,Non-HKUST,32,184,129199,74263241,2149856093,2224119334
2021-08-06,G,Others(HKUST),8,58,6919,2172103,64464239,66636342
2021-08-06,G,RPG,106,945,493258,985851761,30829147985,31814999746
2021-08-06,G,Staff,174,1445,688462,369862130,21289357212,21659219342
2021-08-06,G,TPG,25,375,331683,292000333,9207644988,9499645321
2021-08-06,G,Total,548,4871,2290105,4298442156,114665121356,118963563512
2021-08-06,G,UG,194,1775,590419,2498118902,49383224625,51881343527
2021-08-06,LG1,Alumni,9,137,159693,380559672,10994131859,11374691531
2021-08-06,LG1,Non-HKUST,19,95,114406,163640345,2639242007,2802882352
2021-08-06,LG1,Others(HKUST),6,23,24724,15453330,3858769115,3874222445
2021-08-06,LG1,RPG,64,596,516454,1219296522,22019512985,23238809507
2021-08-06,LG1,Staff,92,583,205701,196326757,6622396520,6818723277
2021-08-06,LG1,TPG,16,187,154423,641464830,14270587469,14912052299
2021-08-06,LG1,Total,341,3186,3208102,14234502929,192485075706,206719578635
2021-08-06,LG1,UG,135,1565,2032701,11617761473,132080435751,143698197224
2021-08-06,LG3,Alumni,10,74,57214,14364436,294407352,308771788
2021-08-06,LG3,Non-HKUST,45,140,97452,176839202,9146129927,9322969129
2021-08-06,LG3,Others(HKUST),22,56,3202,7778855,179766377,187545232
2021-08-06,LG3,RPG,279,692,414357,1342716171,18157646984,19500363155
2021-08-06,LG3,Staff,370,1370,321602,590313576,8125621410,8715934986
2021-08-06,LG3,TPG,19,118,86549,55159401,3074772421,3129931822
2021-08-06,LG3,Total,993,3893,1595961,2846974808,73457628122,76304602930
2021-08-06,LG3,UG,248,1443,615585,659803167,34479283651,35139086818
2021-08-06,LG4,Alumni,6,15,34101,36230363,5735543246,5771773609
2021-08-06,LG4,Non-HKUST,35,160,116711,77835990,3566469058,3644305048
2021-08-06,LG4,Others(HKUST),12,58,27073,6206371,382668176,388874547
2021-08-06,LG4,RPG,174,329,194583,142232700,5729111107,5871343807
2021-08-06,LG4,Staff,214,827,190080,172853163,4139446513,4312299676
2021-08-06,LG4,TPG,15,198,290888,309395290,25492498585,25801893875
2021-08-06,LG4,Total,637,2827,1567764,1340618404,94174053749,95514672153
2021-08-06,LG4,UG,181,1240,714328,595864527,49128317064,49724181591
2021-08-07,1,Alumni,3,26,14155,12142234,1923948215,1936090449
2021-08-07,1,Non-HKUST,2,3,8757,3610165,60587151,64197316
2021-08-07,1,Others(HKUST),1,2,34495,1214155,11463952,12678107
2021-08-07,1,RPG,22,158,199049,138501792,7587150981,7725652773
2021-08-07,1,Staff,12,38,42750,49290817,380345984,429636801
2021-08-07,1,TPG,1,32,50679,19107409,4696385102,4715492511
2021-08-07,1,Total,65,432,516094,565237843,23100118793,23665356636
2021-08-07,1,UG,24,173,166209,341371271,8440237408,8781608679
2021-08-07,All-Floors,Alumni,30,630,319636,273993420,29819894846,30093888266
2021-08-07,All-Floors,Non-HKUST,59,441,257840,141292200,6035414519,6176706719
2021-08-07,All-Floors,Others(HKUST),15,92,51641,7675964,665987121,673663085
2021-08-07,All-Floors,RPG,246,1425,848588,1404235424,39740538361,41144773785
2021-08-07,All-Floors,Staff,143,1126,477955,416682070,17063602305,17480284375
2021-08-07,All-Floors,TPG,35,486,460622,697880178,20674898604,21372778782
2021-08-07,All-Floors,Total,852,7869,4336478,7281198004,219330927431,226612125435
2021-08-07,All-Floors,UG,324,3669,1920196,4339438748,105330591675,109670030423
2021-08-07,G,Alumni,16,287,50556,42891454,3666407501,3709298955
2021-08-07,G,Non-HKUST,24,114,74056,21982955,491832451,513815406
2021-08-07,G,Others(HKUST),2,3,120,13925,31299,45224
2021-08-07,G,RPG,64,482,243853,289976896,8906672501,9196649397
2021-08-07,G,Staff,47,276,109549,83298398,2737511838,2820810236
2021-08-07,G,TPG,17,141,141075,81188982,4141208043,4222397025
2021-08-07,G,Total,274,2291,843053,719675985,31473046981,32192722966
2021-08-07,G,UG,104,988,223844,200323375,11529383348,11729706723
2021-08-07,LG1,Alumni,11,114,120013,125200358,20021007154,20146207512
2021-08-07,LG1,Non-HKUST,18,74,106398,90019158,3079834864,3169854022
2021-08-07,LG1,Others(HKUST),6,8,165,6621,18319,24940
2021-08-07,LG1,RPG,38,234,216436,476179619,11623977180,12100156799
2021-08-07,LG1,Staff,28,145,110295,72962547,4241214346,4314176893
2021-08-07,LG1,TPG,11,198,151342,477182656,6071610952,6548793608
2021-08-07,LG1,Total,206,1917,1772992,4575923556,104746821849,109322745405
2021-08-07,LG1,UG,94,1144,1068343,3334372597,59709159034,63043531631
2021-08-07,LG3,Alumni,17,21,670,30367,63620,93987
2021-08-07,LG3,Non-HKUST,29,141,14550,5901278,966548661,972449939
2021-08-07,LG3,Others(HKUST),11,50,3626,425462,17653783,18079245
2021-08-07,LG3,RPG,177,395,90564,122962885,9950122115,10073085000
2021-08-07,LG3,Staff,91,458,127147,88893834,4769769387,4858663221
2021-08-07,LG3,TPG,23,66,59975,59958877,2947851043,3007809920
2021-08-07,LG3,Total,570,1990,513928,504646567,36446005072,36950651639
2021-08-07,LG3,UG,222,859,217396,226473864,17793996463,18020470327
2021-08-07,LG4,Alumni,14,182,134242,93729007,4208468356,4302197363
2021-08-07,LG4,Non-HKUST,20,109,54079,19778644,1436611392,1456390036
2021-08-07,LG4,Others(HKUST),8,29,13235,6015801,636819768,642835569
2021-08-07,LG4,RPG,73,156,98686,376614232,1672615584,2049229816
2021-08-07,LG4,Staff,54,209,88214,122236474,4934760750,5056997224
2021-08-07,LG4,TPG,11,49,57551,60442254,2817843464,2878285718
2021-08-07,LG4,Total,315,1239,690411,915714053,23564934736,24480648789
2021-08-07,LG4,UG,135,505,244404,236897641,7857815422,8094713063
2021-08-08,1,Alumni,0,0,0,0,0,0
2021-08-08,1,Non-HKUST,5,9,9004,3572700,239125636,242698336
2021-08-08,1,Others(HKUST),3,4,44634,1520982,22090044,23611026
2021-08-08,1,RPG,16,75,75500,63624439,3934949806,3998574245
2021-08-08,1,Staff,13,69,91574,47256719,7606492769,7653749488
2021-08-08,1,TPG,3,11,9152,9346850,181437066,190783916
2021-08-08,1,Total,74,333,412594,227860201,16780370348,17008230549
2021-08-08,1,UG,34,165,182730,102538511,4796275027,4898813538
2021-08-08,All-Floors,Alumni,38,871,287817,251617201,23659047104,23910664305
2021-08-08,All-Floors,Non-HKUST,54,358,284939,197416132,6080539061,6277955193
2021-08-08,All-Floors,Others(HKUST),9,137,66083,5866009,119824960,125690969
2021-08-08,All-Floors,RPG,230,1598,885612,2233610480,47257708987,49491319467
2021-08-08,All-Floors,Staff,116,1446,536584,264018374,16256623407,16520641781
2021-08-08,All-Floors,TPG,25,409,322954,540524895,15158781915,15699306810
2021-08-08,All-Floors,Total,803,9955,5157044,6508449040,222025682574,228534131614
2021-08-08,All-Floors,UG,331,5136,2773055,3015395949,113493157140,116508553089
2021-08-08,G,Alumni,20,259,67737,36940610,1632985356,1669925966
2021-08-08,G,Non-HKUST,21,106,59646,27613064,1220416426,1248029490
2021-08-08,G,Others(HKUST),2,8,5316,1299743,45687933,46987676
2021-08-08,G,RPG,58,658,381733,597608007,27125174473,27722782480
2021-08-08,G,Staff,43,479,244277,58372078,2219388806,2277760884
2021-08-08,G,TPG,14,166,92765,76993600,1565907810,1642901410
2021-08-08,G,Total,303,3021,1282806,1354873009,71363501184,72718374193
2021-08-08,G,UG,145,1345,431332,556045907,37553940380,38109986287
2021-08-08,LG1,Alumni,16,119,66574,79268718,13777050372,13856319090
2021-08-08,LG1,Non-HKUST,17,89,94032,96611252,1168109294,1264720546
2021-08-08,LG1,Others(HKUST),1,18,1665,1080674,4866746,5947420
2021-08-08,LG1,RPG,37,344,177334,590554182,5404156240,5994710422
2021-08-08,LG1,Staff,36,208,41530,30332228,611984797,642317025
2021-08-08,LG1,TPG,6,96,110428,376698328,3877624422,4254322750
2021-08-08,LG1,Total,225,3036,2003463,2827713176,72870611587,75698324763
2021-08-08,LG1,UG,112,2162,1511900,1653167794,48026819716,49679987510
2021-08-08,LG3,Alumni,24,328,60783,79999544,3632304675,3712304219
2021-08-08,LG3,Non-HKUST,24,97,81154,50851024,2776285248,2827136272
2021-08-08,LG3,Others(HKUST),5,51,2790,823353,44130718,44954071
2021-08-08,LG3,RPG,167,370,205871,963842500,10148786186,11112628686
2021-08-08,LG3,Staff,70,463,141175,116571226,5523927008,5640498234
2021-08-08,LG3,TPG,18,86,67222,44496848,8840625215,8885122063
2021-08-08,LG3,Total,528,2245,894811,1726159781,46538135788,48264295569
2021-08-08,LG3,UG,220,850,335816,469575286,15572076738,16041652024
2021-08-08,LG4,Alumni,19,165,92723,55408329,4616706701,4672115030
2021-08-08,LG4,Non-HKUST,14,57,41103,18768092,676602457,695370549
2021-08-08,LG4,Others(HKUST),5,56,11678,1141257,3049519,4190776
2021-08-08,LG4,RPG,81,151,45174,17981352,644642282,662623634
2021-08-08,LG4,Staff,38,227,18028,11486123,294830027,306316150
2021-08-08,LG4,TPG,12,50,43387,32989269,693187402,726176671
2021-08-08,LG4,Total,287,1320,563370,371842873,14473063667,14844906540
2021-08-08,LG4,UG,118,614,311277,234068451,7544045279,7778113730
2021-08-09,1,Alumni,1,5,14789,22235364,793476538,815711902
2021-08-09,1,Non-HKUST,6,73,27558,12590836,416730986,429321822
2021-08-09,1,Others(HKUST),4,70,120010,34424793,1449065167,1483489960
2021-08-09,1,RPG,27,186,168991,120232763,26464502502,26584735265
2021-08-09,1,Staff,69,884,616559,207738917,6092004977,6299743894
2021-08-09,1,TPG,9,139,58300,56252995,5660555323,5716808318
2021-08-09,1,Total,164,1681,1346294,707023886,52684845489,53391869375
2021-08-09,1,UG,48,324,340087,253548218,11808509996,12062058214
2021-08-09,All-Floors,Alumni,20,296,210094,310269267,4670518990,4980788257
2021-08-09,All-Floors,Non-HKUST,78,525,357558,451728515,9583609409,10035337924
2021-08-09,All-Floors,Others(HKUST),26,243,175710,73184206,6438664917,6511849123
2021-08-09,All-Floors,RPG,382,3518,1633638,4141842341,101744445089,105886287430
2021-08-09,All-Floors,Staff,552,5071,1579207,1403300165,23972099209,25375399374
2021-08-09,All-Floors,TPG,40,1391,633296,661048658,27947708548,28608757206
2021-08-09,All-Floors,Total,1491,18027,7470105,10976357107,288431586973,299407944080
2021-08-09,All-Floors,UG,393,6983,2880602,3934983955,114074540811,118009524766
2021-08-09,G,Alumni,10,64,1710,648110,12100461,12748571
2021-08-09,G,Non-HKUST,28,155,69768,95055399,1240132934,1335188333
2021-08-09,G,Others(HKUST),11,68,16169,25554047,4312526948,4338080995
2021-08-09,G,RPG,125,1368,351516,471830600,18631355664,19103186264
2021-08-09,G,Staff,168,1625,432987,243294404,7170304054,7413598458
2021-08-09,G,TPG,31,808,297814,236664286,6512667871,6749332157
2021-08-09,G,Total,597,6389,1433356,1739267516,54628945365,56368212881
2021-08-09,G,UG,224,2301,263392,666220670,16749857433,17416078103
2021-08-09,LG1,Alumni,9,87,86725,259541686,3284497983,3544039669
2021-08-09,LG1,Non-HKUST,27,54,52001,55491321,1957407755,2012899076
2021-08-09,LG1,Others(HKUST),9,20,22482,983467,36393737,37377204
2021-08-09,LG1,RPG,80,886,569347,2990358799,29505350001,32495708800
2021-08-09,LG1,Staff,125,680,268035,362315555,6268752980,6631068535
2021-08-09,LG1,TPG,15,180,106253,181342298,6701120761,6882463059
2021-08-09,LG1,Total,436,3746,2246923,6010240781,101019188621,107029429402
2021-08-09,LG1,UG,171,1839,1142080,2160207655,53265665404,55425873059
2021-08-09,LG3,Alumni,12,66,45876,16853611,204618161,221471772
2021-08-09,LG3,Non-HKUST,42,149,105638,202191408,4050319353,4252510761
2021-08-09,LG3,Others(HKUST),15,52,1590,124995,368087,493082
2021-08-09,LG3,RPG,283,819,425166,315783915,22743600511,23059384426
2021-08-09,LG3,Staff,360,1122,129433,498835120,3177195728,3676030848
2021-08-09,LG3,TPG,23,174,119501,142068205,2247997030,2390065235
2021-08-09,LG3,Total,969,3763,1304757,1466553678,43573610327,45040164005
2021-08-09,LG3,UG,234,1381,477553,290696424,11149511457,11440207881
2021-08-09,LG4,Alumni,6,74,60994,10990496,375825847,386816343
2021-08-09,LG4,Non-HKUST,21,94,102593,86399551,1919018381,2005417932
2021-08-09,LG4,Others(HKUST),11,33,15459,12096904,640310978,652407882
2021-08-09,LG4,RPG,120,259,118618,243636264,4399636411,4643272675
2021-08-09,LG4,Staff,184,760,132193,91116169,1263841470,1354957639
2021-08-09,LG4,TPG,9,90,51428,44720874,6825367563,6870088437
2021-08-09,LG4,Total,493,2448,1138775,1053271246,36524997171,37578268417
2021-08-09,LG4,UG,142,1138,657490,564310988,21100996521,21665307509
2021-08-10,1,Alumni,2,9,28305,67556126,3450694336,3518250462
2021-08-10,1,Non-HKUST,7,58,82948,322821148,4813912107,5136733255
2021-08-10,1,Others(HKUST),5,93,90745,35280230,1100883903,1136164133
2021-08-10,1,RPG,33,144,163009,97921096,4958046389,5055967485
2021-08-10,1,Staff,77,1278,1069573,261684053,9286514254,9548198307
2021-08-10,1,TPG,9,297,136448,87468941,6330110956,6417579897
2021-08-10,1,Total,211,2480,2151103,1437433348,59437095409,60874528757
2021-08-10,1,UG,78,601,580075,564701754,29496933464,30061635218
2021-08-10,All-Floors,Alumni,25,517,455142,401119252,12685739297,13086858549
2021-08-10,All-Floors,Non-HKUST,109,955,748633,1787404028,29027610101,30815014129
2021-08-10,All-Floors,Others(HKUST),33,382,409752,160682833,5835311913,5995994746
2021-08-10,All-Floors,RPG,437,4160,2596189,4578552836,113590903569,118169456405
2021-08-10,All-Floors,Staff,623,5902,2485096,980730083,35692931576,36673661659
2021-08-10,All-Floors,TPG,62,1963,1376105,1648556017,68017673461,69666229478
2021-08-10,All-Floors,Total,1749,22006,13216471,16667492634,504213295395,520880788029
2021-08-10,All-Floors,UG,460,8127,5145554,7110447585,239363125478,246473573063
2021-08-10,G,Alumni,15,161,34416,52364222,583024212,635388434
2021-08-10,G,Non-HKUST,42,384,208119,75739032,1673529926,1749268958
2021-08-10,G,Others(HKUST),10,112,99839,54027816,2509945396,2563973212
2021-08-10,G,RPG,124,1492,714638,1352572162,37259380075,38611952237
2021-08-10,G,Staff,188,1815,560489,315977349,9513185794,9829163143
2021-08-10,G,TPG,38,860,499546,299491616,32412654987,32712146603
2021-08-10,G,Total,630,7371,2847870,3156879302,141686750873,144843630175
2021-08-10,G,UG,213,2547,730823,1006707105,57735030483,58741737588
2021-08-10,LG1,Alumni,10,151,159310,197289099,4081588929,4278878028
2021-08-10,LG1,Non-HKUST,28,115,102443,155824634,2922371408,3078196042
2021-08-10,LG1,Others(HKUST),14,76,98995,48383423,1069560501,1117943924
2021-08-10,LG1,RPG,83,999,925899,2020474294,39618581735,41639056029
2021-08-10,LG1,Staff,136,803,366998,208003556,8421932526,8629936082
2021-08-10,LG1,TPG,34,415,429769,986821342,16742352509,17729173851
2021-08-10,LG1,Total,465,4730,4405541,7787968202,170078950522,177866918724
2021-08-10,LG1,UG,160,2171,2322127,4171171854,97222562914,101393734768
2021-08-10,LG3,Alumni,12,42,27257,12671508,128757666,141429174
2021-08-10,LG3,Non-HKUST,58,257,243481,323899244,5783148707,6107047951
2021-08-10,LG3,Others(HKUST),17,55,2601,188649,2735584,2924233
2021-08-10,LG3,RPG,299,1002,556678,973659317,26964462106,27938121423
2021-08-10,LG3,Staff,430,1298,235249,111832014,5541928806,5653760820
2021-08-10,LG3,TPG,36,227,189416,203606932,6926313294,7129920226
2021-08-10,LG3,Total,1135,4663,2064659,2535643651,72241315161,74776958812
2021-08-10,LG3,UG,283,1782,809977,909785987,26893968998,27803754985
2021-08-10,LG4,Alumni,9,154,205854,71238297,4441674154,4512912451
2021-08-10,LG4,Non-HKUST,35,141,111642,909119970,13834647953,14743767923
2021-08-10,LG4,Others(HKUST),10,46,117572,22802715,1152186529,1174989244
2021-08-10,LG4,RPG,175,523,235965,133925967,4790433264,4924359231
2021-08-10,LG4,Staff,213,708,252787,83233111,2929370196,3012603307
2021-08-10,LG4,TPG,27,164,120926,71167186,5606241715,5677408901
2021-08-10,LG4,Total,671,2762,1747298,1749568131,60769183430,62518751561
2021-08-10,LG4,UG,202,1026,702552,458080885,28014629619,28472710504
2021-08-11,1,Alumni,3,47,29617,84548770,3705980786,3790529556
2021-08-11,1,Non-HKUST,16,224,71820,51456661,2186017689,2237474350
2021-08-11,1,Others(HKUST),7,70,55000,117362504,2384427372,2501789876
2021-08-11,1,RPG,34,114,115753,60098763,1753129138,1813227901
2021-08-11,1,Staff,82,1891,753597,199006240,7798339567,7997345807
2021-08-11,1,TPG,9,54,55712,13257996,1444223278,1457481274
2021-08-11,1,Total,196,2720,1374844,991068182,30095645653,31086713835
2021-08-11,1,UG,45,320,293345,465337248,10823527823,11288865071
2021-08-11,All-Floors,Alumni,20,409,183833,217237885,6801204314,7018442199
2021-08-11,All-Floors,Non-HKUST,140,1461,681903,795804601,45320384299,46116188900
2021-08-11,All-Floors,Others(HKUST),29,527,239721,235244267,8133991595,8369235862
2021-08-11,All-Floors,RPG,595,4075,1902973,2960385630,80686522113,83646907743
2021-08-11,All-Floors,Staff,759,7312,2092466,1468446911,37014131455,38482578366
2021-08-11,All-Floors,TPG,47,967,578321,345158308,16201375433,16546533741
2021-08-11,All-Floors,Total,2052,22321,8867657,9997175654,331601706731,341598882385
2021-08-11,All-Floors,UG,462,7570,3188440,3974898052,137444097522,141418995574
2021-08-11,G,Alumni,9,162,25618,12062997,249160880,261223877
2021-08-11,G,Non-HKUST,58,446,185450,181446956,9930524471,10111971427
2021-08-11,G,Others(HKUST),9,130,30534,22210911,3134094111,3156305022
2021-08-11,G,RPG,129,1513,720146,694563656,48197960206,48892523862
2021-08-11,G,Staff,170,1999,496397,177816454,9521872065,9699688519
2021-08-11,G,TPG,26,494,180475,100383065,8367502552,8467885617
2021-08-11,G,Total,597,6924,1997513,1587474824,95091779209,96679254033
2021-08-11,G,UG,196,2180,358893,398990785,15690664924,16089655709
2021-08-11,LG1,Alumni,7,100,62611,41317432,1013708600,1055026032
2021-08-11,LG1,Non-HKUST,27,259,131003,211425468,5404985641,5616411109
2021-08-11,LG1,Others(HKUST),10,42,8357,159751,5022599,5182350
2021-08-11,LG1,RPG,72,795,571240,1790253241,14838557075,16628810316
2021-08-11,LG1,Staff,120,763,338393,192277506,5196147208,5388424714
2021-08-11,LG1,TPG,13,169,117891,96863858,2377449648,2474313506
2021-08-11,LG1,Total,410,4150,2577738,4039771069,95318613964,99358385033
2021-08-11,LG1,UG,161,2022,1348243,1707473813,66482743193,68190217006
2021-08-11,LG3,Alumni,8,55,43933,15189279,603705604,618894883
2021-08-11,LG3,Non-HKUST,84,308,154863,135631175,8872305706,9007936881
2021-08-11,LG3,Others(HKUST),20,161,90397,72155421,1098106115,1170261536
2021-08-11,LG3,RPG,347,845,261993,251624092,10142692665,10394316757
2021-08-11,LG3,Staff,518,1531,263690,656915166,8400810850,9057726016
2021-08-11,LG3,TPG,30,136,104110,51635530,1714842935,1766478465
2021-08-11,LG3,Total,1274,4637,1529569,1729980559,55975104652,57705085211
2021-08-11,LG3,UG,267,1601,610583,546829896,25142640777,25689470673
2021-08-11,LG4,Alumni,14,45,22054,64119407,1228648444,1292767851
2021-08-11,LG4,Non-HKUST,56,224,138767,215844341,18926550792,19142395133
2021-08-11,LG4,Others(HKUST),15,124,55433,23355680,1512341398,1535697078
2021-08-11,LG4,RPG,373,808,233841,163845878,5754183029,5918028907
2021-08-11,LG4,Staff,416,1128,240389,242431545,6096961765,6339393310
2021-08-11,LG4,TPG,19,114,120133,83017859,2297357020,2380374879
2021-08-11,LG4,Total,1176,3890,1387993,1648881020,55120563253,56769444273
2021-08-11,LG4,UG,283,1447,577376,856266310,19304520805,20160787115
2021-08-12,1,Alumni,2,4,25097,57537813,3975947994,4033485807
2021-08-12,1,Non-HKUST,7,16,32031,16534444,239792276,256326720
2021-08-12,1,Others(HKUST),3,62,63480,29700383,1669073097,1698773480
2021-08-12,1,RPG,13,83,154042,143155596,18201919744,18345075340
2021-08-12,1,Staff,50,1223,591820,139908228,2882505128,3022413356
2021-08-12,1,TPG,2,29,43410,31390354,3714155535,3745545889
2021-08-12,1,Total,112,1714,1355790,1115561957,46081192965,47196754922
2021-08-12,1,UG,35,297,445910,697335139,15397799191,16095134330
2021-08-12,All-Floors,Alumni,14,176,280897,309334737,14281929721,14591264458
2021-08-12,All-Floors,Non-HKUST,140,944,673548,514997153,21024961010,21539958163
2021-08-12,All-Floors,Others(HKUST),26,309,347640,158171836,6325654836,6483826672
2021-08-12,All-Floors,RPG,605,3871,2514738,6887992128,162836250465,169724242593
2021-08-12,All-Floors,Staff,625,4956,1934981,1177804103,30669786855,31847590958
2021-08-12,All-Floors,TPG,49,728,641539,504993419,26333007850,26838001269
2021-08-12,All-Floors,Total,1959,17128,10479693,26360372731,547042783468,573403156199
2021-08-12,All-Floors,UG,500,6144,4086350,16807079355,285571192731,302378272086
2021-08-12,G,Alumni,7,52,50229,39833115,1401837786,1441670901
2021-08-12,G,Non-HKUST,51,267,238399,178481697,7492217467,7670699164
2021-08-12,G,Others(HKUST),8,62,168897,51274922,1184563306,1235838228
2021-08-12,G,RPG,170,1026,572271,1180996045,58111994708,59292990753
2021-08-12,G,Staff,162,1228,636474,239795233,13422683252,13662478485
2021-08-12,G,TPG,24,258,169270,139688539,4338427996,4478116535
2021-08-12,G,Total,648,4448,2355081,3328925775,115314985376,118643911151
2021-08-12,G,UG,226,1555,519541,1498856224,29363260861,30862117085
2021-08-12,LG1,Alumni,5,24,44694,101505953,1715468446,1816974399
2021-08-12,LG1,Non-HKUST,19,113,102387,72569354,1656730522,1729299876
2021-08-12,LG1,Others(HKUST),6,12,55750,46204,90653,136857
2021-08-12,LG1,RPG,91,1006,822090,3862291940,31747127749,35609419689
2021-08-12,LG1,Staff,113,640,270048,134758727,4578022768,4712781495
2021-08-12,LG1,TPG,18,127,216856,176467882,7744445605,7920913487
2021-08-12,LG1,Total,437,3549,3303719,17515406770,196502401806,214017808576
2021-08-12,LG1,UG,185,1627,1791894,13167766710,149060516063,162228282773
2021-08-12,LG3,Alumni,6,22,53006,38366640,3324920188,3363286828
2021-08-12,LG3,Non-HKUST,66,369,164459,121899926,5744479048,5866378974
2021-08-12,LG3,Others(HKUST),14,86,25864,48120640,1144513734,1192634374
2021-08-12,LG3,RPG,304,833,600530,1194427889,39644062539,40838490428
2021-08-12,LG3,Staff,353,1001,268965,126582155,4407121280,4533703435
2021-08-12,LG3,TPG,25,182,107849,107063488,7343600027,7450663515
2021-08-12,LG3,Total,1004,3723,1960262,2581275452,129567049547,132148324999
2021-08-12,LG3,UG,236,1230,739589,944814714,67958352731,68903167445
2021-08-12,LG4,Alumni,6,74,107871,72091216,3863755307,3935846523
2021-08-12,LG4,Non-HKUST,62,179,136272,125511732,5891741697,6017253429
2021-08-12,LG4,Others(HKUST),17,87,33649,29029687,2327414046,2356443733
2021-08-12,LG4,RPG,396,923,365805,507120658,15131145725,15638266383
2021-08-12,LG4,Staff,339,864,167674,536759760,5379454427,5916214187
2021-08-12,LG4,TPG,28,132,104154,50383156,3192378687,3242761843
2021-08-12,LG4,Total,1153,3694,1504841,1819202777,59577153774,61396356551
2021-08-12,LG4,UG,305,1435,589416,498306568,23791263885,24289570453
2021-08-13,1,Alumni,2,22,30925,69350562,9558552075,9627902637
2021-08-13,1,Non-HKUST,8,36,50605,27446986,859257575,886704561
2021-08-13,1,Others(HKUST),4,66,92270,43442244,1391892615,1435334859
2021-08-13,1,RPG,12,153,180284,218513965,10817640700,11036154665
2021-08-13,1,Staff,48,1157,562890,185625815,9986929787,10172555602
2021-08-13,1,TPG,5,68,77281,53400467,2941880987,2995281454
2021-08-13,1,Total,110,1799,1347327,773655302,43953911036,44727566338
2021-08-13,1,UG,31,297,353072,175875263,8397757297,8573632560
2021-08-13,All-Floors,Alumni,19,153,226120,269096005,27554946324,27824042329
2021-08-13,All-Floors,Non-HKUST,128,853,523364,855000123,26263327303,27118327426
2021-08-13,All-Floors,Others(HKUST),25,337,260909,167626434,5662456549,5830082983
2021-08-13,All-Floors,RPG,546,3335,1858267,3733537672,129674090848,133407628520
2021-08-13,All-Floors,Staff,709,5248,2052644,2229484963,60384632770,62614117733
2021-08-13,All-Floors,TPG,47,930,671481,666772853,34486124465,35152897318
2021-08-13,All-Floors,Total,1955,16769,9389488,23245018936,556495847288,579740866224
2021-08-13,All-Floors,UG,481,5913,3796703,15323500886,272470269029,287793769915
2021-08-13,G,Alumni,7,34,13821,3890756,204976665,208867421
2021-08-13,G,Non-HKUST,41,213,94639,213682262,3525400013,3739082275
2021-08-13,G,Others(HKUST),5,38,3133,962907,9843634,10806541
2021-08-13,G,RPG,121,941,505032,841208687,75486911827,76328120514
2021-08-13,G,Staff,167,1152,688460,311591566,9265897866,9577489432
2021-08-13,G,TPG,28,372,197278,163882089,5269211641,5433093730
2021-08-13,G,Total,550,4082,1853940,2039099685,119410651938,121449751623
2021-08-13,G,UG,181,1332,351577,503881418,25648410292,26152291710
2021-08-13,LG1,Alumni,3,33,72861,112126572,7452438656,7564565228
2021-08-13,LG1,Non-HKUST,30,145,144883,380140766,8994889805,9375030571
2021-08-13,LG1,Others(HKUST),7,13,64306,7770809,1254400275,1262171084
2021-08-13,LG1,RPG,70,607,564318,1752413877,16606405339,18358819216
2021-08-13,LG1,Staff,100,727,346221,261498488,21280610912,21542109400
2021-08-13,LG1,TPG,16,184,132087,152051757,5130212561,5282264318
2021-08-13,LG1,Total,376,3591,3070981,15637288658,175306824764,190944113422
2021-08-13,LG1,UG,150,1882,1746305,12971286389,114587867216,127559153605
2021-08-13,LG3,Alumni,10,13,564,666171,62801173,63467344
2021-08-13,LG3,Non-HKUST,79,246,111386,106658289,6552846182,6659504471
2021-08-13,LG3,Others(HKUST),16,149,74322,69730934,1541752104,1611483038
2021-08-13,LG3,RPG,385,935,415389,711744689,14812137754,15523882443
2021-08-13,LG3,Staff,479,1395,294332,399030652,11964451516,12363482168
2021-08-13,LG3,TPG,35,183,138782,125791762,13431008809,13556800571
2021-08-13,LG3,Total,1299,4102,1776314,2411713451,101524658550,103936372001
2021-08-13,LG3,UG,295,1181,741539,998090954,53159661012,54157751966
2021-08-13,LG4,Alumni,12,51,107949,83061944,10276177755,10359239699
2021-08-13,LG4,Non-HKUST,53,213,121851,127071820,6330933728,6458005548
2021-08-13,LG4,Others(HKUST),11,71,26878,45719540,1464567921,1510287461
2021-08-13,LG4,RPG,334,699,193244,209656454,11950995228,12160651682
2021-08-13,LG4,Staff,368,817,160741,1071738442,7886742689,8958481131
2021-08-13,LG4,TPG,22,123,126053,171646778,7713810467,7885457245
2021-08-13,LG4,Total,1095,3195,1340926,2383261840,116299801000,118683062840
2021-08-13,LG4,UG,295,1221,604210,674366862,70676573212,71350940074
2021-08-14,1,Alumni,3,29,25832,15056083,702918840,717974923
2021-08-14,1,Non-HKUST,9,27,36498,46456606,1509313690,1555770296
2021-08-14,1,Others(HKUST),0,0,0,0,0,0
2021-08-14,1,RPG,5,31,64122,59799210,2078124061,2137923271
2021-08-14,1,Staff,8,51,24910,35054527,168517735,203572262
2021-08-14,1,TPG,3,137,62682,44450936,3759552723,3804003659
2021-08-14,1,Total,41,343,337995,289971280,19004633371,19294604651
2021-08-14,1,UG,13,68,123951,89153918,10786206322,10875360240
2021-08-14,All-Floors,Alumni,25,343,150103,187794235,37072299073,37260093308
2021-08-14,All-Floors,Non-HKUST,116,602,361316,304293566,14936572797,15240866363
2021-08-14,All-Floors,Others(HKUST),16,131,151652,37260368,4542569522,4579829890
2021-08-14,All-Floors,RPG,355,1379,477466,1179875984,26980506935,28160382919
2021-08-14,All-Floors,Staff,202,1019,287876,373348455,11861577440,12234925895
2021-08-14,All-Floors,TPG,34,535,287674,241731055,12112333806,12354064861
2021-08-14,All-Floors,Total,1181,7617,3352225,4865661845,201458967255,206324629100
2021-08-14,All-Floors,UG,433,3608,1636138,2541358182,93953107682,96494465864
2021-08-14,G,Alumni,15,182,32952,52177626,2706220752,2758398378
2021-08-14,G,Non-HKUST,27,185,97083,66998030,2626318443,2693316473
2021-08-14,G,Others(HKUST),1,3,64923,4784852,4425745362,4430530214
2021-08-14,G,RPG,38,299,126437,88225120,4063764602,4151989722
2021-08-14,G,Staff,29,248,75603,119451607,1681109280,1800560887
2021-08-14,G,TPG,14,145,55012,62768726,1948899768,2011668494
2021-08-14,G,Total,228,1962,636008,566919185,24699298999,25266218184
2021-08-14,G,UG,104,900,183998,172513224,7247240792,7419754016
2021-08-14,LG1,Alumni,9,46,8907,29892205,2938302469,2968194674
2021-08-14,LG1,Non-HKUST,16,52,83005,38852551,1586893357,1625745908
2021-08-14,LG1,Others(HKUST),1,1,53798,3010872,19313224,22324096
2021-08-14,LG1,RPG,38,168,180351,323150699,13384820212,13707970911
2021-08-14,LG1,Staff,26,63,30055,3285368,47176282,50461650
2021-08-14,LG1,TPG,7,80,58422,44050631,2880500835,2924551466
2021-08-14,LG1,Total,215,1215,1321191,1255832754,71174740407,72430573161
2021-08-14,LG1,UG,118,805,906653,813590428,50317734028,51131324456
2021-08-14,LG3,Alumni,12,44,21152,18360584,8805500238,8823860822
2021-08-14,LG3,Non-HKUST,81,182,97901,94299123,7071779924,7166079047
2021-08-14,LG3,Others(HKUST),14,94,29279,28448067,58829534,87277601
2021-08-14,LG3,RPG,298,547,72074,619402999,4668742912,5288145911
2021-08-14,LG3,Staff,161,415,100757,110456634,6029201041,6139657675
2021-08-14,LG3,TPG,26,60,18973,16486125,1239646332,1256132457
2021-08-14,LG3,Total,921,2388,590787,1747609833,44147919131,45895528964
2021-08-14,LG3,UG,329,1046,250651,860156301,16274219150,17134375451
2021-08-14,LG4,Alumni,9,42,61260,72307737,21919356774,21991664511
2021-08-14,LG4,Non-HKUST,42,156,46829,57687256,2142267383,2199954639
2021-08-14,LG4,Others(HKUST),6,33,3652,1016577,38681402,39697979
2021-08-14,LG4,RPG,198,334,34482,89297956,2785055148,2874353104
2021-08-14,LG4,Staff,90,242,56551,105100319,3935573102,4040673421
2021-08-14,LG4,TPG,15,113,92585,73974637,2283734148,2357708785
2021-08-14,LG4,Total,626,1709,466244,1005328793,42432375347,43437704140
2021-08-14,LG4,UG,266,789,170885,605944311,9327707390,9933651701
2021-08-15,1,Alumni,0,0,0,0,0,0
2021-08-15,1,Non-HKUST,1,9,415,144,464,608
2021-08-15,1,Others(HKUST),0,0,0,0,0,0
2021-08-15,1,RPG,0,0,0,0,0,0
2021-08-15,1,Staff,2,5,795,301483,1178013,1479496
2021-08-15,1,TPG,0,0,0,0,0,0
2021-08-15,1,Total,5,16,2348,306239,1186385,1492624
2021-08-15,1,UG,2,2,1138,4612,7908,12520
2021-08-15,All-Floors,Alumni,12,43,3326,1622447,47941155,49563602
2021-08-15,All-Floors,Non-HKUST,69,288,81857,33306735,1284529269,1317836004
2021-08-15,All-Floors,Others(HKUST),13,46,60877,418074,262464632,262882706
2021-08-15,All-Floors,RPG,424,964,39392,112959035,3189474969,3302434004
2021-08-15,All-Floors,Staff,166,462,37377,123902462,1172903887,1296806349
2021-08-15,All-Floors,TPG,42,96,22771,28849984,669377249,698227233
2021-08-15,All-Floors,Total,1167,3419,493733,635524867,17889858326,18525383193
2021-08-15,All-Floors,UG,441,1520,248133,334466130,11263167165,11597633295
2021-08-15,G,Alumni,4,7,631,1325889,42247901,43573790
2021-08-15,G,Non-HKUST,13,44,18833,2253289,16328024,18581313
2021-08-15,G,Others(HKUST),4,5,360,13024,2452,15476
2021-08-15,G,RPG,89,94,3432,4777981,157569745,162347726
2021-08-15,G,Staff,31,48,2940,3142325,50123425,53265750
2021-08-15,G,TPG,11,15,961,883729,17956770,18840499
2021-08-15,G,Total,250,341,31782,41710343,1023726629,1065436972
2021-08-15,G,UG,98,128,4625,29314106,739498312,768812418
2021-08-15,LG1,Alumni,1,1,55,25508,78478,103986
2021-08-15,LG1,Non-HKUST,2,33,16147,4839985,397388116,402228101
2021-08-15,LG1,Others(HKUST),2,2,53838,0,0,0
2021-08-15,LG1,RPG,24,28,2275,1170700,7146115,8316815
2021-08-15,LG1,Staff,13,23,5196,153471,7350758,7504229
2021-08-15,LG1,TPG,1,1,20,0,0,0
2021-08-15,LG1,Total,85,140,93712,12367531,752234461,764601992
2021-08-15,LG1,UG,42,52,16181,6177867,340270994,346448861
2021-08-15,LG3,Alumni,10,19,425,65878,1874580,1940458
2021-08-15,LG3,Non-HKUST,58,153,32226,22387248,836569922,858957170
2021-08-15,LG3,Others(HKUST),8,22,1637,286004,259619043,259905047
2021-08-15,LG3,RPG,317,497,19398,62035543,1010497050,1072532593
2021-08-15,LG3,Staff,124,254,13475,14631987,754513052,769145039
2021-08-15,LG3,TPG,32,52,20031,23312317,534879163,558191480
2021-08-15,LG3,Total,882,1823,220464,323459906,8787513635,9110973541
2021-08-15,LG3,UG,333,826,133272,200740929,5389560825,5590301754
2021-08-15,LG4,Alumni,8,16,2215,205172,3740196,3945368
2021-08-15,LG4,Non-HKUST,23,49,14236,3826069,34242743,38068812
2021-08-15,LG4,Others(HKUST),8,17,5042,119046,2843137,2962183
2021-08-15,LG4,RPG,237,345,14287,44974811,2014262059,2059236870
2021-08-15,LG4,Staff,83,132,14971,105673196,359738639,465411835
2021-08-15,LG4,TPG,20,28,1759,4653938,116541316,121195254
2021-08-15,LG4,Total,613,1099,145427,257680848,7325197216,7582878064
2021-08-15,LG4,UG,234,512,92917,98228616,4793829126,4892057742
2021-08-16,1,Alumni,1,4,18621,144466296,3979259351,4123725647
2021-08-16,1,Non-HKUST,5,68,68746,183902903,1361367638,1545270541
2021-08-16,1,Others(HKUST),3,81,47598,15490521,683828913,699319434
2021-08-16,1,RPG,7,134,60066,168043216,3211175290,3379218506
2021-08-16,1,Staff,50,1136,532923,128596035,3962257305,4090853340
2021-08-16,1,TPG,4,48,26746,5268933,348137725,353406658
2021-08-16,1,Total,101,1986,1091550,781073338,22939746923,23720820261
2021-08-16,1,UG,31,515,336850,135305434,9393720701,9529026135
2021-08-16,All-Floors,Alumni,17,317,232531,364090318,13925691496,14289781814
2021-08-16,All-Floors,Non-HKUST,164,954,523761,1106266451,23453024198,24559290649
2021-08-16,All-Floors,Others(HKUST),27,402,145211,52986770,2157622302,2210609072
2021-08-16,All-Floors,RPG,658,4142,1582895,10258133625,168842253074,179100386699
2021-08-16,All-Floors,Staff,713,5866,1532605,1633716265,34588645861,36222362126
2021-08-16,All-Floors,TPG,49,802,459810,416520152,21534011189,21950531341
2021-08-16,All-Floors,Total,2164,19813,7484760,18985798994,418389981795,437375780789
2021-08-16,All-Floors,UG,536,7330,3007947,5154085413,153888733675,159042819088
2021-08-16,G,Alumni,11,98,37701,45276917,859149479,904426396
2021-08-16,G,Non-HKUST,49,262,106013,295938463,4294279022,4590217485
2021-08-16,G,Others(HKUST),13,76,8505,1499531,61416854,62916385
2021-08-16,G,RPG,283,1597,470619,2755708623,130779337244,133535045867
2021-08-16,G,Staff,231,1531,391201,276820799,7886062031,8162882830
2021-08-16,G,TPG,27,387,117190,104287361,3867888449,3972175810
2021-08-16,G,Total,902,6280,1477284,4309994499,195529689203,199839683702
2021-08-16,G,UG,288,2329,346055,830462805,47781556124,48612018929
2021-08-16,LG1,Alumni,6,101,84716,113310367,3167238651,3280549018
2021-08-16,LG1,Non-HKUST,22,163,133598,200887167,2060611535,2261498702
2021-08-16,LG1,Others(HKUST),9,17,8949,2803587,155616039,158419626
2021-08-16,LG1,RPG,72,739,617367,4411318506,14595314117,19006632623
2021-08-16,LG1,Staff,109,711,259318,141899030,5583583241,5725482271
2021-08-16,LG1,TPG,13,138,124585,76504609,3598601433,3675106042
2021-08-16,LG1,Total,361,3426,2339571,7021234716,68277970410,75299205126
2021-08-16,LG1,UG,130,1557,1111038,2074511450,39117005394,41191516844
2021-08-16,LG3,Alumni,7,89,65351,26283380,4576690690,4602974070
2021-08-16,LG3,Non-HKUST,115,331,179932,342997038,10690023734,11033020772
2021-08-16,LG3,Others(HKUST),18,122,23646,4661751,47510887,52172638
2021-08-16,LG3,RPG,428,1075,312772,1316746447,12195349937,13512096384
2021-08-16,LG3,Staff,508,1681,200417,690994136,9189544449,9880538585
2021-08-16,LG3,TPG,35,152,136055,109264963,5123412950,5232677913
2021-08-16,LG3,Total,1473,4994,1595887,3415702740,76392843597,79808546337
2021-08-16,LG3,UG,362,1544,677714,924755025,34570310950,35495065975
2021-08-16,LG4,Alumni,8,25,26142,34753358,1343353325,1378106683
2021-08-16,LG4,Non-HKUST,55,130,35472,82540880,5046742269,5129283149
2021-08-16,LG4,Others(HKUST),16,106,56513,28531380,1209249609,1237780989
2021-08-16,LG4,RPG,325,597,122071,1606316833,8061076486,9667393319
2021-08-16,LG4,Staff,322,807,148746,395406265,7967198835,8362605100
2021-08-16,LG4,TPG,20,77,55234,121194286,8595970632,8717164918
2021-08-16,LG4,Total,1048,3127,980468,3457793701,55249731662,58707525363
2021-08-16,LG4,UG,302,1385,536290,1189050699,23026140506,24215191205
2021-08-17,1,Alumni,2,6,8448,55346815,2849179413,2904526228
2021-08-17,1,Non-HKUST,8,46,54719,26735734,1180255116,1206990850
2021-08-17,1,Others(HKUST),5,62,35705,13336494,206931644,220268138
2021-08-17,1,RPG,14,150,138787,119749950,5496568954,5616318904
2021-08-17,1,Staff,50,1064,543522,176999934,3920441204,4097441138
2021-08-17,1,TPG,11,162,127029,131627428,5206570962,5338198390
2021-08-17,1,Total,120,2158,1281570,803123842,33560975313,34364099155
2021-08-17,1,UG,30,668,373360,279327487,14701028020,14980355507
2021-08-17,All-Floors,Alumni,20,529,264385,204406375,6311730985,6516137360
2021-08-17,All-Floors,Non-HKUST,154,892,536370,559310034,27498457775,28057767809
2021-08-17,All-Floors,Others(HKUST),25,343,133730,71761659,1554487668,1626249327
2021-08-17,All-Floors,RPG,726,3917,1402861,2640766594,52622028360,55262794954
2021-08-17,All-Floors,Staff,731,5530,1603878,1789654796,32895545080,34685199876
2021-08-17,All-Floors,TPG,64,1132,556319,554712151,20772484540,21327196691
2021-08-17,All-Floors,Total,2238,20179,7386951,11978322809,364034819128,376013141937
2021-08-17,All-Floors,UG,518,7836,2889408,6157711200,222380084720,228537795920
2021-08-17,G,Alumni,11,148,45864,83686151,1326254396,1409940547
2021-08-17,G,Non-HKUST,56,393,220980,141685728,12338234698,12479920426
2021-08-17,G,Others(HKUST),9,67,11117,6266718,49754521,56021239
2021-08-17,G,RPG,322,1322,348366,341672879,8795513668,9137186547
2021-08-17,G,Staff,245,1505,375143,262183805,8699039325,8961223130
2021-08-17,G,TPG,43,441,135822,132756763,6647912980,6780669743
2021-08-17,G,Total,962,6081,1445609,1907786727,57115069713,59022856440
2021-08-17,G,UG,276,2205,308317,939534683,19258360125,20197894808
2021-08-17,LG1,Alumni,6,68,33106,6159651,321472337,327631988
2021-08-17,LG1,Non-HKUST,35,154,104616,61236454,1506489086,1567725540
2021-08-17,LG1,Others(HKUST),6,47,42059,8328011,281605434,289933445
2021-08-17,LG1,RPG,78,737,556041,604784488,14057849358,14662633846
2021-08-17,LG1,Staff,105,587,300234,184371665,3415490775,3599862440
2021-08-17,LG1,TPG,19,210,121826,102989467,3396480666,3499470133
2021-08-17,LG1,Total,392,3827,2635253,4769295556,170891250441,175660545997
2021-08-17,LG1,UG,143,2024,1477371,3801425820,147911862785,151713288605
2021-08-17,LG3,Alumni,13,115,42990,28032845,918816572,946849417
2021-08-17,LG3,Non-HKUST,86,159,60581,194401453,8144115029,8338516482
2021-08-17,LG3,Others(HKUST),19,100,23024,39596634,522431078,562027712
2021-08-17,LG3,RPG,468,1071,288524,1078483908,11323877930,12402361838
2021-08-17,LG3,Staff,547,1488,194822,539524616,9426053278,9965577894
2021-08-17,LG3,TPG,33,201,95327,133787435,3187461841,3321249276
2021-08-17,LG3,Total,1511,4361,1034492,2677262551,53346944702,56024207253
2021-08-17,LG3,UG,345,1227,329224,663435660,19824188974,20487624634
2021-08-17,LG4,Alumni,10,192,133977,31180913,896008267,927189180
2021-08-17,LG4,Non-HKUST,57,140,95474,135250665,4329363846,4464614511
2021-08-17,LG4,Others(HKUST),12,67,21825,4233802,493764991,497998793
2021-08-17,LG4,RPG,360,637,71143,496075369,12948218450,13444293819
2021-08-17,LG4,Staff,341,886,190157,626574776,7434520498,8061095274
2021-08-17,LG4,TPG,24,118,76315,53551058,2334058091,2387609149
2021-08-17,LG4,Total,1087,3752,990027,1820854133,49120578959,50941433092
2021-08-17,LG4,UG,283,1712,401136,473987550,20684644816,21158632366
2021-08-18,1,Alumni,2,3,3785,7328695,259100752,266429447
2021-08-18,1,Non-HKUST,2,16,14340,4722394,532474302,537196696
2021-08-18,1,Others(HKUST),3,27,14699,6437617,472239288,478676905
2021-08-18,1,RPG,10,48,21423,4606108,110277886,114883994
2021-08-18,1,Staff,40,627,227159,38912448,3211643899,3250556347
2021-08-18,1,TPG,2,8,3637,264133,2371123,2635256
2021-08-18,1,Total,74,848,350662,988482206,5032572304,6021054510
2021-08-18,1,UG,15,119,65619,926210811,444465054,1370675865
2021-08-18,All-Floors,Alumni,9,84,41598,109394766,2661317414,2770712180
2021-08-18,All-Floors,Non-HKUST,59,269,123705,79480612,5669238380,5748718992
2021-08-18,All-Floors,Others(HKUST),16,117,53610,11424940,576599985,588024925
2021-08-18,All-Floors,RPG,196,891,276677,122379727,3894918117,4017297844
2021-08-18,All-Floors,Staff,334,2232,492426,510548135,8517071799,9027619934
2021-08-18,All-Floors,TPG,24,197,100289,35272606,3613297466,3648570072
2021-08-18,All-Floors,Total,837,5082,1461872,2174560377,38583806567,40758366944
2021-08-18,All-Floors,UG,199,1292,373567,1306059591,13651363406,14957422997
2021-08-18,G,Alumni,4,27,2615,4164268,76163686,80327954
2021-08-18,G,Non-HKUST,24,84,33572,22664433,1228353831,1251018264
2021-08-18,G,Others(HKUST),8,26,11820,1898938,56543747,58442685
2021-08-18,G,RPG,80,366,106090,62261575,1811323085,1873584660
2021-08-18,G,Staff,124,538,145014,231435595,3169268147,3400703742
2021-08-18,G,TPG,16,120,40292,11602966,278354587,289957553
2021-08-18,G,Total,376,1571,383460,398692689,9308058378,9706751067
2021-08-18,G,UG,120,410,44057,64664914,2688051295,2752716209
2021-08-18,LG1,Alumni,4,27,17732,92087276,1885243845,1977331121
2021-08-18,LG1,Non-HKUST,10,82,31983,12584437,481193927,493778364
2021-08-18,LG1,Others(HKUST),4,10,9204,33038,72351,105389
2021-08-18,LG1,RPG,23,166,72967,13867860,1000708703,1014576563
2021-08-18,LG1,Staff,44,224,44563,6957666,489079191,496036857
2021-08-18,LG1,TPG,6,23,27954,9264943,2834232534,2843497477
2021-08-18,LG1,Total,128,697,299257,311701913,10316436710,10628138623
2021-08-18,LG1,UG,37,165,94854,176906693,3625906159,3802812852
2021-08-18,LG3,Alumni,3,19,9885,2042933,270053826,272096759
2021-08-18,LG3,Non-HKUST,30,59,10664,9293242,277154801,286448043
2021-08-18,LG3,Others(HKUST),8,29,4786,970091,15651456,16621547
2021-08-18,LG3,RPG,111,197,50404,10399518,278356082,288755600
2021-08-18,LG3,Staff,222,511,41288,224577965,1522366678,1746944643
2021-08-18,LG3,TPG,9,27,8434,7244904,365149764,372394668
2021-08-18,LG3,Total,489,1133,213247,322081714,5162366646,5484448360
2021-08-18,LG3,UG,106,291,87786,67553061,2433634039,2501187100
2021-08-18,LG4,Alumni,3,8,7581,3771594,170755305,174526899
2021-08-18,LG4,Non-HKUST,22,28,33146,30216106,3150061519,3180277625
2021-08-18,LG4,Others(HKUST),9,25,13101,2085256,32093143,34178399
2021-08-18,LG4,RPG,73,114,25793,31244666,694252361,725497027
2021-08-18,LG4,Staff,115,332,34402,8664461,124713884,133378345
2021-08-18,LG4,TPG,6,19,19972,6895660,133189458,140085118
2021-08-18,LG4,Total,295,833,215246,153601855,8764372529,8917974384
2021-08-18,LG4,UG,67,307,81251,70724112,4459306859,4530030971
2021-08-19,1,Alumni,3,16,21025,57053815,2637860571,2694914386
2021-08-19,1,Non-HKUST,12,27,63245,47126875,343944580,391071455
2021-08-19,1,Others(HKUST),3,43,61031,29161691,522834127,551995818
2021-08-19,1,RPG,29,125,97909,300314441,2427357142,2727671583
2021-08-19,1,Staff,49,790,404555,97264290,2512001304,2609265594
2021-08-19,1,TPG,6,82,88721,105450428,16393817588,16499268016
2021-08-19,1,Total,138,1380,1059532,880184827,32163179085,33043363912
2021-08-19,1,UG,36,297,323046,243813287,7325363773,7569177060
2021-08-19,All-Floors,Alumni,21,439,265267,508670098,7992563729,8501233827
2021-08-19,All-Floors,Non-HKUST,128,730,461502,746790624,33524058074,34270848698
2021-08-19,All-Floors,Others(HKUST),26,246,246045,66221661,1946948894,2013170555
2021-08-19,All-Floors,RPG,545,3052,1207224,2294055740,55282352162,57576407902
2021-08-19,All-Floors,Staff,494,3487,1044159,824397879,33625023555,34449421434
2021-08-19,All-Floors,TPG,53,893,630374,5496950816,84439480990,89936431806
2021-08-19,All-Floors,Total,1751,14703,6619951,13154400817,360521058173,373675458990
2021-08-19,All-Floors,UG,484,5856,2765380,3217313999,143710630769,146927944768
2021-08-19,G,Alumni,17,173,47897,32487998,526022455,558510453
2021-08-19,G,Non-HKUST,55,257,115961,79590236,2977248568,3056838804
2021-08-19,G,Others(HKUST),9,91,87162,11312292,115548712,126861004
2021-08-19,G,RPG,163,920,308715,194917927,9606185442,9801103369
2021-08-19,G,Staff,147,1026,253495,132190130,6020130295,6152320425
2021-08-19,G,TPG,31,309,148678,751284065,7239494430,7990778495
2021-08-19,G,Total,638,4476,1248271,1610332694,51236952081,52847284775
2021-08-19,G,UG,216,1700,286363,408550046,24752322179,25160872225
2021-08-19,LG1,Alumni,12,141,101049,380089309,3290677242,3670766551
2021-08-19,LG1,Non-HKUST,25,96,96299,229984384,2049275236,2279259620
2021-08-19,LG1,Others(HKUST),8,22,35084,5912739,169182023,175094762
2021-08-19,LG1,RPG,62,601,502216,825848348,17032683007,17858531355
2021-08-19,LG1,Staff,74,398,156167,89019767,2992072243,3081092010
2021-08-19,LG1,TPG,18,125,129159,80252827,2806509084,2886761911
2021-08-19,LG1,Total,339,2727,2120954,2952561191,85644823902,88597385093
2021-08-19,LG1,UG,140,1344,1100980,1341453817,57304425067,58645878884
2021-08-19,LG3,Alumni,7,20,16973,201816,1099809,1301625
2021-08-19,LG3,Non-HKUST,65,135,69082,69301438,2926834831,2996136269
2021-08-19,LG3,Others(HKUST),15,52,9047,2226826,32200311,34427137
2021-08-19,LG3,RPG,394,784,137832,678674352,18067037199,18745711551
2021-08-19,LG3,Staff,337,767,115708,341796236,8085320273,8427116509
2021-08-19,LG3,TPG,35,149,132487,314996965,5281736162,5596733127
2021-08-19,LG3,Total,1213,3234,1051247,2048424987,63076438372,65124863359
2021-08-19,LG3,UG,360,1327,570118,641227354,28682209787,29323437141
2021-08-19,LG4,Alumni,10,89,78323,38837160,1536903652,1575740812
2021-08-19,LG4,Non-HKUST,56,215,116915,320787691,25226754859,25547542550
2021-08-19,LG4,Others(HKUST),12,38,53721,17608113,1107183721,1124791834
2021-08-19,LG4,RPG,301,622,160552,294300672,8149089372,8443390044
2021-08-19,LG4,Staff,227,506,114234,164127456,14015499440,14179626896
2021-08-19,LG4,TPG,31,228,131329,4244966531,52717923726,56962890257
2021-08-19,LG4,Total,906,2886,1139947,5662897118,128399664733,134062561851
2021-08-19,LG4,UG,269,1188,484873,582269495,25646309963,26228579458
2021-08-20,1,Alumni,6,41,63679,261301730,28200118086,28461419816
2021-08-20,1,Non-HKUST,13,62,57642,27467132,652293985,679761117
2021-08-20,1,Others(HKUST),5,59,81354,44211306,1951316009,1995527315
2021-08-20,1,RPG,46,243,213647,368498069,12391402755,12759900824
2021-08-20,1,Staff,52,1165,852504,301088605,5415878760,5716967365
2021-08-20,1,TPG,7,67,152710,141206286,6129579422,6270785708
2021-08-20,1,Total,163,2029,1993585,1819202406,78878243246,80697445652
2021-08-20,1,UG,34,392,572049,675429278,24137654229,24813083507
2021-08-20,All-Floors,Alumni,24,506,416368,778614939,50842554899,51621169838
2021-08-20,All-Floors,Non-HKUST,156,1224,832651,1212813884,58124282187,59337096071
2021-08-20,All-Floors,Others(HKUST),26,356,141521,65549970,2954559286,3020109256
2021-08-20,All-Floors,RPG,591,4387,2166476,13093114090,131703891915,144797006005
2021-08-20,All-Floors,Staff,668,5780,2136625,2798558688,36648688157,39447246845
2021-08-20,All-Floors,TPG,66,1694,960233,1172383418,59874535459,61046918877
2021-08-20,All-Floors,Total,2015,20754,10508270,39174792074,698256231256,737431023330
2021-08-20,All-Floors,UG,484,6807,3854396,20053757085,358107719353,378161476438
2021-08-20,G,Alumni,14,189,38133,25716089,1024976390,1050692479
2021-08-20,G,Non-HKUST,63,396,173776,484660278,7642009746,8126670024
2021-08-20,G,Others(HKUST),8,45,20672,2427998,59983575,62411573
2021-08-20,G,RPG,141,1652,666891,5545562498,31114853128,36660415626
2021-08-20,G,Staff,135,1438,580998,312485779,11295837706,11608323485
2021-08-20,G,TPG,43,610,210043,320828679,17331506795,17652335474
2021-08-20,G,Total,601,6367,2213315,7421535446,107952568615,115374104061
2021-08-20,G,UG,197,2037,522802,729854125,39483401275,40213255400
2021-08-20,LG1,Alumni,8,189,149208,286969301,6985764353,7272733654
2021-08-20,LG1,Non-HKUST,32,297,293288,415979075,39991132726,40407111801
2021-08-20,LG1,Others(HKUST),8,19,2290,170015,606464,776479
2021-08-20,LG1,RPG,88,791,675168,3994178146,43498140388,47492318534
2021-08-20,LG1,Staff,116,734,283467,103360394,2950637724,3053998118
2021-08-20,LG1,TPG,31,314,196409,282107292,15642952246,15925059538
2021-08-20,LG1,Total,418,3963,3064419,8267121248,213641345638,221908466886
2021-08-20,LG1,UG,135,1619,1464589,3184357025,104572111737,107756468762
2021-08-20,LG3,Alumni,13,23,1447,1504319,3898367,5402686
2021-08-20,LG3,Non-HKUST,103,268,136123,110248222,4356074071,4466322293
2021-08-20,LG3,Others(HKUST),23,142,16562,10762661,493551509,504314170
2021-08-20,LG3,RPG,454,1034,409000,574332820,23552521793,24126854613
2021-08-20,LG3,Staff,538,1584,234585,1177345990,11916736646,13094082636
2021-08-20,LG3,TPG,47,350,203672,263164056,13221920801,13485084857
2021-08-20,LG3,Total,1545,4966,1733502,17079789527,168944233097,186024022624
2021-08-20,LG3,UG,367,1565,732113,14942431459,115399529910,130341961369
2021-08-20,LG4,Alumni,12,64,163901,203123500,14627797703,14830921203
2021-08-20,LG4,Non-HKUST,53,201,171822,174459177,5482771659,5657230836
2021-08-20,LG4,Others(HKUST),13,91,20643,7977990,449101729,457079719
2021-08-20,LG4,RPG,334,667,201770,2610542557,21146973851,23757516408
2021-08-20,LG4,Staff,333,859,185071,904277920,5069597321,5973875241
2021-08-20,LG4,TPG,38,353,197399,165077105,7548576195,7713653300
2021-08-20,LG4,Total,1077,3429,1503449,4587143447,128839840660,133426984107
2021-08-20,LG4,UG,294,1194,562843,521685198,74515022202,75036707400
2021-08-21,1,Alumni,0,0,0,0,0,0
2021-08-21,1,Non-HKUST,14,59,79922,51682462,3400648544,3452331006
2021-08-21,1,Others(HKUST),2,3,44568,0,0,0
2021-08-21,1,RPG,14,58,92241,211202513,23384509890,23595712403
2021-08-21,1,Staff,13,47,73679,32515691,983230226,1015745917
2021-08-21,1,TPG,9,118,54745,50244807,6450376246,6500621053
2021-08-21,1,Total,72,389,469865,472030180,40282796096,40754826276
2021-08-21,1,UG,20,104,124710,126384707,6064031190,6190415897
2021-08-21,All-Floors,Alumni,32,349,147226,271908007,9021361615,9293269622
2021-08-21,All-Floors,Non-HKUST,136,847,484522,1489283241,26291138081,27780421322
2021-08-21,All-Floors,Others(HKUST),17,118,381626,30587583,921500611,952088194
2021-08-21,All-Floors,RPG,422,1713,812978,1481130176,87919047195,89400177371
2021-08-21,All-Floors,Staff,211,1367,473163,1438509317,21215156489,22653665806
2021-08-21,All-Floors,TPG,72,1122,514039,591709398,34804225470,35395934868
2021-08-21,All-Floors,Total,1206,8994,4627669,7937991869,311877361595,319815353464
2021-08-21,All-Floors,UG,316,3478,1814115,2634864147,131704932134,134339796281
2021-08-21,G,Alumni,17,131,41141,26519061,2442901931,2469420992
2021-08-21,G,Non-HKUST,48,325,111248,170897267,7326253925,7497151192
2021-08-21,G,Others(HKUST),2,7,173652,12918252,378691250,391609502
2021-08-21,G,RPG,51,454,305415,355495804,25599828927,25955324731
2021-08-21,G,Staff,39,331,98394,28906634,424228414,453135048
2021-08-21,G,TPG,38,417,170285,163836255,13582109266,13745945521
2021-08-21,G,Total,318,2825,1124448,1117469961,65331699324,66449169285
2021-08-21,G,UG,123,1160,224313,358896688,15577685611,15936582299
2021-08-21,LG1,Alumni,6,90,53383,170210702,2090637110,2260847812
2021-08-21,LG1,Non-HKUST,20,91,66937,1044930747,3452719099,4497649846
2021-08-21,LG1,Others(HKUST),2,3,45258,105134,55355599,55460733
2021-08-21,LG1,RPG,39,145,158330,352174210,9765755984,10117930194
2021-08-21,LG1,Staff,29,183,71423,151917662,3243949255,3395866917
2021-08-21,LG1,TPG,24,237,130699,229615003,7165078187,7394693190
2021-08-21,LG1,Total,213,1611,1346790,3324785781,78776978665,82101764446
2021-08-21,LG1,UG,93,862,820760,1375832323,53003483431,54379315754
2021-08-21,LG3,Alumni,19,74,10036,27726892,1655751052,1683477944
2021-08-21,LG3,Non-HKUST,97,162,61516,34754891,5092761140,5127516031
2021-08-21,LG3,Others(HKUST),12,76,22252,12836162,387196553,400032715
2021-08-21,LG3,RPG,356,679,141258,342216090,11122940833,11465156923
2021-08-21,LG3,Staff,173,551,142148,359035051,12818157235,13177192286
2021-08-21,LG3,TPG,53,207,104944,104124708,4458148110,4562272818
2021-08-21,LG3,Total,945,2400,743691,1214127470,53615029069,54829156539
2021-08-21,LG3,UG,235,651,261537,333433676,18080074146,18413507822
2021-08-21,LG4,Alumni,18,54,42666,47451352,2832071522,2879522874
2021-08-21,LG4,Non-HKUST,59,210,164899,187017874,7018755373,7205773247
2021-08-21,LG4,Others(HKUST),9,29,95896,4728035,100257209,104985244
2021-08-21,LG4,RPG,208,377,115734,220041559,18046011561,18266053120
2021-08-21,LG4,Staff,90,255,87519,866134279,3745591359,4611725638
2021-08-21,LG4,TPG,38,143,53366,43888625,3148513661,3192402286
2021-08-21,LG4,Total,626,1769,942875,1809578477,73870858441,75680436918
2021-08-21,LG4,UG,204,701,382795,440316753,38979657756,39419974509
2021-08-22,1,Alumni,0,0,0,0,0,0
2021-08-22,1,Non-HKUST,0,0,0,0,0,0
2021-08-22,1,Others(HKUST),2,2,41769,476375,2455403,2931778
2021-08-22,1,RPG,10,13,806,102346,354065,456411
2021-08-22,1,Staff,9,13,18430,5186390,158535279,163721669
2021-08-22,1,TPG,0,0,0,0,0,0
2021-08-22,1,Total,26,34,62254,5795931,161697354,167493285
2021-08-22,1,UG,5,6,1249,30820,352607,383427
2021-08-22,All-Floors,Alumni,23,69,8698,27414404,2172828128,2200242532
2021-08-22,All-Floors,Non-HKUST,57,525,99752,69357985,2409636979,2478994964
2021-08-22,All-Floors,Others(HKUST),10,72,217432,34545067,498447635,532992702
2021-08-22,All-Floors,RPG,334,768,44740,499541118,10222959989,10722501107
2021-08-22,All-Floors,Staff,174,477,121766,85487074,2523150978,2608638052
2021-08-22,All-Floors,TPG,32,72,3198,1567955,97844723,99412678
2021-08-22,All-Floors,Total,881,2819,663496,1140663314,25650746120,26791409434
2021-08-22,All-Floors,UG,251,836,167910,422749711,7725877688,8148627399
2021-08-22,G,Alumni,0,0,0,0,0,0
2021-08-22,G,Non-HKUST,11,43,11661,19933650,1002702640,1022636290
2021-08-22,G,Others(HKUST),2,5,45568,3147419,10802882,13950301
2021-08-22,G,RPG,2,3,250,97715,203985,301700
2021-08-22,G,Staff,11,15,42022,2004491,48718169,50722660
2021-08-22,G,TPG,1,1,10,0,0,0
2021-08-22,G,Total,35,76,100761,25378320,1062867181,1088245501
2021-08-22,G,UG,8,9,1250,195045,439505,634550
2021-08-22,LG1,Alumni,1,1,40,0,0,0
2021-08-22,LG1,Non-HKUST,5,17,2801,1043183,7259269,8302452
2021-08-22,LG1,Others(HKUST),2,2,41364,3051780,14357062,17408842
2021-08-22,LG1,RPG,7,9,240,5510172,427940211,433450383
2021-08-22,LG1,Staff,11,29,23953,1806795,10884457,12691252
2021-08-22,LG1,TPG,1,1,5,0,0,0
2021-08-22,LG1,Total,35,67,68732,11759113,467366976,479126089
2021-08-22,LG1,UG,8,8,329,347183,6925977,7273160
2021-08-22,LG3,Alumni,19,44,7863,15805966,1265195466,1281001432
2021-08-22,LG3,Non-HKUST,48,426,68607,22220546,899417177,921637723
2021-08-22,LG3,Others(HKUST),5,40,3495,17266900,372474779,389741679
2021-08-22,LG3,RPG,296,486,32946,283572924,5587557052,5871129976
2021-08-22,LG3,Staff,146,316,31283,49445023,1762685517,1812130540
2021-08-22,LG3,TPG,29,46,2263,1467112,96205147,97672259
2021-08-22,LG3,Total,766,1864,215816,727947232,14255014808,14982962040
2021-08-22,LG3,UG,223,506,69359,338168761,4271479670,4609648431
2021-08-22,LG4,Alumni,15,24,795,11608438,907632662,919241100
2021-08-22,LG4,Non-HKUST,22,39,16683,26160606,500257893,526418499
2021-08-22,LG4,Others(HKUST),6,23,85236,10602593,98357509,108960102
2021-08-22,LG4,RPG,176,257,10498,210257961,4206904676,4417162637
2021-08-22,LG4,Staff,72,104,6078,27044375,542327556,569371931
2021-08-22,LG4,TPG,16,24,920,100843,1639576,1740419
2021-08-22,LG4,Total,445,778,215933,369782718,9703799801,10073582519
2021-08-22,LG4,UG,138,307,95723,84007902,3446679929,3530687831
2021-08-23,1,Alumni,4,11,26893,225438428,2726626164,2952064592
2021-08-23,1,Non-HKUST,41,239,236312,225789756,7862768836,8088558592
2021-08-23,1,Others(HKUST),6,65,71377,30079452,869033984,899113436
2021-08-23,1,RPG,109,251,307701,372317873,14824447900,15196765773
2021-08-23,1,Staff,98,1445,864340,264605830,6266856889,6531462719
2021-08-23,1,TPG,40,243,320207,388247454,20321021390,20709268844
2021-08-23,1,Total,451,2770,2370675,1920122428,67646411582,69566534010
2021-08-23,1,UG,153,516,543845,413643635,14775656419,15189300054
2021-08-23,All-Floors,Alumni,23,437,365895,806859609,17227440848,18034300457
2021-08-23,All-Floors,Non-HKUST,233,2076,1161938,1824730982,55144466400,56969197382
2021-08-23,All-Floors,Others(HKUST),30,356,253344,106390719,2895603497,3001994216
2021-08-23,All-Floors,RPG,673,4754,2544977,5964569026,81860744170,87825313196
2021-08-23,All-Floors,Staff,741,6590,2166894,2945861958,43287745921,46233607879
2021-08-23,All-Floors,TPG,124,3090,1774635,2966735850,75003580086,77970315936
2021-08-23,All-Floors,Total,2399,25750,12550675,21577472353,495850513414,517427985767
2021-08-23,All-Floors,UG,575,8447,4282992,6962324209,220430932492,227393256701
2021-08-23,G,Alumni,8,144,20525,29789125,630976453,660765578
2021-08-23,G,Non-HKUST,82,633,247216,225655534,15990134809,16215790343
2021-08-23,G,Others(HKUST),7,67,85670,18385144,160358731,178743875
2021-08-23,G,RPG,148,1551,702968,988490003,19683948937,20672438940
2021-08-23,G,Staff,169,1838,651619,296791495,7588915283,7885706778
2021-08-23,G,TPG,92,1180,358305,1028170210,15892064763,16920234973
2021-08-23,G,Total,730,7838,2421118,3381746282,97150918732,100532665014
2021-08-23,G,UG,224,2425,354815,794464771,37204519756,37998984527
2021-08-23,LG1,Alumni,8,183,211091,403321415,6791003806,7194325221
2021-08-23,LG1,Non-HKUST,41,342,331464,245586955,13158880375,13404467330
2021-08-23,LG1,Others(HKUST),6,17,12468,2810578,92373228,95183806
2021-08-23,LG1,RPG,78,806,749941,2399737584,16876241641,19275979225
2021-08-23,LG1,Staff,116,869,357271,337053060,7095118479,7432171539
2021-08-23,LG1,TPG,58,630,514671,442294488,16525036698,16967331186
2021-08-23,LG1,Total,464,4816,3789930,6970271099,140505619090,147475890189
2021-08-23,LG1,UG,157,1969,1613024,3139467019,79966964863,83106431882
2021-08-23,LG3,Alumni,14,33,32249,81219730,2003787832,2085007562
2021-08-23,LG3,Non-HKUST,147,443,110026,693805113,6737135146,7430940259
2021-08-23,LG3,Others(HKUST),23,135,50465,48920502,1640408864,1689329366
2021-08-23,LG3,RPG,509,1242,478403,1701389683,20846375243,22547764926
2021-08-23,LG3,Staff,573,1573,190240,691293306,13387038976,14078332282
2021-08-23,LG3,TPG,80,651,423109,497489491,14953607414,15451096905
2021-08-23,LG3,Total,1754,5890,2156483,5295835717,107733163368,113028999085
2021-08-23,LG3,UG,408,1813,871991,1581717892,48164809893,49746527785
2021-08-23,LG4,Alumni,18,66,75137,67090911,5075046593,5142137504
2021-08-23,LG4,Non-HKUST,120,419,236920,433893624,11395547234,11829440858
2021-08-23,LG4,Others(HKUST),19,72,33364,6195043,133428690,139623733
2021-08-23,LG4,RPG,381,904,305964,502633883,9629730449,10132364332
2021-08-23,LG4,Staff,374,865,103424,1356118267,8949816294,10305934561
2021-08-23,LG4,TPG,79,386,158343,610534207,7311849821,7922384028
2021-08-23,LG4,Total,1366,4436,1812469,4009496827,82814400642,86823897469
2021-08-23,LG4,UG,375,1724,899317,1033030892,40318981561,41352012453
2021-08-24,1,Alumni,3,22,38463,60496496,4762347243,4822843739
2021-08-24,1,Non-HKUST,24,164,127477,92730547,3195708333,3288438880
2021-08-24,1,Others(HKUST),4,74,132635,30030690,1212993436,1243024126
2021-08-24,1,RPG,34,192,338461,551970524,11092371416,11644341940
2021-08-24,1,Staff,70,1591,884108,213734459,3649245792,3862980251
2021-08-24,1,TPG,28,198,307182,366004758,15533698491,15899703249
2021-08-24,1,Total,199,2717,2352849,2796314030,52093373633,54889687663
2021-08-24,1,UG,36,476,524523,1481346556,12647008922,14128355478
2021-08-24,All-Floors,Alumni,22,411,386704,405666649,22467038905,22872705554
2021-08-24,All-Floors,Non-HKUST,177,1406,843513,1288568723,51674491396,52963060119
2021-08-24,All-Floors,Others(HKUST),28,416,282423,127828241,2533149458,2660977699
2021-08-24,All-Floors,RPG,644,4983,2418467,5106336606,92540812462,97647149068
2021-08-24,All-Floors,Staff,708,6969,2213369,2430899240,53758699169,56189598409
2021-08-24,All-Floors,TPG,103,2320,1732853,2100482798,87880450338,89980933136
2021-08-24,All-Floors,Total,2201,25199,12799681,20088602760,531771903747,551860506507
2021-08-24,All-Floors,UG,519,8694,4922352,8628820503,220917262019,229546082522
2021-08-24,G,Alumni,10,162,39994,68985751,5932226719,6001212470
2021-08-24,G,Non-HKUST,75,457,174773,166990580,14346408850,14513399430
2021-08-24,G,Others(HKUST),13,99,66216,81382563,695089873,776472436
2021-08-24,G,RPG,165,1700,612994,953679774,22001574890,22955254664
2021-08-24,G,Staff,167,1746,583117,262174044,9335623430,9597797474
2021-08-24,G,TPG,75,1012,492960,480165562,22372823594,22852989156
2021-08-24,G,Total,757,8133,2477797,3143565200,113907180118,117050745318
2021-08-24,G,UG,252,2957,507743,1130186926,39223432762,40353619688
2021-08-24,LG1,Alumni,8,77,94605,152861544,4593124635,4745986179
2021-08-24,LG1,Non-HKUST,43,262,203100,532256216,8983515181,9515771397
2021-08-24,LG1,Others(HKUST),9,28,4477,586934,14729792,15316726
2021-08-24,LG1,RPG,97,869,708411,2320608477,21949610789,24270219266
2021-08-24,LG1,Staff,132,1167,396316,196726023,8222726934,8419452957
2021-08-24,LG1,TPG,41,455,396079,658986545,26251846549,26910833094
2021-08-24,LG1,Total,510,5090,4112301,7508934755,164620672719,172129607474
2021-08-24,LG1,UG,180,2232,2309313,3646909016,94605118839,98252027855
2021-08-24,LG3,Alumni,11,51,101847,54709484,2175875647,2230585131
2021-08-24,LG3,Non-HKUST,95,243,166204,228922116,5184535033,5413457149
2021-08-24,LG3,Others(HKUST),17,103,14867,4555841,229339785,233895626
2021-08-24,LG3,RPG,492,1206,395275,590083866,19711360649,20301444515
2021-08-24,LG3,Staff,532,1502,189542,713908828,13370795427,14084704255
2021-08-24,LG3,TPG,62,304,312410,296809269,8832503442,9129312711
2021-08-24,LG3,Total,1585,4842,1842029,2842076014,84566791955,87408867969
2021-08-24,LG3,UG,376,1433,661884,953086610,35062381972,36015468582
2021-08-24,LG4,Alumni,11,99,111795,68613374,5003464661,5072078035
2021-08-24,LG4,Non-HKUST,89,280,171959,267669264,19964323999,20231993263
2021-08-24,LG4,Others(HKUST),19,112,64228,11272213,380996572,392268785
2021-08-24,LG4,RPG,447,1016,363326,689993965,17785894718,18475888683
2021-08-24,LG4,Staff,428,963,160286,1044355886,19180307586,20224663472
2021-08-24,LG4,TPG,71,351,224222,298516664,14889578262,15188094926
2021-08-24,LG4,Total,1446,4417,2014705,3797712761,116583885322,120381598083
2021-08-24,LG4,UG,381,1596,918889,1417291395,39379319524,40796610919
2021-08-25,1,Alumni,4,19,55818,78198766,3206165802,3284364568
2021-08-25,1,Non-HKUST,25,120,127385,104744805,2549080941,2653825746
2021-08-25,1,Others(HKUST),3,60,109322,29386932,1278424349,1307811281
2021-08-25,1,RPG,51,212,204560,292672477,26107737986,26400410463
2021-08-25,1,Staff,69,1170,731579,200665312,4956099284,5156764596
2021-08-25,1,TPG,27,124,190572,147950684,5192087927,5340038611
2021-08-25,1,Total,224,2020,1871803,1330898654,55262265774,56593164428
2021-08-25,1,UG,45,315,452567,477279678,11972669485,12449949163
2021-08-25,All-Floors,Alumni,26,501,446703,673540328,17088700148,17762240476
2021-08-25,All-Floors,Non-HKUST,183,1677,872970,907826261,50601060001,51508886262
2021-08-25,All-Floors,Others(HKUST),23,381,252174,67449750,2464612633,2532062383
2021-08-25,All-Floors,RPG,618,5216,2506919,8031759252,134523107289,142554866541
2021-08-25,All-Floors,Staff,666,6637,1987631,10277748451,43988553322,54266301773
2021-08-25,All-Floors,TPG,114,2903,1982419,3060078971,129725405668,132785484639
2021-08-25,All-Floors,Total,2122,26693,12834558,29395803225,635293460185,664689263410
2021-08-25,All-Floors,UG,492,9378,4785742,6377400212,256902021124,263279421336
2021-08-25,G,Alumni,13,200,78608,99848095,5606737243,5706585338
2021-08-25,G,Non-HKUST,79,732,247963,172393343,6855729322,7028122665
2021-08-25,G,Others(HKUST),9,85,34421,11845505,214931924,226777429
2021-08-25,G,RPG,169,1766,671245,2181119220,38869359732,41050478952
2021-08-25,G,Staff,164,1805,515096,230628109,6103922301,6334550410
2021-08-25,G,TPG,85,1198,638415,1124992965,75906727912,77031720877
2021-08-25,G,Total,767,8559,2733344,4578513229,167798502391,172377015620
2021-08-25,G,UG,248,2773,547596,757685992,34241093957,34998779949
2021-08-25,LG1,Alumni,11,135,117444,394863939,4352680723,4747544662
2021-08-25,LG1,Non-HKUST,46,252,144421,205227733,12107666079,12312893812
2021-08-25,LG1,Others(HKUST),8,56,15508,1591204,32879974,34471178
2021-08-25,LG1,RPG,98,1154,1094797,4721764755,38420077520,43141842275
2021-08-25,LG1,Staff,121,894,325653,231169073,4878118281,5109287354
2021-08-25,LG1,TPG,54,647,486331,738500190,22046709064,22785209254
2021-08-25,LG1,Total,492,5590,4153776,9315804920,195739616401,205055421321
2021-08-25,LG1,UG,154,2452,1969622,3022688026,113901484760,116924172786
2021-08-25,LG3,Alumni,11,48,44714,30318047,818562737,848880784
2021-08-25,LG3,Non-HKUST,95,313,201190,189422679,16811335854,17000758533
2021-08-25,LG3,Others(HKUST),15,102,26175,9393339,339996251,349389590
2021-08-25,LG3,RPG,442,1122,381997,531039162,16859577793,17390616955
2021-08-25,LG3,Staff,512,1737,254631,8853855925,19627789243,28481645168
2021-08-25,LG3,TPG,70,487,415788,442985169,12822780815,13265765984
2021-08-25,LG3,Total,1480,5401,2240456,11113548106,110906627318,122020175424
2021-08-25,LG3,UG,335,1592,915961,1056533785,43626584625,44683118410
2021-08-25,LG4,Alumni,14,99,150119,70311481,3104553643,3174865124
2021-08-25,LG4,Non-HKUST,80,260,152011,236037701,12277247805,12513285506
2021-08-25,LG4,Others(HKUST),16,78,66748,15232770,598380135,613612905
2021-08-25,LG4,RPG,454,962,154320,305163638,14266354258,14571517896
2021-08-25,LG4,Staff,404,1031,160672,761430032,8422624213,9184054245
2021-08-25,LG4,TPG,78,447,251313,605649963,13757099950,14362749913
2021-08-25,LG4,Total,1410,5123,1835179,3057038316,105586448301,108643486617
2021-08-25,LG4,UG,364,2246,899996,1063212731,53160188297,54223401028
2021-08-26,1,Alumni,2,13,46000,184941433,4690725013,4875666446
2021-08-26,1,Non-HKUST,35,110,112103,54471884,918124763,972596647
2021-08-26,1,Others(HKUST),4,46,48345,31595795,1346127592,1377723387
2021-08-26,1,RPG,36,183,237826,279183367,4875602042,5154785409
2021-08-26,1,Staff,65,1053,840057,204063471,6997393001,7201456472
2021-08-26,1,TPG,45,388,384718,273619871,8279669284,8553289155
2021-08-26,1,Total,257,2148,2202446,1508174423,42688676145,44196850568
2021-08-26,1,UG,70,355,533397,480298602,15581034450,16061333052
2021-08-26,All-Floors,Alumni,20,559,422306,645310407,17350861458,17996171865
2021-08-26,All-Floors,Non-HKUST,225,2069,1114200,1457727348,63929123655,65386851003
2021-08-26,All-Floors,Others(HKUST),31,400,242765,180490867,6960006298,7140497165
2021-08-26,All-Floors,RPG,621,4818,2256838,5433104996,84888199623,90321304619
2021-08-26,All-Floors,Staff,684,7089,2053976,2438524000,32633405305,35071929305
2021-08-26,All-Floors,TPG,154,3931,2607162,2424372057,76459759769,78884131826
2021-08-26,All-Floors,Total,2263,29143,14302411,19232356709,524924473174,544156829883
2021-08-26,All-Floors,UG,528,10277,5605164,6652827034,242703117066,249355944100
2021-08-26,G,Alumni,15,228,70156,45057269,1511058002,1556115271
2021-08-26,G,Non-HKUST,115,804,343897,215843783,15827276976,16043120759
2021-08-26,G,Others(HKUST),11,78,42684,2503174,227609216,230112390
2021-08-26,G,RPG,159,1603,501459,1106049514,26960583394,28066632908
2021-08-26,G,Staff,153,1573,572078,248577745,8851964097,9100541842
2021-08-26,G,TPG,121,1842,828337,862769276,31907166103,32769935379
2021-08-26,G,Total,862,9215,3027429,3128627406,114785115932,117913743338
2021-08-26,G,UG,288,3087,668818,647826645,29499458144,30147284789
2021-08-26,LG1,Alumni,13,225,221564,371813865,10031380760,10403194625
2021-08-26,LG1,Non-HKUST,73,390,300917,751493185,13616408120,14367901305
2021-08-26,LG1,Others(HKUST),11,64,69421,21039974,4425416851,4446456825
2021-08-26,LG1,RPG,95,1159,965295,2518207076,29842915714,32361122790
2021-08-26,LG1,Staff,127,1092,292330,358568182,4927605112,5286173294
2021-08-26,LG1,TPG,68,773,642575,705584914,16775098654,17480683568
2021-08-26,LG1,Total,595,6668,4863677,8253508897,184384108434,192637617331
2021-08-26,LG1,UG,208,2965,2371575,3526801701,104765283223,108292084924
2021-08-26,LG3,Alumni,5,22,19187,17416698,778093374,795510072
2021-08-26,LG3,Non-HKUST,116,398,229778,241340317,12965043080,13206383397
2021-08-26,LG3,Others(HKUST),20,84,10834,3642338,63026796,66669134
2021-08-26,LG3,RPG,455,997,364191,349306416,11901514371,12250820787
2021-08-26,LG3,Staff,508,1955,211854,1312205574,6483751342,7795956916
2021-08-26,LG3,TPG,86,529,562090,427165422,17005692431,17432857853
2021-08-26,LG3,Total,1533,5921,2359965,3290072852,80917837936,84207910788
2021-08-26,LG3,UG,343,1936,962031,938996087,31720716542,32659712629
2021-08-26,LG4,Alumni,8,71,65399,26081142,339604309,365685451
2021-08-26,LG4,Non-HKUST,100,367,127505,194578179,20602270716,20796848895
2021-08-26,LG4,Others(HKUST),18,128,71481,121709586,897825843,1019535429
2021-08-26,LG4,RPG,422,876,188067,1180358623,11307584102,12487942725
2021-08-26,LG4,Staff,439,1416,137657,315109028,5372691753,5687800781
2021-08-26,LG4,TPG,85,399,189442,155232574,2492133297,2647365871
2021-08-26,LG4,Total,1441,5191,1848894,3051973131,102148734727,105200707858
2021-08-26,LG4,UG,369,1934,1069343,1058903999,61136624707,62195528706
2021-08-27,1,Alumni,4,24,41701,70286867,4634963616,4705250483
2021-08-27,1,Non-HKUST,49,295,286510,192222399,7848618330,8040840729
2021-08-27,1,Others(HKUST),4,64,113055,25743295,1933281224,1959024519
2021-08-27,1,RPG,29,189,248604,251854461,4765793434,5017647895
2021-08-27,1,Staff,57,1507,858770,170359033,8411657504,8582016537
2021-08-27,1,TPG,42,244,287635,436201970,11059884887,11496086857
2021-08-27,1,Total,263,2894,2404919,2483440910,54892180627,57375621537
2021-08-27,1,UG,78,571,568644,1336772885,16237981632,17574754517
2021-08-27,All-Floors,Alumni,19,405,371376,659367045,19955228863,20614595908
2021-08-27,All-Floors,Non-HKUST,225,2820,1371918,1332849778,43208702846,44541552624
2021-08-27,All-Floors,Others(HKUST),26,284,345444,79637619,3159469101,3239106720
2021-08-27,All-Floors,RPG,596,4328,2082075,2677870308,75957683688,78635553996
2021-08-27,All-Floors,Staff,616,6360,1914359,1748369479,32677792448,34426161927
2021-08-27,All-Floors,TPG,164,4842,2661974,3069279447,122569284937,125638564384
2021-08-27,All-Floors,Total,2257,31386,14411694,18792619183,560031420244,578824039427
2021-08-27,All-Floors,UG,611,12347,5664548,9225245507,262503258361,271728503868
2021-08-27,G,Alumni,11,159,73864,90510321,3868091099,3958601420
2021-08-27,G,Non-HKUST,125,1047,390580,403387884,15256723129,15660111013
2021-08-27,G,Others(HKUST),5,41,83096,17548113,76115623,93663736
2021-08-27,G,RPG,127,1374,710412,1090947670,25901115474,26992063144
2021-08-27,G,Staff,136,1381,460312,194205712,9334994348,9529200060
2021-08-27,G,TPG,130,1891,730752,1051860321,53202953083,54254813404
2021-08-27,G,Total,794,9217,2961139,3386895579,132805162890,136192058469
2021-08-27,G,UG,260,3324,512123,538435558,25165170134,25703605692
2021-08-27,LG1,Alumni,10,89,95412,396876602,6257273408,6654150010
2021-08-27,LG1,Non-HKUST,73,549,349830,369117973,7802692275,8171810248
2021-08-27,LG1,Others(HKUST),7,16,86766,11573870,121492069,133065939
2021-08-27,LG1,RPG,63,880,583453,487907015,16142620866,16630527881
2021-08-27,LG1,Staff,127,942,301059,279535419,3030009989,3309545408
2021-08-27,LG1,TPG,75,977,457046,372635718,15649015591,16021651309
2021-08-27,LG1,Total,569,8208,4669854,7898156770,217144595590,225042752360
2021-08-27,LG1,UG,214,4755,2796288,5980510173,168141491392,174122001565
2021-08-27,LG3,Alumni,12,58,62256,66906138,3684608752,3751514890
2021-08-27,LG3,Non-HKUST,114,403,169985,230918827,8034283242,8265202069
2021-08-27,LG3,Others(HKUST),16,67,3061,630762,5055871,5686633
2021-08-27,LG3,RPG,382,1036,444518,476844883,20579483940,21056328823
2021-08-27,LG3,Staff,423,1398,136165,137055834,5989898399,6126954233
2021-08-27,LG3,TPG,106,1021,631242,855588961,20687065324,21542654285
2021-08-27,LG3,Total,1470,6050,2481432,2655866852,94865346160,97521213012
2021-08-27,LG3,UG,417,2067,1034205,887921447,35884950632,36772872079
2021-08-27,LG4,Alumni,5,75,98143,34787117,1510291988,1545079105
2021-08-27,LG4,Non-HKUST,104,526,175013,137202695,4266385870,4403588565
2021-08-27,LG4,Others(HKUST),17,96,59466,24141579,1023524314,1047665893
2021-08-27,LG4,RPG,446,849,95088,370316279,8568669974,8938986253
2021-08-27,LG4,Staff,400,1132,158053,967213481,5911232208,6878445689
2021-08-27,LG4,TPG,98,709,555299,352992477,21970366052,22323358529
2021-08-27,LG4,Total,1511,5017,1894350,2368259072,60324134977,62692394049
2021-08-27,LG4,UG,441,1630,753288,481605444,17073664571,17555270015
2021-08-28,1,Alumni,2,2,35,2465,5564,8029
2021-08-28,1,Non-HKUST,29,128,129097,78952273,8202953431,8281905704
2021-08-28,1,Others(HKUST),1,1,42746,0,0,0
2021-08-28,1,RPG,16,304,211295,168554359,6157454829,6326009188
2021-08-28,1,Staff,9,271,110787,51454262,898123422,949577684
2021-08-28,1,TPG,40,298,206084,408724513,8009337342,8418061855
2021-08-28,1,Total,131,1263,845273,1156197247,27155062077,28311259324
2021-08-28,1,UG,34,259,145229,448509375,3887187489,4335696864
2021-08-28,All-Floors,Alumni,29,502,186707,296775816,18488358652,18785134468
2021-08-28,All-Floors,Non-HKUST,324,2496,899910,875491612,44789655967,45665147579
2021-08-28,All-Floors,Others(HKUST),12,89,171689,11813308,613740904,625554212
2021-08-28,All-Floors,RPG,531,2626,991606,1648854348,30986050007,32634904355
2021-08-28,All-Floors,Staff,192,1432,420822,335255651,14721282911,15056538562
2021-08-28,All-Floors,TPG,288,5289,2056967,3142489237,92666324257,95808813494
2021-08-28,All-Floors,Total,2166,18698,7187340,9402358704,312213418668,321615777372
2021-08-28,All-Floors,UG,790,6264,2459639,3091678732,109948005970,113039684702
2021-08-28,G,Alumni,12,105,6257,6884680,280248744,287133424
2021-08-28,G,Non-HKUST,116,803,213780,175770307,11396954185,11572724492
2021-08-28,G,Others(HKUST),2,2,68081,3240472,10844986,14085458
2021-08-28,G,RPG,73,624,151630,182928414,2986761037,3169689451
2021-08-28,G,Staff,34,263,75415,40046418,3088932571,3128978989
2021-08-28,G,TPG,155,1925,548949,697594511,24624624220,25322218731
2021-08-28,G,Total,589,5216,1310177,1296633186,55990083383,57286716569
2021-08-28,G,UG,197,1494,246065,190168384,13601717640,13791886024
2021-08-28,LG1,Alumni,7,65,24170,191616711,1003526893,1195143604
2021-08-28,LG1,Non-HKUST,64,679,269396,324892162,10320672443,10645564605
2021-08-28,LG1,Others(HKUST),1,1,46522,0,0,0
2021-08-28,LG1,RPG,36,437,304396,323097930,9681710553,10004808483
2021-08-28,LG1,Staff,20,289,78581,102593368,3462208502,3564801870
2021-08-28,LG1,TPG,84,1368,707598,1263581191,19882863212,21146444403
2021-08-28,LG1,Total,353,4412,2562494,3452504639,94074505491,97527010130
2021-08-28,LG1,UG,141,1573,1131831,1246723277,49723523888,50970247165
2021-08-28,LG3,Alumni,9,73,64660,31764484,11592156138,11623920622
2021-08-28,LG3,Non-HKUST,113,333,104838,109515464,5679918253,5789433717
2021-08-28,LG3,Others(HKUST),4,19,3402,63006,176801,239807
2021-08-28,LG3,RPG,124,366,183962,236608285,5930599268,6167207553
2021-08-28,LG3,Staff,54,202,72295,91046784,5641421767,5732468551
2021-08-28,LG3,TPG,117,762,288471,325486721,15477279356,15802766077
2021-08-28,LG3,Total,659,2638,1189751,1255773548,73926716420,75182489968
2021-08-28,LG3,UG,238,883,472123,461288804,29605164837,30066453641
2021-08-28,LG4,Alumni,23,257,91585,66507476,5612421313,5678928789
2021-08-28,LG4,Non-HKUST,220,553,182799,186361406,9189157655,9375519061
2021-08-28,LG4,Others(HKUST),8,66,10938,8509830,602719117,611228947
2021-08-28,LG4,RPG,467,895,140323,737665360,6229524320,6967189680
2021-08-28,LG4,Staff,159,407,83744,50114819,1630596649,1680711468
2021-08-28,LG4,TPG,215,936,305865,447102301,24672220127,25119322428
2021-08-28,LG4,Total,1781,5169,1279645,2241250084,61067051297,63308301381
2021-08-28,LG4,UG,689,2055,464391,744988892,13130412116,13875401008
2021-08-29,1,Alumni,0,0,0,0,0,0
2021-08-29,1,Non-HKUST,1,1,1291,336,0,336
2021-08-29,1,Others(HKUST),1,1,42467,0,0,0
2021-08-29,1,RPG,1,1,20,784977,901684,1686661
2021-08-29,1,Staff,1,6,62985,2911674,7816861,10728535
2021-08-29,1,TPG,0,0,0,0,0,0
2021-08-29,1,Total,4,9,106763,3696987,8718545,12415532
2021-08-29,1,UG,0,0,0,0,0,0
2021-08-29,All-Floors,Alumni,13,28,1268,789892,17455403,18245295
2021-08-29,All-Floors,Non-HKUST,70,200,36336,67798383,891777167,959575550
2021-08-29,All-Floors,Others(HKUST),12,58,74755,3260099,95012895,98272994
2021-08-29,All-Floors,RPG,433,852,115160,727334783,7692787120,8420121903
2021-08-29,All-Floors,Staff,153,311,88854,62015623,2370732126,2432747749
2021-08-29,All-Floors,TPG,67,168,25500,36493355,590446395,626939750
2021-08-29,All-Floors,Total,1529,3739,653034,1508651199,24285108248,25793759447
2021-08-29,All-Floors,UG,781,2122,311161,610959064,12626897142,13237856206
2021-08-29,G,Alumni,0,0,0,0,0,0
2021-08-29,G,Non-HKUST,2,2,25,0,0,0
2021-08-29,G,Others(HKUST),1,1,5583,0,0,0
2021-08-29,G,RPG,5,5,60,0,0,0
2021-08-29,G,Staff,2,9,4686,1519861,18421464,19941325
2021-08-29,G,TPG,4,5,30,3166,15476,18642
2021-08-29,G,Total,23,31,10484,1523027,18436940,19959967
2021-08-29,G,UG,9,9,100,0,0,0
2021-08-29,LG1,Alumni,1,1,5,0,0,0
2021-08-29,LG1,Non-HKUST,1,2,1435,63600,295426,359026
2021-08-29,LG1,Others(HKUST),2,3,18406,0,0,0
2021-08-29,LG1,RPG,3,6,635,191222,802459,993681
2021-08-29,LG1,Staff,3,4,290,156531,1272619,1429150
2021-08-29,LG1,TPG,1,1,925,30222,43199,73421
2021-08-29,LG1,Total,24,30,29643,849089,6482643,7331732
2021-08-29,LG1,UG,13,13,7947,407514,4068940,4476454
2021-08-29,LG3,Alumni,7,8,272,11518,14934,26452
2021-08-29,LG3,Non-HKUST,18,44,6056,12595473,595986506,608581979
2021-08-29,LG3,Others(HKUST),4,14,290,172778,372955,545733
2021-08-29,LG3,RPG,99,170,5234,520519909,1080757603,1601277512
2021-08-29,LG3,Staff,35,83,3295,16592902,1327641185,1344234087
2021-08-29,LG3,TPG,20,48,2505,3084953,34764329,37849282
2021-08-29,LG3,Total,427,773,29945,636203001,4322242369,4958445370
2021-08-29,LG3,UG,244,406,12293,83225468,1282704857,1365930325
2021-08-29,LG4,Alumni,12,19,991,778374,17440469,18218843
2021-08-29,LG4,Non-HKUST,66,151,27529,55138974,295495235,350634209
2021-08-29,LG4,Others(HKUST),8,39,8009,3087321,94639940,97727261
2021-08-29,LG4,RPG,407,670,109211,205838675,6610325374,6816164049
2021-08-29,LG4,Staff,138,209,17598,40834655,1015579997,1056414652
2021-08-29,LG4,TPG,63,114,22040,33375014,555623391,588998405
2021-08-29,LG4,Total,1434,2896,476199,866379095,19929227751,20795606846
2021-08-29,LG4,UG,740,1694,290821,527326082,11340123345,11867449427
2021-08-30,1,Alumni,3,6,28164,62893912,2959605217,3022499129
2021-08-30,1,Non-HKUST,83,476,450960,454953554,16181940111,16636893665
2021-08-30,1,Others(HKUST),4,67,160401,33554762,871188806,904743568
2021-08-30,1,RPG,39,451,380272,558056366,12709558172,13267614538
2021-08-30,1,Staff,44,877,946216,201982540,5470313116,5672295656
2021-08-30,1,TPG,111,1241,767143,1440091130,34637354247,36077445377
2021-08-30,1,Total,371,3996,3426170,5118930919,92537238642,97656169561
2021-08-30,1,UG,87,878,693014,2367398655,19707278973,22074677628
2021-08-30,All-Floors,Alumni,19,447,346381,1244901645,17460286102,18705187747
2021-08-30,All-Floors,Non-HKUST,387,4868,2337567,3521690152,105620757756,109142447908
2021-08-30,All-Floors,Others(HKUST),30,303,524486,78194290,1744146070,1822340360
2021-08-30,All-Floors,RPG,809,6882,3015637,5945347852,107842542219,113787890071
2021-08-30,All-Floors,Staff,663,4571,2172471,3327613110,27257418266,30585031376
2021-08-30,All-Floors,TPG,372,11288,5596547,9018762274,370858032996,379876795270
2021-08-30,All-Floors,Total,3479,44722,21397432,36172653671,1025282984605,1061455638276
2021-08-30,All-Floors,UG,1199,16363,7404343,13036144348,394499801196,407535945544
2021-08-30,G,Alumni,8,149,36514,232825654,1750120472,1982946126
2021-08-30,G,Non-HKUST,205,1362,547619,1332330914,23298600507,24630931421
2021-08-30,G,Others(HKUST),7,63,204657,7151461,37027155,44178616
2021-08-30,G,RPG,221,2094,553966,742680072,14342464610,15085144682
2021-08-30,G,Staff,137,1023,583659,171805332,4911014490,5082819822
2021-08-30,G,TPG,288,4139,1407336,1943545714,62904823213,64848368927
2021-08-30,G,Total,1321,13097,4180742,5945661858,185877521531,191823183389
2021-08-30,G,UG,455,4267,846991,1515322711,78633471084,80148793795
2021-08-30,LG1,Alumni,7,181,99052,711693672,3459256132,4170949804
2021-08-30,LG1,Non-HKUST,117,1165,464899,512133608,36379393901,36891527509
2021-08-30,LG1,Others(HKUST),6,26,97089,2475089,32904524,35379613
2021-08-30,LG1,RPG,113,1743,1085896,2355639837,44078860665,46434500502
2021-08-30,LG1,Staff,80,630,243296,186524067,4964253373,5150777440
2021-08-30,LG1,TPG,176,2382,1184516,1612175973,75427070949,77039246922
2021-08-30,LG1,Total,833,10903,6182083,11633710723,353210161115,364843871838
2021-08-30,LG1,UG,334,4776,3007335,6253068477,188868421571,195121490048
2021-08-30,LG3,Alumni,9,79,139359,120830836,7112604383,7233435219
2021-08-30,LG3,Non-HKUST,142,780,433391,346092987,9635235067,9981328054
2021-08-30,LG3,Others(HKUST),12,62,48093,21600571,410951262,432551833
2021-08-30,LG3,RPG,221,1023,641317,1450996448,12192703816,13643700264
2021-08-30,LG3,Staff,217,795,171172,116171056,4011644562,4127815618
2021-08-30,LG3,TPG,170,2030,1355326,2487034743,72504733381,74991768124
2021-08-30,LG3,Total,1201,7351,4267896,5892844741,157498055990,163390900731
2021-08-30,LG3,UG,430,2582,1479238,1350118100,51630183519,52980301619
2021-08-30,LG4,Alumni,12,32,43292,116657571,2178699898,2295357469
2021-08-30,LG4,Non-HKUST,232,1085,440698,876179089,20125588170,21001767259
2021-08-30,LG4,Others(HKUST),23,85,14246,13412407,392074323,405486730
2021-08-30,LG4,RPG,663,1571,354186,837975129,24518954956,25356930085
2021-08-30,LG4,Staff,514,1246,228128,2651130115,7900192725,10551322840
2021-08-30,LG4,TPG,227,1496,882226,1535914714,125384051206,126919965920
2021-08-30,LG4,Total,2693,9375,3340541,7581505430,236160007327,243741512757
2021-08-30,LG4,UG,1022,3860,1377765,1550236405,55660446049,57210682454
2021-08-31,1,Alumni,2,6,13228,89437,304537,393974
2021-08-31,1,Non-HKUST,76,406,707893,192117467,9055598604,9247716071
2021-08-31,1,Others(HKUST),3,28,106725,4628501,174636117,179264618
2021-08-31,1,RPG,16,138,165266,347156210,21280985843,21628142053
2021-08-31,1,Staff,46,585,610850,51459794,1040491475,1091951269
2021-08-31,1,TPG,64,582,1034777,237875736,6843177644,7081053380
2021-08-31,1,Total,299,2410,3549533,1474654032,60034608228,61509262260
2021-08-31,1,UG,92,665,910794,641326887,21639414008,22280740895
2021-08-31,All-Floors,Alumni,14,284,379276,64835277,1084367300,1149202577
2021-08-31,All-Floors,Non-HKUST,360,2988,2946654,1503604846,66078681141,67582285987
2021-08-31,All-Floors,Others(HKUST),21,112,353800,24299510,955581641,979881151
2021-08-31,All-Floors,RPG,481,3279,2760572,3493591362,124093267572,127586858934
2021-08-31,All-Floors,Staff,495,3253,1491987,935566961,10664232813,11599799774
2021-08-31,All-Floors,TPG,277,5617,7432465,2883704260,74037845777,76921550037
2021-08-31,All-Floors,Total,2846,27258,23838028,13677606153,424372851907,438050458060
2021-08-31,All-Floors,UG,1198,11725,8473274,4772003937,147458875663,152230879600
2021-08-31,G,Alumni,6,136,165191,48504739,854993790,903498529
2021-08-31,G,Non-HKUST,162,912,510268,511007463,14741928930,15252936393
2021-08-31,G,Others(HKUST),5,13,106752,15290739,90735396,106026135
2021-08-31,G,RPG,128,822,367500,206145698,4032364413,4238510111
2021-08-31,G,Staff,119,807,431060,28802670,1193951303,1222753973
2021-08-31,G,TPG,208,1872,1947843,985650062,25473807744,26459457806
2021-08-31,G,Total,1060,7454,4379052,2478427569,66336929347,68815356916
2021-08-31,G,UG,432,2892,850438,683026198,19949147771,20632173969
2021-08-31,LG1,Alumni,8,71,92435,15132773,226472261,241605034
2021-08-31,LG1,Non-HKUST,110,683,617483,331502324,21315892708,21647395032
2021-08-31,LG1,Others(HKUST),5,12,74581,279581,4114621,4394202
2021-08-31,LG1,RPG,81,932,1088015,2176343375,75667953516,77844296891
2021-08-31,LG1,Staff,68,637,266649,58679769,2455935187,2514614956
2021-08-31,LG1,TPG,112,1231,1234615,635197717,15384439494,16019637211
2021-08-31,LG1,Total,682,6628,6779626,5414097466,180378345503,185792442969
2021-08-31,LG1,UG,298,3062,3405848,2196961927,65323537716,67520499643
2021-08-31,LG3,Alumni,5,58,67165,977826,2293988,3271814
2021-08-31,LG3,Non-HKUST,124,479,677360,254532463,5531999416,5786531879
2021-08-31,LG3,Others(HKUST),6,9,200,4639,26301,30940
2021-08-31,LG3,RPG,125,523,635463,152338136,7176653047,7328991183
2021-08-31,LG3,Staff,130,524,78770,178769558,881830942,1060600500
2021-08-31,LG3,TPG,111,991,1935529,622340442,15011396001,15633736443
2021-08-31,LG3,Total,917,4373,4668110,1796001763,48327798443,50123800206
2021-08-31,LG3,UG,416,1789,1273623,587038699,19723598748,20310637447
2021-08-31,LG4,Alumni,7,13,41257,130502,302724,433226
2021-08-31,LG4,Non-HKUST,166,508,433650,214445129,15433261483,15647706612
2021-08-31,LG4,Others(HKUST),16,50,65542,4096050,686069206,690165256
2021-08-31,LG4,RPG,378,864,504328,611607943,15935310753,16546918696
2021-08-31,LG4,Staff,374,700,104658,617855170,5092023906,5709879076
2021-08-31,LG4,TPG,129,941,1279701,402640303,11325024894,11727665197
2021-08-31,LG4,Total,2053,6393,4461707,2514425323,69295170386,71809595709
2021-08-31,LG4,UG,983,3317,2032571,663650226,20823177420,21486827646
