Date,Floor,User-Group,User-Count,WiFi-Conn,Duration-Sec,Traffic-In-Byte,Traffic-Out-Byte,Traffic-Both-Byte
2022-04-01,1,Alumni,2,5,1286,25441,32588,58029
2022-04-01,1,Non-HKUST,4,18,56653,38381127,2701922232,2740303359
2022-04-01,1,Others(HKUST),4,7,185,6537,13736,20273
2022-04-01,1,RPG,74,278,249327,128523947,8393108809,8521632756
2022-04-01,1,Staff,66,1031,639189,288928199,17838253613,18127181812
2022-04-01,1,TPG,26,150,250648,146045104,6003908853,6149953957
2022-04-01,1,Total,278,2313,1989185,1098284384,56114767487,57213051871
2022-04-01,1,UG,102,824,791897,496374029,21177527656,21673901685
2022-04-01,All-Floors,Alumni,8,338,181850,50960911,2478895305,2529856216
2022-04-01,All-Floors,Non-HKUST,30,197,215645,269362815,6484022222,6753385037
2022-04-01,All-Floors,Others(HKUST),12,209,117134,9645745,299431623,309077368
2022-04-01,All-Floors,RPG,368,1805,980361,1635182237,28235834612,29871016849
2022-04-01,All-Floors,Staff,320,3550,1227422,704450065,31013833123,31718283188
2022-04-01,All-Floors,TPG,119,3900,2466977,3120836892,66329868934,69450705826
2022-04-01,All-Floors,Total,1507,24039,15417620,19682341977,477626683728,497309025705
2022-04-01,All-Floors,UG,650,14040,10228231,13891903312,342784797909,356676701221
2022-04-01,G,Alumni,7,56,2210,6577342,221727781,228305123
2022-04-01,G,Non-HKUST,13,76,28016,10237945,225787336,236025281
2022-04-01,G,Others(HKUST),5,79,28171,8080139,287206661,295286800
2022-04-01,G,RPG,160,457,231972,310982326,3435854590,3746836916
2022-04-01,G,Staff,141,810,344622,143929936,3694022341,3837952277
2022-04-01,G,TPG,80,825,514625,1159983138,28241528216,29401511354
2022-04-01,G,Total,792,5332,2112691,2682167084,67951482300,70633649384
2022-04-01,G,UG,386,3029,963075,1042376258,31845355375,32887731633
2022-04-01,LG1,Alumni,2,75,40168,10766167,439832218,450598385
2022-04-01,LG1,Non-HKUST,11,40,103106,196112888,3029546890,3225659778
2022-04-01,LG1,Others(HKUST),2,48,64342,78953,309432,388385
2022-04-01,LG1,RPG,29,304,292137,903010136,5242044985,6145055121
2022-04-01,LG1,Staff,35,401,113487,86044607,6597047519,6683092126
2022-04-01,LG1,TPG,56,1122,707265,1226952091,12503021190,13729973281
2022-04-01,LG1,Total,411,8699,8292070,13065658811,262986246962,276051905773
2022-04-01,LG1,UG,276,6709,6971565,10642693969,235174444728,245817138697
2022-04-01,LG3,Alumni,7,48,36792,14707696,935263257,949970953
2022-04-01,LG3,Non-HKUST,17,29,16117,3444462,364762432,368206894
2022-04-01,LG3,Others(HKUST),7,35,707,68104,107585,175689
2022-04-01,LG3,RPG,195,351,62446,118984468,5468310782,5587295250
2022-04-01,LG3,Staff,183,658,40710,56350700,948820345,1005171045
2022-04-01,LG3,TPG,61,1080,639754,317564174,10804326787,11121890961
2022-04-01,LG3,Total,852,3636,1293166,992090230,40901409107,41893499337
2022-04-01,LG3,UG,382,1435,496640,480970626,22379817919,22860788545
2022-04-01,LG4,Alumni,7,154,101394,18884265,882039461,900923726
2022-04-01,LG4,Non-HKUST,16,34,11753,21186393,162003332,183189725
2022-04-01,LG4,Others(HKUST),5,40,23729,1412012,11794209,13206221
2022-04-01,LG4,RPG,175,415,144479,173681360,5696515446,5870196806
2022-04-01,LG4,Staff,145,650,89414,129196623,1935689305,2064885928
2022-04-01,LG4,TPG,57,723,354685,270292385,8777083888,9047376273
2022-04-01,LG4,Total,796,4059,1730508,1844141468,49672777872,51516919340
2022-04-01,LG4,UG,391,2043,1005054,1229488430,32207652231,33437140661
2022-04-02,1,Alumni,3,3,325,3639,14709,18348
2022-04-02,1,Non-HKUST,1,1,8109,12049290,337938320,349987610
2022-04-02,1,Others(HKUST),3,4,100,32188,109760,141948
2022-04-02,1,RPG,28,47,23189,26518052,5279957525,5306475577
2022-04-02,1,Staff,21,118,218039,56956368,2031933848,2088890216
2022-04-02,1,TPG,13,19,38099,21810283,1626661185,1648471468
2022-04-02,1,Total,122,791,637591,391938837,28761444720,29153383557
2022-04-02,1,UG,53,599,349730,274569017,19484829373,19759398390
2022-04-02,All-Floors,Alumni,14,569,371228,729158240,40360178326,41089336566
2022-04-02,All-Floors,Non-HKUST,18,148,207543,264399199,7041182852,7305582051
2022-04-02,All-Floors,Others(HKUST),10,86,291477,19820853,603352429,623173282
2022-04-02,All-Floors,RPG,265,1547,826635,1809935866,37972130265,39782066131
2022-04-02,All-Floors,Staff,118,1068,642643,369170459,15356081333,15725251792
2022-04-02,All-Floors,TPG,86,2053,2391221,3850622809,98702234920,102552857729
2022-04-02,All-Floors,Total,1020,14955,12636574,21074324432,615790738662,636865063094
2022-04-02,All-Floors,UG,509,9484,7905827,14031217006,415755578537,429786795543
2022-04-02,G,Alumni,7,71,5290,2772323,401531010,404303333
2022-04-02,G,Non-HKUST,6,24,955,10456152,542256361,552712513
2022-04-02,G,Others(HKUST),3,4,47156,3724486,15110174,18834660
2022-04-02,G,RPG,32,334,124237,969243374,6045858954,7015102328
2022-04-02,G,Staff,30,206,73662,5784022,180695575,186479597
2022-04-02,G,TPG,55,663,386444,359271334,21971439053,22330710387
2022-04-02,G,Total,321,3384,1111753,1971410196,48860223382,50831633578
2022-04-02,G,UG,188,2082,474009,620158505,19703332255,20323490760
2022-04-02,LG1,Alumni,8,348,254877,624146650,33654960928,34279107578
2022-04-02,LG1,Non-HKUST,8,92,186898,222248767,5117870667,5340119434
2022-04-02,LG1,Others(HKUST),1,12,177667,7709711,28105869,35815580
2022-04-02,LG1,RPG,21,490,565207,563827988,18650113211,19213941199
2022-04-02,LG1,Staff,20,269,240365,188457928,4516197545,4704655473
2022-04-02,LG1,TPG,54,988,1639068,3147222087,57380015980,60527238067
2022-04-02,LG1,Total,304,6566,8984403,16520332365,444401372689,460921705054
2022-04-02,LG1,UG,192,4367,5920321,11766719234,325054108489,336820827723
2022-04-02,LG3,Alumni,8,88,48276,47816904,2663906389,2711723293
2022-04-02,LG3,Non-HKUST,12,17,427,26399,78538,104937
2022-04-02,LG3,Others(HKUST),6,24,625,636847,44098312,44735159
2022-04-02,LG3,RPG,189,319,13776,11832580,332104161,343936741
2022-04-02,LG3,Staff,83,278,87557,103259494,6586616023,6689875517
2022-04-02,LG3,TPG,46,161,133594,138667049,3887009371,4025676420
2022-04-02,LG3,Total,700,1963,682107,656263845,34817637542,35473901387
2022-04-02,LG3,UG,356,1076,397852,354024572,21303824748,21657849320
2022-04-02,LG4,Alumni,11,59,62460,54418724,3639765290,3694184014
2022-04-02,LG4,Non-HKUST,7,14,11154,19618591,1043038966,1062657557
2022-04-02,LG4,Others(HKUST),6,42,65929,7717621,515928314,523645935
2022-04-02,LG4,RPG,186,357,100226,238513872,7664096414,7902610286
2022-04-02,LG4,Staff,73,197,23020,14712647,2040638342,2055350989
2022-04-02,LG4,TPG,41,222,194016,183652056,13837109331,14020761387
2022-04-02,LG4,Total,687,2251,1220720,1534379189,58950060329,60484439518
2022-04-02,LG4,UG,363,1360,763915,1015745678,30209483672,31225229350
2022-04-03,1,Alumni,0,0,0,0,0,0
2022-04-03,1,Non-HKUST,0,0,0,0,0,0
2022-04-03,1,Others(HKUST),0,0,0,0,0,0
2022-04-03,1,RPG,9,9,130,44414,385173,429587
2022-04-03,1,Staff,9,57,83419,1241503,5148851,6390354
2022-04-03,1,TPG,2,2,20,0,0,0
2022-04-03,1,Total,31,80,83770,1299717,5875710,7175427
2022-04-03,1,UG,11,12,201,13800,341686,355486
2022-04-03,All-Floors,Alumni,11,70,15755,102788698,9314900367,9417689065
2022-04-03,All-Floors,Non-HKUST,20,70,77996,119951780,8749745192,8869696972
2022-04-03,All-Floors,Others(HKUST),8,83,265781,33862825,1676409925,1710272750
2022-04-03,All-Floors,RPG,309,1479,887461,975547888,28090911027,29066458915
2022-04-03,All-Floors,Staff,128,390,252890,248107625,5725341100,5973448725
2022-04-03,All-Floors,TPG,100,1604,1974278,5077181418,73556921872,78634103290
2022-04-03,All-Floors,Total,1048,9440,8964461,16228451853,410480871307,426709323160
2022-04-03,All-Floors,UG,472,5744,5490300,9671011619,283366641824,293037653443
2022-04-03,G,Alumni,1,3,15,1475,4402,5877
2022-04-03,G,Non-HKUST,0,0,0,0,0,0
2022-04-03,G,Others(HKUST),1,1,14369,0,0,0
2022-04-03,G,RPG,3,3,19,0,0,0
2022-04-03,G,Staff,9,31,966,82457,444166,526623
2022-04-03,G,TPG,3,3,35,0,0,0
2022-04-03,G,Total,29,53,15609,123549,663072,786621
2022-04-03,G,UG,12,12,205,39617,214504,254121
2022-04-03,LG1,Alumni,2,7,90,0,0,0
2022-04-03,LG1,Non-HKUST,3,32,73999,116504262,7924820045,8041324307
2022-04-03,LG1,Others(HKUST),1,10,182025,1067635,6151343,7218978
2022-04-03,LG1,RPG,27,811,843547,918837529,26616073456,27534910985
2022-04-03,LG1,Staff,8,101,151760,228578234,5055636873,5284215107
2022-04-03,LG1,TPG,47,1367,1942467,5055223564,73016896735,78072120299
2022-04-03,LG1,Total,233,6775,8349470,15390603677,366981440686,382372044363
2022-04-03,LG1,UG,145,4447,5155582,9070392453,254361862234,263432254687
2022-04-03,LG3,Alumni,10,31,9545,23224674,2891270208,2914494882
2022-04-03,LG3,Non-HKUST,18,36,3747,3361857,823387317,826749174
2022-04-03,LG3,Others(HKUST),5,29,2754,5646173,87941661,93587834
2022-04-03,LG3,RPG,288,558,41149,44998147,1385394943,1430393090
2022-04-03,LG3,Staff,110,169,15374,17936375,660270407,678206782
2022-04-03,LG3,TPG,85,203,27322,17775723,461484464,479260187
2022-04-03,LG3,Total,949,2159,385680,577839132,21970127704,22547966836
2022-04-03,LG3,UG,433,1133,285789,464896183,15660378704,16125274887
2022-04-03,LG4,Alumni,4,29,6105,79562549,6423625757,6503188306
2022-04-03,LG4,Non-HKUST,2,2,250,85661,1537830,1623491
2022-04-03,LG4,Others(HKUST),4,43,66633,27149017,1582316921,1609465938
2022-04-03,LG4,RPG,62,98,2616,11667798,89057455,100725253
2022-04-03,LG4,Staff,18,32,1371,269056,3840803,4109859
2022-04-03,LG4,TPG,22,29,4434,4182131,78540673,82722804
2022-04-03,LG4,Total,219,373,129932,258585778,21522764135,21781349913
2022-04-03,LG4,UG,107,140,48523,135669566,13343844696,13479514262
2022-04-04,1,Alumni,1,1,10,0,0,0
2022-04-04,1,Non-HKUST,8,65,66166,35675142,1580778704,1616453846
2022-04-04,1,Others(HKUST),1,1,85,16408,105301,121709
2022-04-04,1,RPG,14,268,132897,88218964,4940702836,5028921800
2022-04-04,1,Staff,55,1146,590347,147344200,3638987408,3786331608
2022-04-04,1,TPG,7,66,57834,8462728,162317668,170780396
2022-04-04,1,Total,130,1899,1177137,595783164,21262377446,21858160610
2022-04-04,1,UG,44,352,329798,316065722,10939485529,11255551251
2022-04-04,All-Floors,Alumni,14,424,210224,657752963,18741953270,19399706233
2022-04-04,All-Floors,Non-HKUST,40,773,433225,1119973244,19366965902,20486939146
2022-04-04,All-Floors,Others(HKUST),17,194,149454,31209767,1004107123,1035316890
2022-04-04,All-Floors,RPG,375,2998,1384236,3356420140,56530896171,59887316311
2022-04-04,All-Floors,Staff,336,4339,1232939,3325776773,14419055421,17744832194
2022-04-04,All-Floors,TPG,114,4038,1985959,3678883093,61478075970,65156959063
2022-04-04,All-Floors,Total,1512,28377,13873696,32250387523,536173581072,568423968595
2022-04-04,All-Floors,UG,616,15611,8477659,20080371543,364632527215,384712898758
2022-04-04,G,Alumni,7,65,29880,43710564,1681811899,1725522463
2022-04-04,G,Non-HKUST,18,257,36374,339871888,3625423717,3965295605
2022-04-04,G,Others(HKUST),3,13,17289,0,0,0
2022-04-04,G,RPG,66,636,217682,366607570,5790744370,6157351940
2022-04-04,G,Staff,93,1034,157591,95023804,3077489729,3172513533
2022-04-04,G,TPG,73,1030,307160,477714771,8433064715,8910779486
2022-04-04,G,Total,562,6263,1418873,2991904178,51824123691,54816027869
2022-04-04,G,UG,302,3228,652897,1668975581,29215589261,30884564842
2022-04-04,LG1,Alumni,4,269,84745,172399258,7821880962,7994280220
2022-04-04,LG1,Non-HKUST,21,223,239959,573244296,8403099201,8976343497
2022-04-04,LG1,Others(HKUST),2,26,65763,3963150,23583842,27546992
2022-04-04,LG1,RPG,47,996,706371,2654549958,40536931255,43191481213
2022-04-04,LG1,Staff,45,503,199193,128779881,2843408521,2972188402
2022-04-04,LG1,TPG,64,1077,938744,2097150013,26839646023,28936796036
2022-04-04,LG1,Total,472,10440,7944687,20527520949,326737171343,347264692292
2022-04-04,LG1,UG,289,7346,5709912,14897434393,240268621539,255166055932
2022-04-04,LG3,Alumni,8,14,25366,47275121,2296296949,2343572070
2022-04-04,LG3,Non-HKUST,28,126,31618,72109888,1331133390,1403243278
2022-04-04,LG3,Others(HKUST),12,55,3245,2445062,78820631,81265693
2022-04-04,LG3,RPG,329,746,180692,111600557,3129220917,3240821474
2022-04-04,LG3,Staff,274,994,132382,2865418803,3059478580,5924897383
2022-04-04,LG3,TPG,87,666,358631,410418487,10779252531,11189671018
2022-04-04,LG3,Total,1229,5351,1698056,4862303892,73288481953,78150785845
2022-04-04,LG3,UG,491,2750,966122,1353035974,52614278955,53967314929
2022-04-04,LG4,Alumni,5,75,70223,394368020,6941963460,7336331480
2022-04-04,LG4,Non-HKUST,10,102,59108,99072030,4426530890,4525602920
2022-04-04,LG4,Others(HKUST),6,99,63072,24785147,901597349,926382496
2022-04-04,LG4,RPG,78,352,146594,135443091,2133296793,2268739884
2022-04-04,LG4,Staff,78,662,153426,89210085,1799691183,1888901268
2022-04-04,LG4,TPG,34,1199,323590,685137094,15263795033,15948932127
2022-04-04,LG4,Total,385,4424,1634943,3272875340,63061426639,66334301979
2022-04-04,LG4,UG,174,1935,818930,1844859873,31594551931,33439411804
2022-04-05,1,Alumni,0,0,0,0,0,0
2022-04-05,1,Non-HKUST,0,0,0,0,0,0
2022-04-05,1,Others(HKUST),1,1,70,4230,3230,7460
2022-04-05,1,RPG,19,19,576,866733,35805703,36672436
2022-04-05,1,Staff,7,23,21666,47180,311965,359145
2022-04-05,1,TPG,6,6,205,30818,67756,98574
2022-04-05,1,Total,54,71,24377,2627101,105782122,108409223
2022-04-05,1,UG,21,22,1860,1678140,69593468,71271608
2022-04-05,All-Floors,Alumni,8,26,9816,14572750,835118972,849691722
2022-04-05,All-Floors,Non-HKUST,15,64,83865,155715402,2576797690,2732513092
2022-04-05,All-Floors,Others(HKUST),10,63,249525,14573202,2112891243,2127464445
2022-04-05,All-Floors,RPG,331,1485,1172170,1977041975,68540080392,70517122367
2022-04-05,All-Floors,Staff,130,535,332000,463081716,20859851006,21322932722
2022-04-05,All-Floors,TPG,105,1960,2212233,5020278059,76831222677,81851500736
2022-04-05,All-Floors,Total,1099,13324,12364671,30400904886,559803748633,590204653519
2022-04-05,All-Floors,UG,500,9191,8305062,22755641782,388047786653,410803428435
2022-04-05,G,Alumni,0,0,0,0,0,0
2022-04-05,G,Non-HKUST,0,0,0,0,0,0
2022-04-05,G,Others(HKUST),3,5,20902,0,0,0
2022-04-05,G,RPG,5,5,35,0,0,0
2022-04-05,G,Staff,9,45,22298,1255808,47910418,49166226
2022-04-05,G,TPG,3,4,5187,1944198,3783075,5727273
2022-04-05,G,Total,38,89,49103,3844894,53117462,56962356
2022-04-05,G,UG,18,30,681,644888,1423969,2068857
2022-04-05,LG1,Alumni,0,0,0,0,0,0
2022-04-05,LG1,Non-HKUST,5,45,76772,152707829,2146993661,2299701490
2022-04-05,LG1,Others(HKUST),2,10,176410,982211,2542907,3525118
2022-04-05,LG1,RPG,43,935,1132109,1832284201,65426466490,67258750691
2022-04-05,LG1,Staff,14,199,256421,423688390,18115379682,18539068072
2022-04-05,LG1,TPG,66,1797,2179857,4881974573,75804196439,80686171012
2022-04-05,LG1,Total,342,10936,11843683,28974641705,531340037528,560314679233
2022-04-05,LG1,UG,212,7950,8022114,21683004501,369844458349,391527462850
2022-04-05,LG3,Alumni,7,8,8296,14104917,833837060,847941977
2022-04-05,LG3,Non-HKUST,10,15,780,298381,2498796,2797177
2022-04-05,LG3,Others(HKUST),5,15,725,246589,8669030,8915619
2022-04-05,LG3,RPG,288,440,34547,59503612,1956736153,2016239765
2022-04-05,LG3,Staff,106,207,13791,9686523,238400264,248086787
2022-04-05,LG3,TPG,77,129,26304,128893611,649270991,778164602
2022-04-05,LG3,Total,910,1764,303447,1198037689,17000896500,18198934189
2022-04-05,LG3,UG,417,950,219004,985304056,13311484206,14296788262
2022-04-05,LG4,Alumni,3,18,1520,467833,1281912,1749745
2022-04-05,LG4,Non-HKUST,4,4,6313,2709192,427305233,430014425
2022-04-05,LG4,Others(HKUST),5,32,51418,13340172,2101676076,2115016248
2022-04-05,LG4,RPG,71,86,4903,84387429,1121072046,1205459475
2022-04-05,LG4,Staff,31,61,17824,28403815,2457848677,2486252492
2022-04-05,LG4,TPG,14,24,680,7434859,373904416,381339275
2022-04-05,LG4,Total,295,464,144061,221753497,11303915021,11525668518
2022-04-05,LG4,UG,167,239,61403,85010197,4820826661,4905836858
2022-04-06,1,Alumni,1,2,150,53684,5217604,5271288
2022-04-06,1,Non-HKUST,4,21,90661,137594385,5369652611,5507246996
2022-04-06,1,Others(HKUST),1,1,5,0,0,0
2022-04-06,1,RPG,32,235,220499,186134176,5149452492,5335586668
2022-04-06,1,Staff,60,988,951951,304241652,9704016059,10008257711
2022-04-06,1,TPG,9,141,291074,357614028,10800259654,11157873682
2022-04-06,1,Total,150,2329,2450403,2344203121,80263843025,82608046146
2022-04-06,1,UG,43,941,896063,1358565196,49235244605,50593809801
2022-04-06,All-Floors,Alumni,11,233,178310,127951002,6970296575,7098247577
2022-04-06,All-Floors,Non-HKUST,34,357,568777,1104893249,22500261456,23605154705
2022-04-06,All-Floors,Others(HKUST),16,108,301289,16404052,1356315088,1372719140
2022-04-06,All-Floors,RPG,387,2764,1786131,4336871980,78967193590,83304065570
2022-04-06,All-Floors,Staff,330,3577,1741974,2128826443,26618225831,28747052274
2022-04-06,All-Floors,TPG,111,3010,2917927,6673255246,119946258084,126619513330
2022-04-06,All-Floors,Total,1540,28257,21938011,51805071976,912657366469,964462438445
2022-04-06,All-Floors,UG,651,18208,14443603,37416870004,656298815845,693715685849
2022-04-06,G,Alumni,9,78,36023,67011187,1459129738,1526140925
2022-04-06,G,Non-HKUST,13,113,16208,6902621,220701519,227604140
2022-04-06,G,Others(HKUST),2,6,20589,23700,44586,68286
2022-04-06,G,RPG,72,589,326799,1129249135,29035348662,30164597797
2022-04-06,G,Staff,83,827,335550,1479516446,5649323700,7128840146
2022-04-06,G,TPG,70,853,362834,640033196,17376920960,18016954156
2022-04-06,G,Total,586,6360,2294383,9090273011,142649809778,151740082789
2022-04-06,G,UG,337,3894,1196380,5767536726,88908340613,94675877339
2022-04-06,LG1,Alumni,3,28,24201,1917262,14442630,16359892
2022-04-06,LG1,Non-HKUST,17,178,445914,878921742,16275687309,17154609051
2022-04-06,LG1,Others(HKUST),2,8,196137,921316,2468009,3389325
2022-04-06,LG1,RPG,48,1035,885417,1856487522,26105433272,27961920794
2022-04-06,LG1,Staff,45,524,301776,180438915,8608180931,8788619846
2022-04-06,LG1,TPG,58,1090,1494568,4462698828,59656834022,64119532850
2022-04-06,LG1,Total,474,11967,13210068,33782339946,502641800164,536424140110
2022-04-06,LG1,UG,301,9104,9862055,26400954361,391978753991,418379708352
2022-04-06,LG3,Alumni,3,9,497,69194,1786761,1855955
2022-04-06,LG3,Non-HKUST,22,35,15819,81437493,633912883,715350376
2022-04-06,LG3,Others(HKUST),13,51,4316,1933316,222270684,224204000
2022-04-06,LG3,RPG,319,659,200338,244806308,7410614303,7655420611
2022-04-06,LG3,Staff,267,811,110592,146878173,2335869324,2482747497
2022-04-06,LG3,TPG,78,270,267466,790392857,10991947273,11782340130
2022-04-06,LG3,Total,1195,4034,2016379,3199337291,81772962406,84972299697
2022-04-06,LG3,UG,493,2199,1417351,1933819950,60176561178,62110381128
2022-04-06,LG4,Alumni,7,116,117439,58899675,5489719842,5548619517
2022-04-06,LG4,Non-HKUST,6,10,175,37008,307134,344142
2022-04-06,LG4,Others(HKUST),8,42,80242,13525720,1131531809,1145057529
2022-04-06,LG4,RPG,113,246,153078,920194839,11266344861,12186539700
2022-04-06,LG4,Staff,73,427,42105,17751257,320835817,338587074
2022-04-06,LG4,TPG,33,656,501985,422516337,21120296175,21542812512
2022-04-06,LG4,Total,443,3567,1966778,3388918607,105328951096,108717869703
2022-04-06,LG4,UG,203,2070,1071754,1955993771,65999915458,67955909229
2022-04-07,1,Alumni,2,2,360,13978,38564,52542
2022-04-07,1,Non-HKUST,9,59,74300,235357826,3470333115,3705690941
2022-04-07,1,Others(HKUST),1,1,5,0,0,0
2022-04-07,1,RPG,23,280,215025,257571082,10965840311,11223411393
2022-04-07,1,Staff,50,707,708648,241930870,19726953737,19968884607
2022-04-07,1,TPG,17,159,259431,911841971,8148274455,9060116426
2022-04-07,1,Total,155,1978,2076437,2840229663,92333518296,95173747959
2022-04-07,1,UG,53,770,818668,1193513936,50022078114,51215592050
2022-04-07,All-Floors,Alumni,14,567,337227,1382960427,20723492377,22106452804
2022-04-07,All-Floors,Non-HKUST,37,446,405195,689647473,9555243313,10244890786
2022-04-07,All-Floors,Others(HKUST),18,122,241123,13904850,413156150,427061000
2022-04-07,All-Floors,RPG,425,3102,1637506,5103780857,56826365946,61930146803
2022-04-07,All-Floors,Staff,376,3374,1494739,1113855712,41902961093,43016816805
2022-04-07,All-Floors,TPG,125,3962,3171068,9130183584,152882349421,162012533005
2022-04-07,All-Floors,Total,1674,30968,21120790,55778303078,1000977517055,1056755820133
2022-04-07,All-Floors,UG,679,19395,13833932,38343970175,718673948755,757017918930
2022-04-07,G,Alumni,8,230,124096,851414210,7282967784,8134381994
2022-04-07,G,Non-HKUST,16,125,18185,4612833,50087379,54700212
2022-04-07,G,Others(HKUST),6,14,41498,504884,22802765,23307649
2022-04-07,G,RPG,62,619,240476,843007740,8920280044,9763287784
2022-04-07,G,Staff,82,761,254732,333454728,6667844284,7001299012
2022-04-07,G,TPG,82,987,589854,1145786707,25650148800,26795935507
2022-04-07,G,Total,584,6639,2485957,8073476686,106552027639,114625504325
2022-04-07,G,UG,328,3903,1217116,4894695584,57957896583,62852592167
2022-04-07,LG1,Alumni,7,53,51386,371855249,4808836784,5180692033
2022-04-07,LG1,Non-HKUST,16,160,287459,419392468,5578069299,5997461767
2022-04-07,LG1,Others(HKUST),3,18,142239,3737272,12444432,16181704
2022-04-07,LG1,RPG,49,875,756841,3257749710,22416718326,25674468036
2022-04-07,LG1,Staff,52,539,319813,435974501,12255135305,12691109806
2022-04-07,LG1,TPG,73,1515,1489379,6283125757,87250074101,93533199858
2022-04-07,LG1,Total,522,12617,12021912,37549964259,540005080713,577555044972
2022-04-07,LG1,UG,322,9457,8974795,26778129302,407683802466,434461931768
2022-04-07,LG3,Alumni,10,57,16881,86998413,1014763622,1101762035
2022-04-07,LG3,Non-HKUST,19,93,25017,30277026,456750662,487027688
2022-04-07,LG3,Others(HKUST),11,46,2098,472036,15677172,16149208
2022-04-07,LG3,RPG,377,976,164999,241241715,4748350717,4989592432
2022-04-07,LG3,Staff,297,974,169818,83408681,2493690854,2577099535
2022-04-07,LG3,TPG,83,429,349190,388617020,15935823911,16324440931
2022-04-07,LG3,Total,1336,5761,2266076,3658636279,115405114138,119063750417
2022-04-07,LG3,UG,539,3186,1538073,2827621388,90740057200,93567678588
2022-04-07,LG4,Alumni,6,225,144504,72678577,7616885623,7689564200
2022-04-07,LG4,Non-HKUST,3,9,234,7320,2858,10178
2022-04-07,LG4,Others(HKUST),10,43,55283,9190658,362231781,371422439
2022-04-07,LG4,RPG,106,352,260165,504210610,9775176548,10279387158
2022-04-07,LG4,Staff,86,393,41728,19086932,759336913,778423845
2022-04-07,LG4,TPG,45,872,483214,400812129,15898028154,16298840283
2022-04-07,LG4,Total,495,3973,2270408,3655996191,146681776269,150337772460
2022-04-07,LG4,UG,239,2079,1285280,2650009965,112270114392,114920124357
2022-04-08,1,Alumni,1,1,11313,10272943,277950187,288223130
2022-04-08,1,Non-HKUST,8,22,48217,68029660,1369471692,1437501352
2022-04-08,1,Others(HKUST),1,1,5,0,0,0
2022-04-08,1,RPG,29,175,322909,427958588,29273561276,29701519864
2022-04-08,1,Staff,52,1317,957598,369015899,15158360210,15527376109
2022-04-08,1,TPG,18,146,139175,181108624,6728950601,6910059225
2022-04-08,1,Total,174,2112,2164426,2365507855,80836238943,83201746798
2022-04-08,1,UG,65,450,685209,1309122141,28027944977,29337067118
2022-04-08,All-Floors,Alumni,13,1255,466521,1546101497,21313273641,22859375138
2022-04-08,All-Floors,Non-HKUST,34,419,306597,666314562,17880453987,18546768549
2022-04-08,All-Floors,Others(HKUST),16,91,162530,45788651,2749453399,2795242050
2022-04-08,All-Floors,RPG,401,2414,1480565,5190545469,71527204446,76717749915
2022-04-08,All-Floors,Staff,377,4402,1659595,1171657630,26170330443,27341988073
2022-04-08,All-Floors,TPG,121,4208,3031709,5784822225,116132610061,121917432286
2022-04-08,All-Floors,Total,1598,25824,16805511,41925589669,732567849092,774493438761
2022-04-08,All-Floors,UG,636,13035,9697994,27520359635,476794523115,504314882750
2022-04-08,G,Alumni,9,336,110811,1014493632,5546250378,6560744010
2022-04-08,G,Non-HKUST,14,142,27158,55575415,2009359601,2064935016
2022-04-08,G,Others(HKUST),4,5,22874,9850,128736,138586
2022-04-08,G,RPG,67,729,318999,1928546375,13351420045,15279966420
2022-04-08,G,Staff,123,878,289832,145130829,3547197982,3692328811
2022-04-08,G,TPG,75,1269,538640,782906397,29745811129,30528717526
2022-04-08,G,Total,571,6780,2195078,5866945278,88548972236,94415917514
2022-04-08,G,UG,279,3421,886764,1940282780,34348804365,36289087145
2022-04-08,LG1,Alumni,7,689,167589,414128761,7225942855,7640071616
2022-04-08,LG1,Non-HKUST,14,130,206116,500962544,11419245688,11920208232
2022-04-08,LG1,Others(HKUST),4,14,46309,9038694,27128675,36167369
2022-04-08,LG1,RPG,51,622,520873,2488911022,16281237516,18770148538
2022-04-08,LG1,Staff,111,645,275272,179243744,3792650718,3971894462
2022-04-08,LG1,TPG,68,1419,1510575,3623405908,48712310420,52335716328
2022-04-08,LG1,Total,515,8859,8607515,26459928322,371282756864,397742685186
2022-04-08,LG1,UG,260,5340,5880781,19244237649,283824240992,303068478641
2022-04-08,LG3,Alumni,6,49,2440,605142,9030172,9635314
2022-04-08,LG3,Non-HKUST,22,64,3872,3959035,42947464,46906499
2022-04-08,LG3,Others(HKUST),13,38,3687,10747642,329507512,340255154
2022-04-08,LG3,RPG,327,578,133698,169020293,6053876123,6222896416
2022-04-08,LG3,Staff,272,1098,91065,463243987,3422219357,3885463344
2022-04-08,LG3,TPG,85,578,284653,684367855,13807370135,14491737990
2022-04-08,LG3,Total,1233,4501,1893716,3997750858,101836372407,105834123265
2022-04-08,LG3,UG,508,2096,1374301,2665806904,78171421644,80837228548
2022-04-08,LG4,Alumni,9,180,174368,106601019,8254100049,8360701068
2022-04-08,LG4,Non-HKUST,9,61,21234,37787908,3039429542,3077217450
2022-04-08,LG4,Others(HKUST),8,33,89655,25992465,2392688476,2418680941
2022-04-08,LG4,RPG,98,310,184086,176109191,6567109486,6743218677
2022-04-08,LG4,Staff,76,464,45828,15023171,249902176,264925347
2022-04-08,LG4,TPG,35,796,558666,513033441,17138167776,17651201217
2022-04-08,LG4,Total,422,3572,1944776,3235457356,90063508642,93298965998
2022-04-08,LG4,UG,187,1728,870939,2360910161,52422111137,54783021298
2022-04-09,1,Alumni,4,9,11932,9408350,1275543214,1284951564
2022-04-09,1,Non-HKUST,1,5,90,25099,19474,44573
2022-04-09,1,Others(HKUST),1,1,15,0,0,0
2022-04-09,1,RPG,13,21,1515,5861521,22855616,28717137
2022-04-09,1,Staff,14,87,139696,90482618,6757217862,6847700480
2022-04-09,1,TPG,6,14,26663,13941666,824295911,838237577
2022-04-09,1,Total,75,344,469536,422608102,22879973715,23302581817
2022-04-09,1,UG,36,207,289625,302888848,14000041638,14302930486
2022-04-09,All-Floors,Alumni,21,566,348485,1457204563,22149145572,23606350135
2022-04-09,All-Floors,Non-HKUST,20,119,196030,544803134,9350241711,9895044845
2022-04-09,All-Floors,Others(HKUST),14,85,137888,28009392,731005828,759015220
2022-04-09,All-Floors,RPG,277,1867,696301,1400064915,41474028444,42874093359
2022-04-09,All-Floors,Staff,168,1020,383079,396759443,15562888007,15959647450
2022-04-09,All-Floors,TPG,90,2331,2245932,5444442328,84793914865,90238357193
2022-04-09,All-Floors,Total,1083,13061,9405985,19521538938,442551345380,462072884318
2022-04-09,All-Floors,UG,493,7073,5398270,10250255163,268490120953,278740376116
2022-04-09,G,Alumni,9,192,48545,95946881,3215251539,3311198420
2022-04-09,G,Non-HKUST,3,16,240,38686,88219,126905
2022-04-09,G,Others(HKUST),3,6,16939,3894913,19543768,23438681
2022-04-09,G,RPG,41,635,85899,286492390,6147826510,6434318900
2022-04-09,G,Staff,63,400,88195,36537863,670823928,707361791
2022-04-09,G,TPG,57,1012,389663,449870094,11697329780,12147199874
2022-04-09,G,Total,326,4090,1212596,2058695935,46346807374,48405503309
2022-04-09,G,UG,150,1829,583115,1185915108,24595943630,25781858738
2022-04-09,LG1,Alumni,10,176,177184,1225725997,12033789756,13259515753
2022-04-09,LG1,Non-HKUST,8,61,163583,516241010,7629533014,8145774024
2022-04-09,LG1,Others(HKUST),3,4,27201,6950178,22436567,29386745
2022-04-09,LG1,RPG,37,723,415493,712584158,13684391186,14396975344
2022-04-09,LG1,Staff,52,218,74405,68786082,3808814585,3877600667
2022-04-09,LG1,TPG,50,844,1484847,4556756022,58729396942,63286152964
2022-04-09,LG1,Total,304,4683,5862576,14104881031,260468456181,274573337212
2022-04-09,LG1,UG,144,2657,3519863,7017837584,164560094131,171577931715
2022-04-09,LG3,Alumni,15,59,24764,22996746,1584346484,1607343230
2022-04-09,LG3,Non-HKUST,15,31,29816,27876958,1709776768,1737653726
2022-04-09,LG3,Others(HKUST),10,36,3138,399705,3020803,3420508
2022-04-09,LG3,RPG,229,392,153136,380846575,21458030049,21838876624
2022-04-09,LG3,Staff,105,221,52588,188408455,518874524,707282979
2022-04-09,LG3,TPG,58,234,195818,296295027,5787462897,6083757924
2022-04-09,LG3,Total,845,2322,932145,1825255616,72875494250,74700749866
2022-04-09,LG3,UG,413,1349,472885,908432150,41813982725,42722414875
2022-04-09,LG4,Alumni,8,130,86060,103126589,4040214579,4143341168
2022-04-09,LG4,Non-HKUST,4,6,2301,621381,10824236,11445617
2022-04-09,LG4,Others(HKUST),5,38,90595,16764596,686004690,702769286
2022-04-09,LG4,RPG,59,96,40258,14280271,160925083,175205354
2022-04-09,LG4,Staff,32,94,28195,12544425,3807157108,3819701533
2022-04-09,LG4,TPG,20,227,148941,127579519,7755429335,7883008854
2022-04-09,LG4,Total,250,1622,929132,1110098254,39980613860,41090712114
2022-04-09,LG4,UG,122,1031,532782,835181473,23520058829,24355240302
2022-04-10,1,Alumni,0,0,0,0,0,0
2022-04-10,1,Non-HKUST,0,0,0,0,0,0
2022-04-10,1,Others(HKUST),0,0,0,0,0,0
2022-04-10,1,RPG,6,6,45,48125,953672,1001797
2022-04-10,1,Staff,7,59,81799,26751067,108765278,135516345
2022-04-10,1,TPG,2,3,15,0,0,0
2022-04-10,1,Total,31,84,82124,94649556,1100392831,1195042387
2022-04-10,1,UG,16,16,265,67850364,990673881,1058524245
2022-04-10,All-Floors,Alumni,10,50,6852,4725329,120512842,125238171
2022-04-10,All-Floors,Non-HKUST,13,58,88455,103731066,5652539366,5756270432
2022-04-10,All-Floors,Others(HKUST),7,53,134517,24102071,146341255,170443326
2022-04-10,All-Floors,RPG,259,1160,855691,1551524909,39157701439,40709226348
2022-04-10,All-Floors,Staff,143,655,286484,252461508,3743725233,3996186741
2022-04-10,All-Floors,TPG,68,1429,1597572,2935278571,47268730432,50204009003
2022-04-10,All-Floors,Total,936,9063,9075107,18824028304,375399293276,394223321580
2022-04-10,All-Floors,UG,436,5658,6105536,13952204850,279309742709,293261947559
2022-04-10,G,Alumni,0,0,0,0,0,0
2022-04-10,G,Non-HKUST,0,0,0,0,0,0
2022-04-10,G,Others(HKUST),2,21,31973,10170926,101719361,111890287
2022-04-10,G,RPG,23,36,2252,511972,5585620,6097592
2022-04-10,G,Staff,39,157,13726,3532235,30958268,34490503
2022-04-10,G,TPG,2,2,30,16481,22141,38622
2022-04-10,G,Total,88,251,52217,30225072,466538957,496764029
2022-04-10,G,UG,22,35,4236,15993458,328253567,344247025
2022-04-10,LG1,Alumni,0,0,0,0,0,0
2022-04-10,LG1,Non-HKUST,4,44,86135,103353383,5645061920,5748415303
2022-04-10,LG1,Others(HKUST),2,10,27438,7302060,15416288,22718348
2022-04-10,LG1,RPG,47,742,818890,1396718178,37274167555,38670885733
2022-04-10,LG1,Staff,45,273,172737,217712428,3512676975,3730389403
2022-04-10,LG1,TPG,41,1334,1588131,2922162323,45625852269,48548014592
2022-04-10,LG1,Total,308,7199,8553789,18106373104,347657038097,365763411201
2022-04-10,LG1,UG,169,4796,5860458,13459124732,255583863090,269042987822
2022-04-10,LG3,Alumni,10,17,4333,3112152,87705618,90817770
2022-04-10,LG3,Non-HKUST,8,10,2255,372458,7470154,7842612
2022-04-10,LG3,Others(HKUST),3,10,465,135475,5322909,5458384
2022-04-10,LG3,RPG,204,293,29993,93768274,1546047617,1639815891
2022-04-10,LG3,Staff,88,123,16967,4401468,89768716,94170184
2022-04-10,LG3,TPG,41,78,6623,9989202,318163776,328152978
2022-04-10,LG3,Total,690,1179,278773,469001663,22332707229,22801708892
2022-04-10,LG3,UG,336,648,218137,357222634,20278228439,20635451073
2022-04-10,LG4,Alumni,4,33,2519,1613177,32807224,34420401
2022-04-10,LG4,Non-HKUST,4,4,65,5225,7292,12517
2022-04-10,LG4,Others(HKUST),4,12,74641,6493610,23882697,30376307
2022-04-10,LG4,RPG,69,83,4511,60478360,330946975,391425335
2022-04-10,LG4,Staff,18,43,1255,64310,1555996,1620306
2022-04-10,LG4,TPG,11,12,2773,3110565,1324692246,1327802811
2022-04-10,LG4,Total,234,350,108204,123778909,3842616162,3966395071
2022-04-10,LG4,UG,124,163,22440,52013662,2128723732,2180737394
2022-04-11,1,Alumni,1,2,120,16754,42861,59615
2022-04-11,1,Non-HKUST,5,11,24599,112044293,4342082035,4454126328
2022-04-11,1,Others(HKUST),0,0,0,0,0,0
2022-04-11,1,RPG,16,60,103278,186694252,6384926360,6571620612
2022-04-11,1,Staff,63,1291,1056381,1999558134,10684618446,12684176580
2022-04-11,1,TPG,22,165,190276,503009092,9584555237,10087564329
2022-04-11,1,Total,190,2144,2667543,7095056426,85942438956,93037495382
2022-04-11,1,UG,83,615,1292889,4293733901,54946214017,59239947918
2022-04-11,All-Floors,Alumni,13,421,246594,396048048,13567546373,13963594421
2022-04-11,All-Floors,Non-HKUST,33,542,427178,792689447,14351476140,15144165587
2022-04-11,All-Floors,Others(HKUST),23,127,217448,29935445,952482937,982418382
2022-04-11,All-Floors,RPG,383,2994,1655505,3909457612,68927173392,72836631004
2022-04-11,All-Floors,Staff,483,5347,1866027,5167752335,35730693028,40898445363
2022-04-11,All-Floors,TPG,124,3406,2835469,6034700569,115953288977,121987989546
2022-04-11,All-Floors,Total,1768,29993,22427578,60199333233,873249009121,933448342354
2022-04-11,All-Floors,UG,709,17156,15179357,43868749777,623766348274,667635098051
2022-04-11,G,Alumni,8,51,6980,11659615,477063758,488723373
2022-04-11,G,Non-HKUST,13,187,62470,94514468,516443379,610957847
2022-04-11,G,Others(HKUST),4,7,30940,337433,4366284,4703717
2022-04-11,G,RPG,61,659,329152,1196944144,18234004300,19430948444
2022-04-11,G,Staff,137,1124,227758,1719854622,3051544970,4771399592
2022-04-11,G,TPG,80,1061,583619,846204992,31327482955,32173687947
2022-04-11,G,Total,698,6726,2315675,7021651537,95874834877,102896486414
2022-04-11,G,UG,395,3637,1074756,3152136263,42263929231,45416065494
2022-04-11,LG1,Alumni,6,110,82868,230951485,8554880814,8785832299
2022-04-11,LG1,Non-HKUST,13,174,300734,570200165,8954353651,9524553816
2022-04-11,LG1,Others(HKUST),7,13,81609,7336500,19497897,26834397
2022-04-11,LG1,RPG,49,993,886418,2016705494,33731138147,35747843641
2022-04-11,LG1,Staff,137,956,250448,521162777,12453370568,12974533345
2022-04-11,LG1,TPG,64,1103,1216672,3970627110,40426782434,44397409544
2022-04-11,LG1,Total,638,11655,12424880,38214294638,475329064499,513543359137
2022-04-11,LG1,UG,362,8306,9606131,30897311107,371189040988,402086352095
2022-04-11,LG3,Alumni,11,36,8683,44262555,1426645825,1470908380
2022-04-11,LG3,Non-HKUST,19,101,37034,15450036,526854030,542304066
2022-04-11,LG3,Others(HKUST),15,57,7533,4053864,420842511,424896375
2022-04-11,LG3,RPG,314,1068,189482,299605469,5817205657,6116811126
2022-04-11,LG3,Staff,329,1190,262909,894590641,8811320736,9705911377
2022-04-11,LG3,TPG,86,518,450355,367750361,10806309570,11174059931
2022-04-11,LG3,Total,1286,5188,2583432,4459984974,114399601558,118859586532
2022-04-11,LG3,UG,512,2218,1627436,2834272048,86590423229,89424695277
2022-04-11,LG4,Alumni,6,222,147943,109157639,3108913115,3218070754
2022-04-11,LG4,Non-HKUST,9,69,2341,480485,11743045,12223530
2022-04-11,LG4,Others(HKUST),9,50,97366,18207648,507776245,525983893
2022-04-11,LG4,RPG,118,214,147175,209508253,4759898928,4969407181
2022-04-11,LG4,Staff,122,786,68531,32586161,729838308,762424469
2022-04-11,LG4,TPG,51,559,394547,347109014,23808158781,24155267795
2022-04-11,LG4,Total,555,4280,2436048,3408345658,101703069231,105111414889
2022-04-11,LG4,UG,240,2380,1578145,2691296458,68776740809,71468037267
2022-04-12,1,Alumni,1,2,130,4229,11067,15296
2022-04-12,1,Non-HKUST,5,57,80155,155588413,9169651203,9325239616
2022-04-12,1,Others(HKUST),2,2,30,0,0,0
2022-04-12,1,RPG,26,256,465942,9258189256,60699177330,69957366586
2022-04-12,1,Staff,67,1385,1155269,542665806,12351738306,12894404112
2022-04-12,1,TPG,11,86,190688,957896812,17247552540,18205449352
2022-04-12,1,Total,181,2236,2613490,12784558957,154164220932,166948779889
2022-04-12,1,UG,69,448,721276,1870214441,54696090486,56566304927
2022-04-12,All-Floors,Alumni,14,269,193644,697070494,13876487711,14573558205
2022-04-12,All-Floors,Non-HKUST,41,631,548269,1406714788,30850372079,32257086867
2022-04-12,All-Floors,Others(HKUST),22,122,227820,44302860,3511531098,3555833958
2022-04-12,All-Floors,RPG,422,2850,2161010,13075247988,168661928427,181737176415
2022-04-12,All-Floors,Staff,462,4551,2065383,2150237273,36686919693,38837156966
2022-04-12,All-Floors,TPG,116,3577,2945817,6207239543,152933557060,159140796603
2022-04-12,All-Floors,Total,1726,27984,20928809,56235444263,1318543794477,1374779238740
2022-04-12,All-Floors,UG,649,15984,12786866,32654631317,912022998409,944677629726
2022-04-12,G,Alumni,9,84,47652,464998203,4766179004,5231177207
2022-04-12,G,Non-HKUST,18,147,69917,111060145,370628964,481689109
2022-04-12,G,Others(HKUST),4,7,41373,5631409,55377362,61008771
2022-04-12,G,RPG,87,533,382642,650147300,32830573069,33480720369
2022-04-12,G,Staff,148,1165,504720,683179967,11267337557,11950517524
2022-04-12,G,TPG,80,810,746657,1356491260,36529646578,37886137838
2022-04-12,G,Total,677,5870,2947923,6896904533,158646894425,165543798958
2022-04-12,G,UG,331,3124,1154962,3625396249,72827151891,76452548140
2022-04-12,LG1,Alumni,3,7,27755,145870024,633236442,779106466
2022-04-12,LG1,Non-HKUST,19,326,343154,853668426,18866975100,19720643526
2022-04-12,LG1,Others(HKUST),3,5,83783,10913175,72559808,83472983
2022-04-12,LG1,RPG,53,1075,837170,2586960618,54933760526,57520721144
2022-04-12,LG1,Staff,91,498,193855,693221886,3042024978,3735246864
2022-04-12,LG1,TPG,64,1105,1104658,2977452452,64484892882,67462345334
2022-04-12,LG1,Total,528,11056,10647021,29068200197,663422501759,692490701956
2022-04-12,LG1,UG,295,8040,8056646,21800113616,521389052023,543189165639
2022-04-12,LG3,Alumni,8,15,740,1437326,114371629,115808955
2022-04-12,LG3,Non-HKUST,21,61,49680,283614490,2127686164,2411300654
2022-04-12,LG3,Others(HKUST),16,59,3291,2346650,290371437,292718087
2022-04-12,LG3,RPG,344,784,289159,454721683,17214099440,17668821123
2022-04-12,LG3,Staff,330,1031,164611,195577259,9123037422,9318614681
2022-04-12,LG3,TPG,79,548,459168,390270079,24436138722,24826408801
2022-04-12,LG3,Total,1286,4857,2220334,3254533400,142992565558,146247098958
2022-04-12,LG3,UG,488,2359,1253685,1926565913,89686860744,91613426657
2022-04-12,LG4,Alumni,8,161,117367,84760712,8362689569,8447450281
2022-04-12,LG4,Non-HKUST,9,40,5363,2783314,315430648,318213962
2022-04-12,LG4,Others(HKUST),9,49,99343,25411626,3093222491,3118634117
2022-04-12,LG4,RPG,106,202,186097,125229131,2984318062,3109547193
2022-04-12,LG4,Staff,120,472,46928,35592355,902781430,938373785
2022-04-12,LG4,TPG,40,1028,444646,525128940,10235326338,10760455278
2022-04-12,LG4,Total,498,3965,2500041,4231247176,199317611803,203548858979
2022-04-12,LG4,UG,206,2013,1600297,3432341098,173423843265,176856184363
2022-04-13,1,Alumni,0,0,0,0,0,0
2022-04-13,1,Non-HKUST,0,0,0,0,0,0
2022-04-13,1,Others(HKUST),0,0,0,0,0,0
2022-04-13,1,RPG,0,0,0,0,0,0
2022-04-13,1,Staff,0,0,0,0,0,0
2022-04-13,1,TPG,0,0,0,0,0,0
2022-04-13,1,Total,1,1,40,135631607,389694451,525326058
2022-04-13,1,UG,1,1,40,135631607,389694451,525326058
2022-04-13,All-Floors,Alumni,1,16,940,3414115,195147692,198561807
2022-04-13,All-Floors,Non-HKUST,1,1,5,0,0,0
2022-04-13,All-Floors,Others(HKUST),0,0,0,0,0,0
2022-04-13,All-Floors,RPG,2,3,106,21242,282112,303354
2022-04-13,All-Floors,Staff,3,3,1060,76855,422868,499723
2022-04-13,All-Floors,TPG,0,0,0,0,0,0
2022-04-13,All-Floors,Total,29,56,4061,283205593,2089396332,2372601925
2022-04-13,All-Floors,UG,22,33,1950,279693381,1893543660,2173237041
2022-04-13,G,Alumni,0,0,0,0,0,0
2022-04-13,G,Non-HKUST,0,0,0,0,0,0
2022-04-13,G,Others(HKUST),0,0,0,0,0,0
2022-04-13,G,RPG,0,0,0,0,0,0
2022-04-13,G,Staff,0,0,0,0,0,0
2022-04-13,G,TPG,0,0,0,0,0,0
2022-04-13,G,Total,0,0,0,0,0,0
2022-04-13,G,UG,0,0,0,0,0,0
2022-04-13,LG1,Alumni,0,0,0,0,0,0
2022-04-13,LG1,Non-HKUST,0,0,0,0,0,0
2022-04-13,LG1,Others(HKUST),0,0,0,0,0,0
2022-04-13,LG1,RPG,0,0,0,0,0,0
2022-04-13,LG1,Staff,0,0,0,0,0,0
2022-04-13,LG1,TPG,0,0,0,0,0,0
2022-04-13,LG1,Total,0,0,0,0,0,0
2022-04-13,LG1,UG,0,0,0,0,0,0
2022-04-13,LG3,Alumni,0,0,0,0,0,0
2022-04-13,LG3,Non-HKUST,0,0,0,0,0,0
2022-04-13,LG3,Others(HKUST),0,0,0,0,0,0
2022-04-13,LG3,RPG,1,1,36,0,0,0
2022-04-13,LG3,Staff,3,3,1060,76855,422868,499723
2022-04-13,LG3,TPG,0,0,0,0,0,0
2022-04-13,LG3,Total,21,26,2560,144120621,1504242752,1648363373
2022-04-13,LG3,UG,17,22,1464,144043766,1503819884,1647863650
2022-04-13,LG4,Alumni,1,16,940,3414115,195147692,198561807
2022-04-13,LG4,Non-HKUST,1,1,5,0,0,0
2022-04-13,LG4,Others(HKUST),0,0,0,0,0,0
2022-04-13,LG4,RPG,2,2,70,21242,282112,303354
2022-04-13,LG4,Staff,0,0,0,0,0,0
2022-04-13,LG4,TPG,0,0,0,0,0,0
2022-04-13,LG4,Total,12,29,1461,3453365,195459129,198912494
2022-04-13,LG4,UG,8,10,446,18008,29325,47333
2022-04-14,1,Alumni,0,0,0,0,0,0
2022-04-14,1,Non-HKUST,0,0,0,0,0,0
2022-04-14,1,Others(HKUST),0,0,0,0,0,0
2022-04-14,1,RPG,0,0,0,0,0,0
2022-04-14,1,Staff,4,17,153375,8068,6292,14360
2022-04-14,1,TPG,0,0,0,0,0,0
2022-04-14,1,Total,4,17,153375,8068,6292,14360
2022-04-14,1,UG,0,0,0,0,0,0
2022-04-14,All-Floors,Alumni,1,1,5,0,0,0
2022-04-14,All-Floors,Non-HKUST,2,3,409,80486,574246,654732
2022-04-14,All-Floors,Others(HKUST),5,10,662420,0,0,0
2022-04-14,All-Floors,RPG,8,8,14799,15049138,315816788,330865926
2022-04-14,All-Floors,Staff,9,66,308450,383124,3151806,3534930
2022-04-14,All-Floors,TPG,0,0,0,0,0,0
2022-04-14,All-Floors,Total,53,144,990650,17816279,445338157,463154436
2022-04-14,All-Floors,UG,28,56,4567,2303531,125795317,128098848
2022-04-14,G,Alumni,0,0,0,0,0,0
2022-04-14,G,Non-HKUST,0,0,0,0,0,0
2022-04-14,G,Others(HKUST),2,3,229400,0,0,0
2022-04-14,G,RPG,0,0,0,0,0,0
2022-04-14,G,Staff,4,10,153349,202616,913722,1116338
2022-04-14,G,TPG,0,0,0,0,0,0
2022-04-14,G,Total,6,13,382749,202616,913722,1116338
2022-04-14,G,UG,0,0,0,0,0,0
2022-04-14,LG1,Alumni,0,0,0,0,0,0
2022-04-14,LG1,Non-HKUST,0,0,0,0,0,0
2022-04-14,LG1,Others(HKUST),2,4,280090,0,0,0
2022-04-14,LG1,RPG,0,0,0,0,0,0
2022-04-14,LG1,Staff,2,3,237,19583,1109119,1128702
2022-04-14,LG1,TPG,0,0,0,0,0,0
2022-04-14,LG1,Total,4,7,280327,19583,1109119,1128702
2022-04-14,LG1,UG,0,0,0,0,0,0
2022-04-14,LG3,Alumni,0,0,0,0,0,0
2022-04-14,LG3,Non-HKUST,2,2,399,80486,574246,654732
2022-04-14,LG3,Others(HKUST),0,0,0,0,0,0
2022-04-14,LG3,RPG,6,6,14794,15049138,315816788,330865926
2022-04-14,LG3,Staff,5,21,924,34009,50885,84894
2022-04-14,LG3,TPG,0,0,0,0,0,0
2022-04-14,LG3,Total,38,72,20334,17356909,436073066,453429975
2022-04-14,LG3,UG,25,43,4217,2193276,119631147,121824423
2022-04-14,LG4,Alumni,1,1,5,0,0,0
2022-04-14,LG4,Non-HKUST,1,1,10,0,0,0
2022-04-14,LG4,Others(HKUST),3,3,152930,0,0,0
2022-04-14,LG4,RPG,2,2,5,0,0,0
2022-04-14,LG4,Staff,2,15,565,118848,1071788,1190636
2022-04-14,LG4,TPG,0,0,0,0,0,0
2022-04-14,LG4,Total,13,35,153865,229103,7235958,7465061
2022-04-14,LG4,UG,4,13,350,110255,6164170,6274425
2022-04-15,1,Alumni,5,86,63458,32612690,842868318,875481008
2022-04-15,1,Non-HKUST,1,3,23045,18142559,468300824,486443383
2022-04-15,1,Others(HKUST),1,1,0,0,0,0
2022-04-15,1,RPG,60,99,99060,307082485,5064248947,5371331432
2022-04-15,1,Staff,19,87,205984,132687314,5895970313,6028657627
2022-04-15,1,TPG,22,300,288679,272396358,9418734140,9691130498
2022-04-15,1,Total,192,1005,1156914,3522315346,46573493219,50095808565
2022-04-15,1,UG,84,429,476688,2759393940,24883370677,27642764617
2022-04-15,All-Floors,Alumni,16,545,470127,1731470057,32517312110,34248782167
2022-04-15,All-Floors,Non-HKUST,31,434,333399,512167426,12919329935,13431497361
2022-04-15,All-Floors,Others(HKUST),11,87,479858,46133299,3948720813,3994854112
2022-04-15,All-Floors,RPG,468,2529,1309234,1873146153,49493117726,51366263879
2022-04-15,All-Floors,Staff,199,1053,482456,647618870,26195673778,26843292648
2022-04-15,All-Floors,TPG,110,3917,2719835,4319272281,127131111197,131450383478
2022-04-15,All-Floors,Total,1474,21351,14361963,31369698678,759662743475,791032442153
2022-04-15,All-Floors,UG,639,12786,8567054,22239890592,507457477916,529697368508
2022-04-15,G,Alumni,11,199,163591,710437282,16216136198,16926573480
2022-04-15,G,Non-HKUST,13,92,19465,16928139,199211047,216139186
2022-04-15,G,Others(HKUST),3,4,115891,12534808,2393870861,2406405669
2022-04-15,G,RPG,54,516,145716,181487527,7273268254,7454755781
2022-04-15,G,Staff,60,376,87269,32452453,893791123,926243576
2022-04-15,G,TPG,70,857,435203,642261563,39357462625,39999724188
2022-04-15,G,Total,479,4612,1770752,3818955004,102609822509,106428777513
2022-04-15,G,UG,268,2568,803617,2222853232,36276082401,38498935633
2022-04-15,LG1,Alumni,7,184,147597,921716189,12608672661,13530388850
2022-04-15,LG1,Non-HKUST,12,151,155247,247368630,5579508762,5826877392
2022-04-15,LG1,Others(HKUST),1,6,173349,11747317,29144561,40891878
2022-04-15,LG1,RPG,32,792,686868,907353869,23904149727,24811503596
2022-04-15,LG1,Staff,14,183,122300,319700014,14563572245,14883272259
2022-04-15,LG1,TPG,58,1310,1183419,2621941562,47568320313,50190261875
2022-04-15,LG1,Total,360,9123,8262298,19510854651,396670342288,416181196939
2022-04-15,LG1,UG,236,6497,5793518,14481027070,292416974019,306898001089
2022-04-15,LG3,Alumni,9,25,32914,39739055,1015241680,1054980735
2022-04-15,LG3,Non-HKUST,23,99,58817,50578263,2637447288,2688025551
2022-04-15,LG3,Others(HKUST),6,34,4268,7120161,598710636,605830797
2022-04-15,LG3,RPG,406,946,277794,377042487,10032550903,10409593390
2022-04-15,LG3,Staff,155,297,54751,154873254,4694888089,4849761343
2022-04-15,LG3,TPG,94,712,476555,557812440,19285670567,19843483007
2022-04-15,LG3,Total,1239,3931,1656663,2312308106,144561630482,146873938588
2022-04-15,LG3,UG,546,1818,751564,1125142446,106297121319,107422263765
2022-04-15,LG4,Alumni,7,51,62567,26964841,1834393253,1861358094
2022-04-15,LG4,Non-HKUST,10,89,76825,179149835,4034862014,4214011849
2022-04-15,LG4,Others(HKUST),7,42,186350,14731013,926994755,941725768
2022-04-15,LG4,RPG,88,176,99796,100179785,3218899895,3319079680
2022-04-15,LG4,Staff,27,110,12152,7905835,147452008,155357843
2022-04-15,LG4,TPG,37,738,335979,224860358,11500923552,11725783910
2022-04-15,LG4,Total,343,2680,1515336,2205265571,69247454977,71452720548
2022-04-15,LG4,UG,167,1474,741667,1651473904,47583929500,49235403404
2022-04-16,1,Alumni,7,8,14300,3711814,115887638,119599452
2022-04-16,1,Non-HKUST,2,5,490,97260,307083,404343
2022-04-16,1,Others(HKUST),1,1,5,0,0,0
2022-04-16,1,RPG,45,164,127863,437632867,3459115377,3896748244
2022-04-16,1,Staff,21,45,121016,91117148,3201736828,3292853976
2022-04-16,1,TPG,19,133,135059,242766128,8898135194,9140901322
2022-04-16,1,Total,155,631,789596,1584214621,36013483617,37597698238
2022-04-16,1,UG,60,275,390863,808889404,20338301497,21147190901
2022-04-16,All-Floors,Alumni,24,440,366087,1119862468,48811046391,49930908859
2022-04-16,All-Floors,Non-HKUST,30,193,131533,294207265,9394807260,9689014525
2022-04-16,All-Floors,Others(HKUST),13,44,306898,29938419,2030052837,2059991256
2022-04-16,All-Floors,RPG,481,2383,1356269,3317132629,68428089503,71745222132
2022-04-16,All-Floors,Staff,242,954,321950,427391970,15671986682,16099378652
2022-04-16,All-Floors,TPG,106,2427,1816416,2618830034,77109264737,79728094771
2022-04-16,All-Floors,Total,1503,16800,11428268,21100709670,582635617357,603736327027
2022-04-16,All-Floors,UG,607,10359,7129115,13293346885,361190369947,374483716832
2022-04-16,G,Alumni,10,139,72066,378752161,34483932447,34862684608
2022-04-16,G,Non-HKUST,9,52,19709,26086792,477367370,503454162
2022-04-16,G,Others(HKUST),3,5,137224,8014497,1943919005,1951933502
2022-04-16,G,RPG,62,349,168635,180814553,5115646893,5296461446
2022-04-16,G,Staff,52,244,52096,22702424,233054430,255756854
2022-04-16,G,TPG,52,651,177930,236176524,11756452537,11992629061
2022-04-16,G,Total,408,3331,1207278,1658787949,72262621761,73921409710
2022-04-16,G,UG,220,1891,579618,806240998,18252249079,19058490077
2022-04-16,LG1,Alumni,8,174,185369,669509880,11578761655,12248271535
2022-04-16,LG1,Non-HKUST,5,57,74807,120876950,4206036872,4326913822
2022-04-16,LG1,Others(HKUST),1,5,110022,21278348,76796982,98075330
2022-04-16,LG1,RPG,32,587,581351,1388191495,31538535127,32926726622
2022-04-16,LG1,Staff,13,117,78730,184875054,10519467213,10704342267
2022-04-16,LG1,TPG,46,976,968968,1620843117,38976548380,40597391497
2022-04-16,LG1,Total,283,6755,6837023,13550245010,352482935829,366033180839
2022-04-16,LG1,UG,178,4839,4837776,9544670166,255586789600,265131459766
2022-04-16,LG3,Alumni,20,48,27002,18302327,765141446,783443773
2022-04-16,LG3,Non-HKUST,22,68,33297,141415481,2963755821,3105171302
2022-04-16,LG3,Others(HKUST),9,23,3298,465770,8853822,9319592
2022-04-16,LG3,RPG,447,1098,380397,1203396025,23860688987,25064085012
2022-04-16,LG3,Staff,203,448,53827,114740332,1638342180,1753082512
2022-04-16,LG3,TPG,91,405,271601,357354879,7637806223,7995161102
2022-04-16,LG3,Total,1323,3940,1444211,3225977905,71149255712,74375233617
2022-04-16,LG3,UG,531,1850,674789,1390303091,34274667233,35664970324
2022-04-16,LG4,Alumni,5,71,67350,49586286,1867323205,1916909491
2022-04-16,LG4,Non-HKUST,7,11,3230,5730782,1747340114,1753070896
2022-04-16,LG4,Others(HKUST),3,10,56349,179804,483028,662832
2022-04-16,LG4,RPG,79,185,98023,107097689,4454103119,4561200808
2022-04-16,LG4,Staff,36,100,16281,13957012,79386031,93343043
2022-04-16,LG4,TPG,19,262,262858,161689386,9840322403,10002011789
2022-04-16,LG4,Total,295,2143,1150160,1081484185,50727320438,51808804623
2022-04-16,LG4,UG,146,1504,646069,743243226,32738362538,33481605764
2022-04-17,1,Alumni,2,2,20,63930,142555,206485
2022-04-17,1,Non-HKUST,3,3,35,2248,5846,8094
2022-04-17,1,Others(HKUST),2,2,20,0,0,0
2022-04-17,1,RPG,38,44,863,37567233,901150703,938717936
2022-04-17,1,Staff,16,24,31411,437409,5748701,6186110
2022-04-17,1,TPG,3,3,65,10726,115348,126074
2022-04-17,1,Total,105,122,33369,38137790,907446713,945584503
2022-04-17,1,UG,41,44,955,56244,283560,339804
2022-04-17,All-Floors,Alumni,11,135,33979,59108134,4049154902,4108263036
2022-04-17,All-Floors,Non-HKUST,26,213,227374,358645080,8267206798,8625851878
2022-04-17,All-Floors,Others(HKUST),11,49,214641,3397256,25788726,29185982
2022-04-17,All-Floors,RPG,429,1612,800762,2513705163,33192066116,35705771279
2022-04-17,All-Floors,Staff,204,746,345082,388457315,26841732375,27230189690
2022-04-17,All-Floors,TPG,93,1905,2125753,3108023972,105505043232,108613067204
2022-04-17,All-Floors,Total,1339,11941,9935292,17768985178,492764898475,510533883653
2022-04-17,All-Floors,UG,565,7281,6187701,11337648258,314883906326,326221554584
2022-04-17,G,Alumni,0,0,0,0,0,0
2022-04-17,G,Non-HKUST,0,0,0,0,0,0
2022-04-17,G,Others(HKUST),2,2,63905,1292613,16526029,17818642
2022-04-17,G,RPG,26,32,2607,277730,3773392,4051122
2022-04-17,G,Staff,34,86,40312,695410,2934713,3630123
2022-04-17,G,TPG,6,18,8801,5999435,31697032,37696467
2022-04-17,G,Total,131,228,167710,94469662,11368715965,11463185627
2022-04-17,G,UG,63,90,52085,86204474,11313784799,11399989273
2022-04-17,LG1,Alumni,0,0,0,0,0,0
2022-04-17,LG1,Non-HKUST,10,132,214363,351842637,8187505104,8539347741
2022-04-17,LG1,Others(HKUST),1,8,110089,975251,1695788,2671039
2022-04-17,LG1,RPG,26,643,718928,1336427858,27860958450,29197386308
2022-04-17,LG1,Staff,11,184,236751,304737210,25693619235,25998356445
2022-04-17,LG1,TPG,57,1638,2102242,3095762245,105327092661,108422854906
2022-04-17,LG1,Total,276,8157,9279738,15791270400,459320440457,475111710857
2022-04-17,LG1,UG,171,5552,5897365,10701525199,292249569219,302951094418
2022-04-17,LG3,Alumni,11,38,16748,49131496,3770947710,3820079206
2022-04-17,LG3,Non-HKUST,23,74,12881,6796798,79234508,86031306
2022-04-17,LG3,Others(HKUST),6,26,2975,884014,2924823,3808837
2022-04-17,LG3,RPG,385,780,74570,304741497,3406917004,3711658501
2022-04-17,LG3,Staff,169,384,33890,35273117,991918407,1027191524
2022-04-17,LG3,TPG,84,221,13430,6085533,141835601,147921134
2022-04-17,LG3,Total,1176,2903,374016,941374954,19262606413,20203981367
2022-04-17,LG3,UG,498,1380,219522,538462499,10868828360,11407290859
2022-04-17,LG4,Alumni,6,95,17211,9912708,278064637,287977345
2022-04-17,LG4,Non-HKUST,4,4,95,3397,461340,464737
2022-04-17,LG4,Others(HKUST),3,11,37652,245378,4642086,4887464
2022-04-17,LG4,RPG,92,113,3794,834690845,1019266567,1853957412
2022-04-17,LG4,Staff,40,68,2718,47314169,147511319,194825488
2022-04-17,LG4,TPG,13,25,1215,166033,4302590,4468623
2022-04-17,LG4,Total,306,531,80459,903732372,1905688927,2809421299
2022-04-17,LG4,UG,148,215,17774,11399842,451440388,462840230
2022-04-18,1,Alumni,2,2,10,0,0,0
2022-04-18,1,Non-HKUST,4,27,74585,110882335,3046286094,3157168429
2022-04-18,1,Others(HKUST),3,4,81,2131,5210,7341
2022-04-18,1,RPG,47,108,132696,302408985,8626110114,8928519099
2022-04-18,1,Staff,17,21,40332,29940008,670260495,700200503
2022-04-18,1,TPG,18,92,115649,109059235,3766066299,3875125534
2022-04-18,1,Total,182,748,999776,1540151741,42467879614,44008031355
2022-04-18,1,UG,91,494,636423,987859047,26359151402,27347010449
2022-04-18,All-Floors,Alumni,19,573,447437,1094117031,59815275779,60909392810
2022-04-18,All-Floors,Non-HKUST,52,635,577195,1219523195,22787924246,24007447441
2022-04-18,All-Floors,Others(HKUST),8,41,145160,8042794,96889332,104932126
2022-04-18,All-Floors,RPG,564,2953,1406507,2922272480,49972327190,52894599670
2022-04-18,All-Floors,Staff,233,998,476310,1259696182,25462071280,26721767462
2022-04-18,All-Floors,TPG,115,3727,2970205,4182162481,110765543493,114947705974
2022-04-18,All-Floors,Total,1687,25557,16482009,32727931338,761663845670,794391777008
2022-04-18,All-Floors,UG,696,16630,10459195,22042117175,492763814350,514805931525
2022-04-18,G,Alumni,12,148,94407,427317865,14019862942,14447180807
2022-04-18,G,Non-HKUST,20,120,48856,41942294,1549161276,1591103570
2022-04-18,G,Others(HKUST),3,5,31689,7491762,69167375,76659137
2022-04-18,G,RPG,79,445,220259,615248862,4769506387,5384755249
2022-04-18,G,Staff,49,391,72651,41820179,572146677,613966856
2022-04-18,G,TPG,76,939,661672,1030569260,36986363423,38016932683
2022-04-18,G,Total,530,4461,1887663,3506137593,82776159333,86282296926
2022-04-18,G,UG,291,2413,758129,1341747371,24809951253,26151698624
2022-04-18,LG1,Alumni,10,240,184791,398960585,13982592684,14381553269
2022-04-18,LG1,Non-HKUST,23,192,305244,639682144,10153036968,10792719112
2022-04-18,LG1,Others(HKUST),1,3,56986,0,0,0
2022-04-18,LG1,RPG,46,755,495694,928907032,21336144620,22265051652
2022-04-18,LG1,Staff,13,139,202787,228578781,16632157015,16860735796
2022-04-18,LG1,TPG,66,1682,1454330,2323033198,35193054214,37516087412
2022-04-18,LG1,Total,417,12731,9872324,19773493192,455433931541,475207424733
2022-04-18,LG1,UG,258,9720,7172492,15254331452,358136946040,373391277492
2022-04-18,LG3,Alumni,14,85,89544,209786737,26400454331,26610241068
2022-04-18,LG3,Non-HKUST,39,172,110424,292151596,7264165345,7556316941
2022-04-18,LG3,Others(HKUST),5,18,2880,484245,27565988,28050233
2022-04-18,LG3,RPG,537,1410,413015,845658754,10853258300,11698917054
2022-04-18,LG3,Staff,195,375,126797,927153248,6911430479,7838583727
2022-04-18,LG3,TPG,100,725,492512,519708076,27122431095,27642139171
2022-04-18,LG3,Total,1493,5127,2186721,4405308036,122935570341,127340878377
2022-04-18,LG3,UG,603,2342,951549,1610365380,44356264803,45966630183
2022-04-18,LG4,Alumni,6,98,78685,58051844,5412365822,5470417666
2022-04-18,LG4,Non-HKUST,6,124,38086,134864826,775274563,910139389
2022-04-18,LG4,Others(HKUST),3,11,53524,64656,150759,215415
2022-04-18,LG4,RPG,110,235,144843,230048847,4387307769,4617356616
2022-04-18,LG4,Staff,34,72,33743,32203966,676076614,708280580
2022-04-18,LG4,TPG,37,289,246042,199792712,7697628462,7897421174
2022-04-18,LG4,Total,382,2490,1535525,3502840776,58050304841,61553145617
2022-04-18,LG4,UG,186,1661,940602,2847813925,39101500852,41949314777
2022-04-19,1,Alumni,0,0,0,0,0,0
2022-04-19,1,Non-HKUST,10,28,71046,63612178,2044647403,2108259581
2022-04-19,1,Others(HKUST),3,3,35,0,0,0
2022-04-19,1,RPG,38,51,56281,22836986,491530568,514367554
2022-04-19,1,Staff,93,1197,806888,127960009,3966329270,4094289279
2022-04-19,1,TPG,15,70,200693,439375110,2489019234,2928394344
2022-04-19,1,Total,231,1778,1953259,1672455819,26710361480,28382817299
2022-04-19,1,UG,72,429,818316,1018671536,17718835005,18737506541
2022-04-19,All-Floors,Alumni,10,107,144129,54263852,5444384956,5498648808
2022-04-19,All-Floors,Non-HKUST,41,338,327646,588200703,7260922494,7849123197
2022-04-19,All-Floors,Others(HKUST),26,107,63705,17278460,1629467122,1646745582
2022-04-19,All-Floors,RPG,376,1579,1122952,918973244,58895915263,59814888507
2022-04-19,All-Floors,Staff,556,4030,1640459,585346117,15474520427,16059866544
2022-04-19,All-Floors,TPG,89,1552,1581161,1241882869,21180853595,22422736464
2022-04-19,All-Floors,Total,1621,15456,13237560,9884442251,243623832237,253508274488
2022-04-19,All-Floors,UG,523,7743,8357508,6478497006,133737768380,140216265386
2022-04-19,G,Alumni,4,28,30026,1219699,12649658,13869357
2022-04-19,G,Non-HKUST,19,144,62906,62972867,2502146659,2565119526
2022-04-19,G,Others(HKUST),3,6,31922,392230,237950194,238342424
2022-04-19,G,RPG,59,393,310031,257967044,32662509435,32920476479
2022-04-19,G,Staff,106,928,411232,87569783,3191492982,3279062765
2022-04-19,G,TPG,58,495,255612,102852817,1343886144,1446738961
2022-04-19,G,Total,528,4139,2045344,1174542140,58696009726,59870551866
2022-04-19,G,UG,279,2145,943615,661567700,18745374654,19406942354
2022-04-19,LG1,Alumni,1,1,10,4681,9989,14670
2022-04-19,LG1,Non-HKUST,11,84,161803,418439389,2524598037,2943037426
2022-04-19,LG1,Others(HKUST),0,0,0,0,0,0
2022-04-19,LG1,RPG,32,378,441305,383248886,10846937225,11230186111
2022-04-19,LG1,Staff,29,306,226370,66220356,4878534802,4944755158
2022-04-19,LG1,TPG,39,422,568277,509284786,10775404304,11284689090
2022-04-19,LG1,Total,333,4181,5920886,5211785607,100736973152,105948758759
2022-04-19,LG1,UG,221,2990,4523121,3834587509,71711488795,75546076304
2022-04-19,LG3,Alumni,7,16,24997,4056256,114913752,118970008
2022-04-19,LG3,Non-HKUST,24,72,19773,43176269,189530395,232706664
2022-04-19,LG3,Others(HKUST),19,68,5349,2163499,57524778,59688277
2022-04-19,LG3,RPG,319,582,215406,216355732,14114538815,14330894547
2022-04-19,LG3,Staff,450,1086,151931,286595699,2839181215,3125776914
2022-04-19,LG3,TPG,63,375,386740,141948072,5281267414,5423215486
2022-04-19,LG3,Total,1238,3817,1951809,1425942301,41588874437,43014816738
2022-04-19,LG3,UG,356,1618,1147613,731646774,18991918068,19723564842
2022-04-19,LG4,Alumni,5,62,89096,48983216,5316811557,5365794773
2022-04-19,LG4,Non-HKUST,6,10,12118,0,0,0
2022-04-19,LG4,Others(HKUST),5,30,26399,14722731,1333992150,1348714881
2022-04-19,LG4,RPG,60,175,99929,38564596,780399220,818963816
2022-04-19,LG4,Staff,111,513,44038,17000270,598982158,615982428
2022-04-19,LG4,TPG,16,190,169839,48422084,1291276499,1339698583
2022-04-19,LG4,Total,333,1541,1366262,399716384,15891613442,16291329826
2022-04-19,LG4,UG,130,561,924843,232023487,6570151858,6802175345
2022-04-20,1,Alumni,0,0,0,0,0,0
2022-04-20,1,Non-HKUST,2,2,11199,0,0,0
2022-04-20,1,Others(HKUST),0,0,0,0,0,0
2022-04-20,1,RPG,1,3,16791,0,0,0
2022-04-20,1,Staff,18,22,123203,0,0,0
2022-04-20,1,TPG,2,5,28000,0,0,0
2022-04-20,1,Total,37,59,330371,0,0,0
2022-04-20,1,UG,14,27,151178,0,0,0
2022-04-20,All-Floors,Alumni,5,6,33583,0,0,0
2022-04-20,All-Floors,Non-HKUST,12,15,83995,0,0,0
2022-04-20,All-Floors,Others(HKUST),5,11,61561,0,0,0
2022-04-20,All-Floors,RPG,24,36,201583,0,0,0
2022-04-20,All-Floors,Staff,39,48,268768,0,0,0
2022-04-20,All-Floors,TPG,31,60,335972,0,0,0
2022-04-20,All-Floors,Total,262,487,2726742,0,0,0
2022-04-20,All-Floors,UG,146,311,1741280,0,0,0
2022-04-20,G,Alumni,1,1,5596,0,0,0
2022-04-20,G,Non-HKUST,1,1,5597,0,0,0
2022-04-20,G,Others(HKUST),3,3,16790,0,0,0
2022-04-20,G,RPG,6,11,61603,0,0,0
2022-04-20,G,Staff,10,11,61574,0,0,0
2022-04-20,G,TPG,5,9,50397,0,0,0
2022-04-20,G,Total,46,75,419945,0,0,0
2022-04-20,G,UG,20,39,218388,0,0,0
2022-04-20,LG1,Alumni,0,0,0,0,0,0
2022-04-20,LG1,Non-HKUST,7,9,50408,0,0,0
2022-04-20,LG1,Others(HKUST),1,4,22384,0,0,0
2022-04-20,LG1,RPG,1,2,11201,0,0,0
2022-04-20,LG1,Staff,4,5,27995,0,0,0
2022-04-20,LG1,TPG,8,13,72783,0,0,0
2022-04-20,LG1,Total,104,219,1226144,0,0,0
2022-04-20,LG1,UG,83,186,1041373,0,0,0
2022-04-20,LG3,Alumni,1,1,5603,0,0,0
2022-04-20,LG3,Non-HKUST,1,2,11194,0,0,0
2022-04-20,LG3,Others(HKUST),0,0,0,0,0,0
2022-04-20,LG3,RPG,14,17,95192,0,0,0
2022-04-20,LG3,Staff,7,9,50397,0,0,0
2022-04-20,LG3,TPG,11,21,117588,0,0,0
2022-04-20,LG3,Total,50,78,436732,0,0,0
2022-04-20,LG3,UG,16,28,156758,0,0,0
2022-04-20,LG4,Alumni,3,4,22384,0,0,0
2022-04-20,LG4,Non-HKUST,1,1,5597,0,0,0
2022-04-20,LG4,Others(HKUST),3,4,22387,0,0,0
2022-04-20,LG4,RPG,2,3,16796,0,0,0
2022-04-20,LG4,Staff,1,1,5599,0,0,0
2022-04-20,LG4,TPG,6,12,67204,0,0,0
2022-04-20,LG4,Total,31,56,313550,0,0,0
2022-04-20,LG4,UG,15,31,173583,0,0,0
2022-04-21,1,Alumni,0,0,0,0,0,0
2022-04-21,1,Non-HKUST,1,1,6537,0,0,0
2022-04-21,1,Others(HKUST),0,0,0,0,0,0
2022-04-21,1,RPG,4,8,52297,0,0,0
2022-04-21,1,Staff,21,29,195232,0,0,0
2022-04-21,1,TPG,6,12,78431,0,0,0
2022-04-21,1,Total,49,73,476303,0,0,0
2022-04-21,1,UG,17,23,143806,0,0,0
2022-04-21,All-Floors,Alumni,4,5,26930,0,0,0
2022-04-21,All-Floors,Non-HKUST,6,9,62601,0,0,0
2022-04-21,All-Floors,Others(HKUST),6,20,147591,0,0,0
2022-04-21,All-Floors,RPG,28,59,390766,0,0,0
2022-04-21,All-Floors,Staff,44,72,496329,0,0,0
2022-04-21,All-Floors,TPG,45,96,663963,0,0,0
2022-04-21,All-Floors,Total,314,708,4796503,0,0,0
2022-04-21,All-Floors,UG,181,447,3008323,0,0,0
2022-04-21,G,Alumni,2,2,13079,0,0,0
2022-04-21,G,Non-HKUST,1,2,13074,0,0,0
2022-04-21,G,Others(HKUST),3,5,36428,0,0,0
2022-04-21,G,RPG,5,12,58833,0,0,0
2022-04-21,G,Staff,10,19,131713,0,0,0
2022-04-21,G,TPG,6,13,84981,0,0,0
2022-04-21,G,Total,44,86,540779,0,0,0
2022-04-21,G,UG,17,33,202671,0,0,0
2022-04-21,LG1,Alumni,1,1,7318,0,0,0
2022-04-21,LG1,Non-HKUST,3,4,29910,0,0,0
2022-04-21,LG1,Others(HKUST),2,9,68197,0,0,0
2022-04-21,LG1,RPG,12,26,194658,0,0,0
2022-04-21,LG1,Staff,6,12,90943,0,0,0
2022-04-21,LG1,TPG,22,45,341803,0,0,0
2022-04-21,LG1,Total,168,412,2921429,0,0,0
2022-04-21,LG1,UG,122,315,2188600,0,0,0
2022-04-21,LG3,Alumni,0,0,0,0,0,0
2022-04-21,LG3,Non-HKUST,2,2,13080,0,0,0
2022-04-21,LG3,Others(HKUST),0,0,0,0,0,0
2022-04-21,LG3,RPG,6,10,65366,0,0,0
2022-04-21,LG3,Staff,8,11,71908,0,0,0
2022-04-21,LG3,TPG,13,23,152210,0,0,0
2022-04-21,LG3,Total,52,84,541385,0,0,0
2022-04-21,LG3,UG,23,38,238821,0,0,0
2022-04-21,LG4,Alumni,1,2,6533,0,0,0
2022-04-21,LG4,Non-HKUST,0,0,0,0,0,0
2022-04-21,LG4,Others(HKUST),3,6,42966,0,0,0
2022-04-21,LG4,RPG,2,3,19612,0,0,0
2022-04-21,LG4,Staff,1,1,6533,0,0,0
2022-04-21,LG4,TPG,2,3,6538,0,0,0
2022-04-21,LG4,Total,27,53,316607,0,0,0
2022-04-21,LG4,UG,18,38,234425,0,0,0
2022-04-22,1,Alumni,0,0,0,0,0,0
2022-04-22,1,Non-HKUST,0,0,0,0,0,0
2022-04-22,1,Others(HKUST),0,0,0,0,0,0
2022-04-22,1,RPG,1,1,5238,0,0,0
2022-04-22,1,Staff,1,1,8417,0,0,0
2022-04-22,1,TPG,0,0,0,0,0,0
2022-04-22,1,Total,3,3,22074,0,0,0
2022-04-22,1,UG,1,1,8419,0,0,0
2022-04-22,All-Floors,Alumni,0,0,0,0,0,0
2022-04-22,All-Floors,Non-HKUST,4,5,42088,0,0,0
2022-04-22,All-Floors,Others(HKUST),2,7,58905,0,0,0
2022-04-22,All-Floors,RPG,11,16,124799,0,0,0
2022-04-22,All-Floors,Staff,5,10,75082,0,0,0
2022-04-22,All-Floors,TPG,13,25,177311,0,0,0
2022-04-22,All-Floors,Total,110,229,1761435,0,0,0
2022-04-22,All-Floors,UG,75,166,1283250,0,0,0
2022-04-22,G,Alumni,0,0,0,0,0,0
2022-04-22,G,Non-HKUST,0,0,0,0,0,0
2022-04-22,G,Others(HKUST),1,1,8415,0,0,0
2022-04-22,G,RPG,0,0,0,0,0,0
2022-04-22,G,Staff,2,2,16834,0,0,0
2022-04-22,G,TPG,0,0,0,0,0,0
2022-04-22,G,Total,3,3,25249,0,0,0
2022-04-22,G,UG,0,0,0,0,0,0
2022-04-22,LG1,Alumni,0,0,0,0,0,0
2022-04-22,LG1,Non-HKUST,4,5,42088,0,0,0
2022-04-22,LG1,Others(HKUST),1,4,33660,0,0,0
2022-04-22,LG1,RPG,9,13,102725,0,0,0
2022-04-22,LG1,Staff,2,7,49831,0,0,0
2022-04-22,LG1,TPG,11,23,160476,0,0,0
2022-04-22,LG1,Total,97,211,1616958,0,0,0
2022-04-22,LG1,UG,70,159,1228178,0,0,0
2022-04-22,LG3,Alumni,0,0,0,0,0,0
2022-04-22,LG3,Non-HKUST,0,0,0,0,0,0
2022-04-22,LG3,Others(HKUST),0,0,0,0,0,0
2022-04-22,LG3,RPG,1,2,16836,0,0,0
2022-04-22,LG3,Staff,0,0,0,0,0,0
2022-04-22,LG3,TPG,2,2,16835,0,0,0
2022-04-22,LG3,Total,6,9,71913,0,0,0
2022-04-22,LG3,UG,3,5,38242,0,0,0
2022-04-22,LG4,Alumni,0,0,0,0,0,0
2022-04-22,LG4,Non-HKUST,0,0,0,0,0,0
2022-04-22,LG4,Others(HKUST),2,2,16830,0,0,0
2022-04-22,LG4,RPG,0,0,0,0,0,0
2022-04-22,LG4,Staff,0,0,0,0,0,0
2022-04-22,LG4,TPG,0,0,0,0,0,0
2022-04-22,LG4,Total,3,3,25241,0,0,0
2022-04-22,LG4,UG,1,1,8411,0,0,0
2022-04-23,1,Alumni,3,16,8260,6967326,67888471,74855797
2022-04-23,1,Non-HKUST,4,4,13850,457233,32507073,32964306
2022-04-23,1,Others(HKUST),2,2,30,5451,22921,28372
2022-04-23,1,RPG,77,123,127535,205540787,13471706219,13677247006
2022-04-23,1,Staff,29,57,54837,15859407,77547226,93406633
2022-04-23,1,TPG,24,102,134632,319745155,11007291833,11327036988
2022-04-23,1,Total,273,921,1391863,2470102834,66481333898,68951436732
2022-04-23,1,UG,134,617,1052719,1921527475,41824370155,43745897630
2022-04-23,All-Floors,Alumni,22,219,142338,170807515,4394400662,4565208177
2022-04-23,All-Floors,Non-HKUST,30,191,267145,422969303,11669967023,12092936326
2022-04-23,All-Floors,Others(HKUST),16,126,214667,15168813,3455826304,3470995117
2022-04-23,All-Floors,RPG,515,2827,1550165,2022469422,55156894263,57179363685
2022-04-23,All-Floors,Staff,248,1231,443993,290045037,12142355945,12432400982
2022-04-23,All-Floors,TPG,131,2831,2294171,4923234709,94232330670,99155565379
2022-04-23,All-Floors,Total,1684,18014,13682065,29538626597,581701899610,611240526207
2022-04-23,All-Floors,UG,722,10589,8769586,21693931798,400650124743,422344056541
2022-04-23,G,Alumni,6,93,56918,119126880,3361636362,3480763242
2022-04-23,G,Non-HKUST,7,38,25272,2967864,44188312,47156176
2022-04-23,G,Others(HKUST),4,5,47761,6019681,2477040872,2483060553
2022-04-23,G,RPG,71,428,186794,274797568,5580532195,5855329763
2022-04-23,G,Staff,61,314,170522,55059976,1839867073,1894927049
2022-04-23,G,TPG,72,714,293321,317897112,17893557672,18211454784
2022-04-23,G,Total,529,3835,1505726,1756152599,59749014311,61505166910
2022-04-23,G,UG,308,2243,725138,980283518,28552191825,29532475343
2022-04-23,LG1,Alumni,3,35,56161,31756608,460377916,492134524
2022-04-23,LG1,Non-HKUST,10,92,213503,406348291,8923229261,9329577552
2022-04-23,LG1,Others(HKUST),1,6,110449,0,0,0
2022-04-23,LG1,RPG,35,882,825556,965262127,20664861860,21630123987
2022-04-23,LG1,Staff,20,178,92687,91879091,4952686663,5044565754
2022-04-23,LG1,TPG,61,1048,1251625,3555017693,43156716224,46711733917
2022-04-23,LG1,Total,355,6958,8213359,20729840863,311381275755,332111116618
2022-04-23,LG1,UG,225,4717,5663378,15679577053,233223403831,248902980884
2022-04-23,LG3,Alumni,17,48,2338,524940,3349430,3874370
2022-04-23,LG3,Non-HKUST,23,48,12062,9720104,2013346679,2023066783
2022-04-23,LG3,Others(HKUST),11,65,5132,1443641,109066119,110509760
2022-04-23,LG3,RPG,462,1201,250475,388295529,12770823649,13159119178
2022-04-23,LG3,Staff,204,562,69227,53628160,666085226,719713386
2022-04-23,LG3,TPG,109,594,353552,286422487,10393951870,10680374357
2022-04-23,LG3,Total,1451,4992,1665976,2621220635,91887046653,94508267288
2022-04-23,LG3,UG,625,2474,973190,1881185774,65930423680,67811609454
2022-04-23,LG4,Alumni,4,27,18661,12431761,501148483,513580244
2022-04-23,LG4,Non-HKUST,3,9,2458,3475811,656695698,660171509
2022-04-23,LG4,Others(HKUST),8,48,51295,7700040,869696392,877396432
2022-04-23,LG4,RPG,60,193,159805,188573411,2668970340,2857543751
2022-04-23,LG4,Staff,22,120,56720,73618403,4606169757,4679788160
2022-04-23,LG4,TPG,21,373,261041,444152262,11780813071,12224965333
2022-04-23,LG4,Total,229,1308,905141,1961309666,52203228993,54164538659
2022-04-23,LG4,UG,111,538,355161,1231357978,31119735252,32351093230
2022-04-24,1,Alumni,1,35,13838,9695197,1473844917,1483540114
2022-04-24,1,Non-HKUST,1,1,15,1797,595,2392
2022-04-24,1,Others(HKUST),1,2,120,12956,19986,32942
2022-04-24,1,RPG,50,53,7291,64076717,2485475182,2549551899
2022-04-24,1,Staff,20,30,98631,2431194,32990442,35421636
2022-04-24,1,TPG,9,11,175,47666,192997,240663
2022-04-24,1,Total,173,237,126942,76830571,4003783411,4080613982
2022-04-24,1,UG,91,105,6872,565044,11259292,11824336
2022-04-24,All-Floors,Alumni,13,131,48101,59942629,2024980036,2084922665
2022-04-24,All-Floors,Non-HKUST,28,152,180751,196985176,3413381301,3610366477
2022-04-24,All-Floors,Others(HKUST),12,61,437627,41231138,590150024,631381162
2022-04-24,All-Floors,RPG,436,1712,1015673,2346390057,28352607136,30698997193
2022-04-24,All-Floors,Staff,177,542,623181,374554955,18605407473,18979962428
2022-04-24,All-Floors,TPG,108,1785,2058144,7593569909,98404074887,105997644796
2022-04-24,All-Floors,Total,1389,12948,12035587,27507973630,518046567488,545554541118
2022-04-24,All-Floors,UG,615,8565,7672110,16895299766,366655966631,383551266397
2022-04-24,G,Alumni,1,1,10,0,0,0
2022-04-24,G,Non-HKUST,4,4,656,7594,32085,39679
2022-04-24,G,Others(HKUST),5,6,136285,5411961,190675419,196087380
2022-04-24,G,RPG,30,32,4060,372690,2374151,2746841
2022-04-24,G,Staff,34,95,259434,3817292,103633630,107450922
2022-04-24,G,TPG,9,9,105,33366,27401,60767
2022-04-24,G,Total,150,236,407525,11205271,310133981,321339252
2022-04-24,G,UG,67,89,6975,1562368,13391295,14953663
2022-04-24,LG1,Alumni,3,13,5629,87294,275279,362573
2022-04-24,LG1,Non-HKUST,11,102,162489,185327988,3216867509,3402195497
2022-04-24,LG1,Others(HKUST),1,6,194428,24323564,61543540,85867104
2022-04-24,LG1,RPG,38,804,928434,2219191848,24352961255,26572153103
2022-04-24,LG1,Staff,8,145,227567,357426196,18281773633,18639199829
2022-04-24,LG1,TPG,61,1488,2028907,7449350411,95538522739,102987873150
2022-04-24,LG1,Total,351,9119,10810264,26357079159,485754693984,512111773143
2022-04-24,LG1,UG,229,6561,7262810,16121371858,344302750029,360424121887
2022-04-24,LG3,Alumni,12,43,20225,9952237,146270075,156222312
2022-04-24,LG3,Non-HKUST,19,39,17521,11646136,196356770,208002906
2022-04-24,LG3,Others(HKUST),8,35,6963,5015920,298128704,303144624
2022-04-24,LG3,RPG,391,764,73828,61715787,1459165882,1520881669
2022-04-24,LG3,Staff,141,252,36428,10795396,186516549,197311945
2022-04-24,LG3,TPG,88,259,28632,144138466,2865331750,3009470216
2022-04-24,LG3,Total,1189,3014,513380,925320390,21523388488,22448708878
2022-04-24,LG3,UG,530,1622,329783,682056448,16371618758,17053675206
2022-04-24,LG4,Alumni,3,39,8399,40207901,404589765,444797666
2022-04-24,LG4,Non-HKUST,4,6,70,1661,124342,126003
2022-04-24,LG4,Others(HKUST),4,12,99831,6466737,39782375,46249112
2022-04-24,LG4,RPG,52,59,2060,1033015,52630666,53663681
2022-04-24,LG4,Staff,12,20,1121,84877,493219,578096
2022-04-24,LG4,TPG,11,18,325,0,0,0
2022-04-24,LG4,Total,189,342,177476,137538239,6454567624,6592105863
2022-04-24,LG4,UG,103,188,65670,89744048,5956947257,6046691305
2022-04-25,1,Alumni,2,2,5,0,0,0
2022-04-25,1,Non-HKUST,17,226,218812,529860997,6549289203,7079150200
2022-04-25,1,Others(HKUST),6,6,440,26843,29002,55845
2022-04-25,1,RPG,80,138,90100,346508372,4347861469,4694369841
2022-04-25,1,Staff,139,1961,1308685,861194226,7367737800,8228932026
2022-04-25,1,TPG,33,191,256875,596538278,12903706760,13500245038
2022-04-25,1,Total,456,3417,3057536,4435031745,80416460614,84851492359
2022-04-25,1,UG,179,893,1182619,2100903029,49247836380,51348739409
2022-04-25,All-Floors,Alumni,15,280,200874,297511071,11283272490,11580783561
2022-04-25,All-Floors,Non-HKUST,53,1085,846731,1602338825,23338579822,24940918647
2022-04-25,All-Floors,Others(HKUST),42,186,138095,23410133,4622100734,4645510867
2022-04-25,All-Floors,RPG,567,3625,2333587,5713412225,77793521408,83506933633
2022-04-25,All-Floors,Staff,722,6393,2291474,3658051782,39368058754,43026110536
2022-04-25,All-Floors,TPG,147,4471,3942172,9305973076,144875210053,154181183129
2022-04-25,All-Floors,Total,2434,34725,24837304,57632545805,941741014646,999373560451
2022-04-25,All-Floors,UG,888,18685,15084371,37031848693,640460271385,677492120078
2022-04-25,G,Alumni,7,42,5619,549707,5924624,6474331
2022-04-25,G,Non-HKUST,28,336,136617,88047628,1286086833,1374134461
2022-04-25,G,Others(HKUST),8,17,64845,7423144,2571220139,2578643283
2022-04-25,G,RPG,131,757,604553,923244305,16387059221,17310303526
2022-04-25,G,Staff,191,1586,399725,564202960,9790101488,10354304448
2022-04-25,G,TPG,106,1267,756301,1209991962,23523551508,24733543470
2022-04-25,G,Total,958,7692,3227870,6804598314,117821898560,124626496874
2022-04-25,G,UG,487,3687,1260210,4011138608,64257954747,68269093355
2022-04-25,LG1,Alumni,3,43,16186,22264559,1014280204,1036544763
2022-04-25,LG1,Non-HKUST,17,167,264444,713554318,8953965971,9667520289
2022-04-25,LG1,Others(HKUST),3,14,46858,5609518,324381289,329990807
2022-04-25,LG1,RPG,52,1243,1019390,3418053483,26603951530,30022005013
2022-04-25,LG1,Staff,54,493,199296,424152700,5872881534,6297034234
2022-04-25,LG1,TPG,83,1347,1327341,4772423218,50844833881,55617257099
2022-04-25,LG1,Total,558,11907,12339028,33490296128,459825253996,493315550124
2022-04-25,LG1,UG,346,8600,9465513,24134238332,366210959587,390345197919
2022-04-25,LG3,Alumni,13,37,46074,157190027,2069247988,2226438015
2022-04-25,LG3,Non-HKUST,28,74,48244,23440232,1174642245,1198082477
2022-04-25,LG3,Others(HKUST),29,93,8734,8630687,1712104859,1720735546
2022-04-25,LG3,RPG,455,1019,378289,407982008,9082055783,9490037791
2022-04-25,LG3,Staff,549,1475,166996,1554885495,6592146291,8147031786
2022-04-25,LG3,TPG,94,1120,1026072,1764671335,33462057515,35226728850
2022-04-25,LG3,Total,1838,7198,3572905,7706257144,137335727147,145041984291
2022-04-25,LG3,UG,670,3380,1898496,3789457360,83243472466,87032929826
2022-04-25,LG4,Alumni,9,156,132990,117506778,8193819674,8311326452
2022-04-25,LG4,Non-HKUST,21,282,178614,247435650,5374595570,5622031220
2022-04-25,LG4,Others(HKUST),14,56,17218,1719941,14365445,16085386
2022-04-25,LG4,RPG,229,468,241255,617624057,21372593405,21990217462
2022-04-25,LG4,Staff,226,878,216772,253616401,9745191641,9998808042
2022-04-25,LG4,TPG,56,546,575583,962348283,24141060389,25103408672
2022-04-25,LG4,Total,999,4511,2639965,5196362474,146341674329,151538036803
2022-04-25,LG4,UG,444,2125,1277533,2996111364,77500048205,80496159569
2022-04-26,1,Alumni,1,1,10,0,0,0
2022-04-26,1,Non-HKUST,17,216,194919,248622310,5958149510,6206771820
2022-04-26,1,Others(HKUST),3,3,95,11701,18504,30205
2022-04-26,1,RPG,64,143,140546,139091071,6452682808,6591773879
2022-04-26,1,Staff,133,2011,1348985,290328618,8408226965,8698555583
2022-04-26,1,TPG,21,133,292133,573229018,10784822026,11358051044
2022-04-26,1,Total,343,3411,3154124,3502255208,76524218437,80026473645
2022-04-26,1,UG,104,904,1177436,2250972490,44920318624,47171291114
2022-04-26,All-Floors,Alumni,24,401,311453,554355580,9000942621,9555298201
2022-04-26,All-Floors,Non-HKUST,57,933,613345,1094151806,29106562437,30200714243
2022-04-26,All-Floors,Others(HKUST),23,150,529350,184239595,7958965808,8143205403
2022-04-26,All-Floors,RPG,520,3665,2190688,3938152314,72528212995,76466365309
2022-04-26,All-Floors,Staff,698,7826,2934559,1859535657,41523649024,43383184681
2022-04-26,All-Floors,TPG,128,3923,3362071,7459688654,139451440539,146911129193
2022-04-26,All-Floors,Total,2280,38366,24753687,49837652261,1030399375521,1080237027782
2022-04-26,All-Floors,UG,830,21468,14812221,34747528655,730829602097,765577130752
2022-04-26,G,Alumni,12,115,115285,345661314,2304645550,2650306864
2022-04-26,G,Non-HKUST,31,216,64578,78990199,1634527676,1713517875
2022-04-26,G,Others(HKUST),7,12,131807,15341785,3189660541,3205002326
2022-04-26,G,RPG,121,748,535267,894371828,18360955425,19255327253
2022-04-26,G,Staff,199,1833,928686,874230208,12574757101,13448987309
2022-04-26,G,TPG,93,1110,713378,2050129140,39295188551,41345317691
2022-04-26,G,Total,906,8224,3706426,6793375412,130925741235,137719116647
2022-04-26,G,UG,443,4190,1217425,2534650938,53566006391,56100657329
2022-04-26,LG1,Alumni,6,97,34552,8352706,424168261,432520967
2022-04-26,LG1,Non-HKUST,17,137,147232,446181440,6705573660,7151755100
2022-04-26,LG1,Others(HKUST),2,26,218079,28196378,82260528,110456906
2022-04-26,LG1,RPG,55,1135,852787,1949772483,29325456471,31275228954
2022-04-26,LG1,Staff,74,669,224280,279542728,4605185820,4884728548
2022-04-26,LG1,TPG,68,1226,1334853,3361671892,45958624435,49320296327
2022-04-26,LG1,Total,562,12846,11339766,28095210826,469862472222,497957683048
2022-04-26,LG1,UG,340,9556,8527983,22021493199,382761203047,404782696246
2022-04-26,LG3,Alumni,14,92,88451,69665457,3407624798,3477290255
2022-04-26,LG3,Non-HKUST,30,163,108757,90738900,3035387443,3126126343
2022-04-26,LG3,Others(HKUST),13,63,2745,443303,120486435,120929738
2022-04-26,LG3,RPG,389,914,396854,644519795,11685763485,12330283280
2022-04-26,LG3,Staff,482,1920,202863,212167372,9981109793,10193277165
2022-04-26,LG3,TPG,84,874,636585,970905749,32116656066,33087561815
2022-04-26,LG3,Total,1607,7107,3505876,6342966073,198728186060,205071152133
2022-04-26,LG3,UG,595,3081,2069621,4354525497,138381158040,142735683537
2022-04-26,LG4,Alumni,10,96,73155,130676103,2864504012,2995180115
2022-04-26,LG4,Non-HKUST,24,201,97859,229618957,11772924148,12002543105
2022-04-26,LG4,Others(HKUST),12,46,176624,140246428,4566539800,4706786228
2022-04-26,LG4,RPG,282,725,265234,310397137,6703354806,7013751943
2022-04-26,LG4,Staff,354,1393,229745,203266731,5954369345,6157636076
2022-04-26,LG4,TPG,64,580,385122,503752855,11296149461,11799902316
2022-04-26,LG4,Total,1253,6778,3047495,5103844742,154358757567,159462602309
2022-04-26,LG4,UG,507,3737,1819756,3585886531,111200915995,114786802526
2022-04-27,1,Alumni,3,34,16673,10810380,513637840,524448220
2022-04-27,1,Non-HKUST,11,67,99987,404347606,4386810848,4791158454
2022-04-27,1,Others(HKUST),3,3,35,2304933,10529219,12834152
2022-04-27,1,RPG,82,154,99142,99237487,2029363716,2128601203
2022-04-27,1,Staff,136,1799,1352314,363755673,10136862492,10500618165
2022-04-27,1,TPG,31,202,450028,692217956,10788740726,11480958682
2022-04-27,1,Total,456,3353,3080584,4097728147,107201039217,111298767364
2022-04-27,1,UG,190,1094,1062405,2525054112,79335094376,81860148488
2022-04-27,All-Floors,Alumni,25,674,341390,582118670,10947809088,11529927758
2022-04-27,All-Floors,Non-HKUST,43,493,433551,1294187306,14532260160,15826447466
2022-04-27,All-Floors,Others(HKUST),32,222,416282,83863715,4732785544,4816649259
2022-04-27,All-Floors,RPG,545,3696,1763352,3099741968,58879550521,61979292489
2022-04-27,All-Floors,Staff,663,6252,2687989,2707797014,40053665594,42761462608
2022-04-27,All-Floors,TPG,140,5794,4160040,9602180062,183542274385,193144454447
2022-04-27,All-Floors,Total,2386,39783,25592658,57735437345,1268558653144,1326294090489
2022-04-27,All-Floors,UG,938,22652,15790054,40365548610,955870307852,996235856462
2022-04-27,G,Alumni,14,129,37458,32043366,554594912,586638278
2022-04-27,G,Non-HKUST,23,142,59998,201886342,1352250047,1554136389
2022-04-27,G,Others(HKUST),7,24,143721,56734765,4122945790,4179680555
2022-04-27,G,RPG,113,686,499148,804200859,13252711751,14056912610
2022-04-27,G,Staff,173,1534,619352,314496611,7804839886,8119336497
2022-04-27,G,TPG,97,1597,699044,1002642637,31220517017,32223159654
2022-04-27,G,Total,940,9316,3749102,6679690798,152253975771,158933666569
2022-04-27,G,UG,513,5204,1690381,4267686218,93946116368,98213802586
2022-04-27,LG1,Alumni,5,128,49132,67440641,1337089991,1404530632
2022-04-27,LG1,Non-HKUST,14,83,188375,581367222,6268534762,6849901984
2022-04-27,LG1,Others(HKUST),2,30,161240,16655515,46476699,63132214
2022-04-27,LG1,RPG,60,942,709554,1484434499,25216172250,26700606749
2022-04-27,LG1,Staff,63,506,276888,339067188,4507576569,4846643757
2022-04-27,LG1,TPG,82,1920,1937257,5643603192,103988619142,109632222334
2022-04-27,LG1,Total,633,12795,12574814,33713456606,637759570323,671473026929
2022-04-27,LG1,UG,407,9186,9252368,25580888349,496395100910,521975989259
2022-04-27,LG3,Alumni,15,46,42037,58558378,2440368786,2498927164
2022-04-27,LG3,Non-HKUST,24,48,23395,18976677,709790439,728767116
2022-04-27,LG3,Others(HKUST),24,93,12028,4179708,531619321,535799029
2022-04-27,LG3,RPG,406,1234,280012,519319597,14186869434,14706189031
2022-04-27,LG3,Staff,466,1323,210520,1307425219,12122978657,13430403876
2022-04-27,LG3,TPG,77,928,702789,1972990611,27078159499,29051150110
2022-04-27,LG3,Total,1661,7116,3420148,7962228341,204660369921,212622598262
2022-04-27,LG3,UG,649,3444,2149367,4080778151,147590583785,151671361936
2022-04-27,LG4,Alumni,13,337,196090,413265905,6102117559,6515383464
2022-04-27,LG4,Non-HKUST,22,153,61796,87609459,1814874064,1902483523
2022-04-27,LG4,Others(HKUST),16,72,99258,3988794,21214515,25203309
2022-04-27,LG4,RPG,308,680,175496,192549526,4194433370,4386982896
2022-04-27,LG4,Staff,335,1090,228915,383052323,5481407990,5864460313
2022-04-27,LG4,TPG,56,1147,370922,290725666,10466238001,10756963667
2022-04-27,LG4,Total,1285,7203,2768010,5282333453,166683697912,171966031365
2022-04-27,LG4,UG,535,3724,1635533,3911141780,138603412413,142514554193
2022-04-28,1,Alumni,2,26,13069,20353070,351410535,371763605
2022-04-28,1,Non-HKUST,12,176,187132,1067136763,6995997275,8063134038
2022-04-28,1,Others(HKUST),2,2,175,6280,28340,34620
2022-04-28,1,RPG,113,217,174282,101413493,3853475137,3954888630
2022-04-28,1,Staff,137,1938,1180393,272537033,9256449142,9528986175
2022-04-28,1,TPG,22,128,257246,475290832,7331886101,7807176933
2022-04-28,1,Total,504,3350,3035209,4757100797,114671411341,119428512138
2022-04-28,1,UG,216,863,1222912,2820363326,86882164811,89702528137
2022-04-28,All-Floors,Alumni,28,316,244329,588750164,10455401822,11044151986
2022-04-28,All-Floors,Non-HKUST,45,930,684100,1982972779,27262591818,29245564597
2022-04-28,All-Floors,Others(HKUST),26,164,401694,89775358,9667243576,9757018934
2022-04-28,All-Floors,RPG,495,3050,1899174,2455476045,62715783380,65171259425
2022-04-28,All-Floors,Staff,625,6628,2337071,1351660214,41724801573,43076461787
2022-04-28,All-Floors,TPG,144,5666,4309342,10184577817,205148557434,215333135251
2022-04-28,All-Floors,Total,2251,38302,25674740,59781549345,1196334564668,1256116114013
2022-04-28,All-Floors,UG,888,21548,15799030,43128336968,839360185065,882488522033
2022-04-28,G,Alumni,11,66,36345,383986017,1266906079,1650892096
2022-04-28,G,Non-HKUST,24,294,38162,198808199,2965252540,3164060739
2022-04-28,G,Others(HKUST),9,25,138506,71031273,9473646105,9544677378
2022-04-28,G,RPG,104,748,612666,962192629,29381644970,30343837599
2022-04-28,G,Staff,179,1609,638980,496295376,14423833026,14920128402
2022-04-28,G,TPG,98,1281,544775,2032309504,42159967901,44192277405
2022-04-28,G,Total,876,8525,3420482,8218771523,158859208485,167077980008
2022-04-28,G,UG,451,4502,1411048,4074148525,59187957864,63262106389
2022-04-28,LG1,Alumni,6,53,49369,67035029,4492793653,4559828682
2022-04-28,LG1,Non-HKUST,17,183,224504,469635433,7921372537,8391007970
2022-04-28,LG1,Others(HKUST),4,25,159016,15313545,43069336,58382881
2022-04-28,LG1,RPG,45,720,663958,706140369,11554808669,12260949038
2022-04-28,LG1,Staff,65,477,146394,85324443,4464293042,4549617485
2022-04-28,LG1,TPG,83,1782,1955569,4881321385,71942302265,76823623650
2022-04-28,LG1,Total,559,13135,12502855,31939466728,543355321377,575294788105
2022-04-28,LG1,UG,339,9895,9304045,25714696524,442936681875,468651378399
2022-04-28,LG3,Alumni,21,54,61147,58638642,1922459832,1981098474
2022-04-28,LG3,Non-HKUST,23,58,113713,117787863,7017590330,7135378193
2022-04-28,LG3,Others(HKUST),19,66,9927,1302138,136563283,137865421
2022-04-28,LG3,RPG,351,720,123781,235909099,7818786684,8054695783
2022-04-28,LG3,Staff,452,1403,151587,296222333,5258812298,5555034631
2022-04-28,LG3,TPG,93,1076,995969,2266874671,57171098101,59437972772
2022-04-28,LG3,Total,1577,6869,3726944,8235063145,210991979295,219227042440
2022-04-28,LG3,UG,618,3492,2270820,5258328399,131666668767,136924997166
2022-04-28,LG4,Alumni,15,117,84399,58737406,2421831723,2480569129
2022-04-28,LG4,Non-HKUST,18,219,120589,129604521,2362379136,2491983657
2022-04-28,LG4,Others(HKUST),13,46,94070,2122122,13936512,16058634
2022-04-28,LG4,RPG,268,645,324487,449820455,10107067920,10556888375
2022-04-28,LG4,Staff,300,1201,219717,201281029,8321414065,8522695094
2022-04-28,LG4,TPG,78,1399,555783,528781425,26543303066,27072084491
2022-04-28,LG4,Total,1200,6423,2989250,6631147152,168456644170,175087791322
2022-04-28,LG4,UG,508,2796,1590205,5260800194,118686711748,123947511942
2022-04-29,1,Alumni,2,2,15,0,0,0
2022-04-29,1,Non-HKUST,11,44,99375,320514053,8298866760,8619380813
2022-04-29,1,Others(HKUST),4,4,130,3770,10361,14131
2022-04-29,1,RPG,108,180,103598,99977188,2126458221,2226435409
2022-04-29,1,Staff,165,2308,1294906,328211401,9410695806,9738907207
2022-04-29,1,TPG,20,158,222812,222231186,5707641544,5929872730
2022-04-29,1,Total,526,3898,3235125,3771766637,101194254143,104966020780
2022-04-29,1,UG,216,1202,1514289,2800829039,75650581451,78451410490
2022-04-29,All-Floors,Alumni,18,439,309400,506016154,14649811891,15155828045
2022-04-29,All-Floors,Non-HKUST,53,710,709402,1440303343,28182360621,29622663964
2022-04-29,All-Floors,Others(HKUST),32,125,341952,51219056,2328907818,2380126874
2022-04-29,All-Floors,RPG,500,2691,1577196,4241093601,49166078400,53407172001
2022-04-29,All-Floors,Staff,652,7488,2482843,1904186780,68479523347,70383710127
2022-04-29,All-Floors,TPG,136,4998,3957593,6542021954,141292406027,147834427981
2022-04-29,All-Floors,Total,2267,36025,24070329,52075306158,1074848337402,1126923643560
2022-04-29,All-Floors,UG,876,19574,14691943,37390465270,770749249298,808139714568
2022-04-29,G,Alumni,9,107,33575,61041149,864662830,925703979
2022-04-29,G,Non-HKUST,25,192,86327,82517459,618278037,700795496
2022-04-29,G,Others(HKUST),7,16,90623,10383256,1440020458,1450403714
2022-04-29,G,RPG,105,573,406832,1047594481,13322144629,14369739110
2022-04-29,G,Staff,181,1724,532852,469771330,32989000789,33458772119
2022-04-29,G,TPG,100,1239,706322,1117272735,27196133304,28313406039
2022-04-29,G,Total,874,8553,3757661,9748263773,185874003503,195622267276
2022-04-29,G,UG,447,4702,1901130,6959683363,109443763456,116403446819
2022-04-29,LG1,Alumni,6,59,38820,121665114,5115787088,5237452202
2022-04-29,LG1,Non-HKUST,19,230,244527,800690243,8261377847,9062068090
2022-04-29,LG1,Others(HKUST),2,5,157536,15453870,43172517,58626387
2022-04-29,LG1,RPG,41,493,465559,2242842158,17231746001,19474588159
2022-04-29,LG1,Staff,73,601,119621,39024525,1834602855,1873627380
2022-04-29,LG1,TPG,76,1532,1409986,2666106503,43966821043,46632927546
2022-04-29,LG1,Total,558,11424,10713017,27008454812,390571230348,417579685160
2022-04-29,LG1,UG,341,8504,8276968,21122672399,314117722997,335240395396
2022-04-29,LG3,Alumni,12,56,76398,128352667,5273267135,5401619802
2022-04-29,LG3,Non-HKUST,34,151,212488,140160896,7025371077,7165531973
2022-04-29,LG3,Others(HKUST),21,59,2654,1298633,105046950,106345583
2022-04-29,LG3,RPG,363,803,248537,465099299,6197700172,6662799471
2022-04-29,LG3,Staff,457,1638,203319,745140364,7428297635,8173437999
2022-04-29,LG3,TPG,88,815,849856,1641543355,31402935252,33044478607
2022-04-29,LG3,Total,1588,6433,3262332,6944881740,204205870175,211150751915
2022-04-29,LG3,UG,613,2911,1669080,3823286526,146773251954,150596538480
2022-04-29,LG4,Alumni,9,215,160592,194957224,3396094838,3591052062
2022-04-29,LG4,Non-HKUST,28,93,66685,96420692,3978466900,4074887592
2022-04-29,LG4,Others(HKUST),14,41,91009,24079527,740657532,764737059
2022-04-29,LG4,RPG,256,642,352670,385580475,10288029377,10673609852
2022-04-29,LG4,Staff,315,1217,332145,322039160,16816926262,17138965422
2022-04-29,LG4,TPG,70,1254,768617,894868175,33018874884,33913743059
2022-04-29,LG4,Total,1166,5717,3102194,4601939196,193002979233,197604918429
2022-04-29,LG4,UG,474,2255,1330476,2683993943,124763929440,127447923383
2022-04-30,1,Alumni,5,20,40025,67869391,1918840390,1986709781
2022-04-30,1,Non-HKUST,8,21,45976,660691920,1448877873,2109569793
2022-04-30,1,Others(HKUST),0,0,0,0,0,0
2022-04-30,1,RPG,66,172,137120,195600814,5121092866,5316693680
2022-04-30,1,Staff,33,97,138435,42125260,1390632839,1432758099
2022-04-30,1,TPG,28,298,218794,790603211,11386621608,12177224819
2022-04-30,1,Total,272,1122,989913,3107971263,46118247816,49226219079
2022-04-30,1,UG,132,514,409563,1351080667,24852182240,26203262907
2022-04-30,All-Floors,Alumni,30,1015,519503,1037464253,44270782715,45308246968
2022-04-30,All-Floors,Non-HKUST,29,261,312039,1124542700,15924610278,17049152978
2022-04-30,All-Floors,Others(HKUST),16,117,316557,33726081,15671755323,15705481404
2022-04-30,All-Floors,RPG,332,2124,1185958,3128360213,54406421105,57534781318
2022-04-30,All-Floors,Staff,178,1018,566575,7937912734,19134653008,27072565742
2022-04-30,All-Floors,TPG,111,3309,2676929,6067212911,138185602002,144252814913
2022-04-30,All-Floors,Total,1364,18035,12696248,35449730820,617637588942,653087319762
2022-04-30,All-Floors,UG,668,10191,7118687,16120511928,330043764511,346164276439
2022-04-30,G,Alumni,15,138,106278,173941079,4309902351,4483843430
2022-04-30,G,Non-HKUST,11,58,50689,11875079,298455578,310330657
2022-04-30,G,Others(HKUST),5,12,83645,4086179,1274736850,1278823029
2022-04-30,G,RPG,60,377,249620,545694449,12087879605,12633574054
2022-04-30,G,Staff,55,381,223596,7335235037,4543849825,11879084862
2022-04-30,G,TPG,69,901,553140,838049633,22435454189,23273503822
2022-04-30,G,Total,479,3660,1934462,10223989738,86174820528,96398810266
2022-04-30,G,UG,264,1793,667494,1315108282,41224542130,42539650412
2022-04-30,LG1,Alumni,10,606,246633,711721011,18921684327,19633405338
2022-04-30,LG1,Non-HKUST,11,111,115506,394354181,9684407890,10078762071
2022-04-30,LG1,Others(HKUST),3,9,157611,13898911,129276921,143175832
2022-04-30,LG1,RPG,36,631,533816,1374258641,25069705927,26443964568
2022-04-30,LG1,Staff,11,110,80855,284089116,8711643246,8995732362
2022-04-30,LG1,TPG,62,1378,1405869,3914281930,86864776267,90779058197
2022-04-30,LG1,Total,349,7992,7642593,18136598989,354438132615,372574731604
2022-04-30,LG1,UG,216,5147,5102303,11443995199,205056638037,216500633236
2022-04-30,LG3,Alumni,18,107,99178,65458129,18049995860,18115453989
2022-04-30,LG3,Non-HKUST,18,42,84500,49244344,4381434984,4430679328
2022-04-30,LG3,Others(HKUST),10,53,33923,6997961,14161694099,14168692060
2022-04-30,LG3,RPG,237,550,150289,237166243,6582814480,6819980723
2022-04-30,LG3,Staff,112,265,42183,239993428,2808784953,3048778381
2022-04-30,LG3,TPG,50,563,422106,452576377,14760920860,15213497237
2022-04-30,LG3,Total,906,3047,1433247,2457174422,105881725266,108338899688
2022-04-30,LG3,UG,461,1467,601068,1405737940,45136080030,46541817970
2022-04-30,LG4,Alumni,17,144,27389,18474643,1070359787,1088834430
2022-04-30,LG4,Non-HKUST,13,29,15368,8377176,111433953,119811129
2022-04-30,LG4,Others(HKUST),10,43,41378,8743030,106047453,114790483
2022-04-30,LG4,RPG,184,394,115113,775640066,5544928227,6320568293
2022-04-30,LG4,Staff,73,165,81506,36469893,1679742145,1716212038
2022-04-30,LG4,TPG,32,169,77020,71701760,2737829078,2809530838
2022-04-30,LG4,Total,693,2214,696033,1523996408,25024662717,26548659125
2022-04-30,LG4,UG,364,1270,338259,604589840,13774322074,14378911914
